sep=,
"Account Description","Account Date","Bank / Customer / Supplier","Reference","Transaction Type","Description","Debit","Credit","Balance"
"3300/020 : Computer - Platforms",,,,,,,
"3300/020 : Computer - Platforms","Opening Balance as at: 01/03/2025",,,,,"0",,
,"01/03/2025","8400/000 : FNB","Shopify 3421.17 SHOPIFY* 33 4XXXXX*5191 27 FEB XXXXXXXXXXXXXXXXXXX6960 Shopify","Account Payment","Shopify 3421.17 SHOPIFY* 33 4XXXXX*5191 27 FEB XXXXXXXXXXXXXXXXXXX6960 Shopify","64465",,"64465"
,"01/03/2025","8400/000 : FNB","Intuit 570.40 INTUIT *QBoo 4XXXXX*5225 27 FEB XXXXXXXXXXXXXXXXXXX2756 Intuit","Account Payment","Intuit 570.40 INTUIT *QBoo 4XXXXX*5225 27 FEB XXXXXXXXXXXXXXXXXXX2756 Intuit","570.4",,"65035.4"
,"01/03/2025","8400/000 : FNB","Intuit 570.40 INTUIT *QBoo 4XXXXX*5225 27 FEB XXXXXXXXXXXXXXXXXXX2814 Intuit","Account Payment","Intuit 570.40 INTUIT *QBoo 4XXXXX*5225 27 FEB XXXXXXXXXXXXXXXXXXX2814 Intuit","570.4",,"65605.8"
,"01/03/2025","8400/000 : FNB","Intuit 546.25 INTUIT *QBoo 4XXXXX*5225 27 FEB XXXXXXXXXXXXXXXXXXX2509 Intuit","Account Payment","Intuit 546.25 INTUIT *QBoo 4XXXXX*5225 27 FEB XXXXXXXXXXXXXXXXXXX2509 Intuit","546.25",,"66152.05"
,"01/03/2025","8400/000 : FNB","399.99 POE.COM 4XX*5191 27 FEB XX1001 399.99 POE.COM 4XXXXX*5191 27 FEB XXXXXXXXXXXXXXXXXXX1001","Account Payment","399.99 POE.COM 4XX*5191 27 FEB XX1001 399.99 POE.COM 4XXXXX*5191 27 FEB XXXXXXXXXXXXXXXXXXX1001","399.99",,"66552.04"
,"03/03/2025","8400/000 : FNB","67.85 LEMSQZY* CHAT 4XX*5191 01 MAR XX9146 67.85 LEMSQZY* CHAT 4XXXXX*5191 01 MAR XXXXXXXXXXXXXXXXXX","Account Payment","67.85 LEMSQZY* CHAT 4XX*5191 01 MAR XX9146 67.85 LEMSQZY* CHAT 4XXXXX*5191 01 MAR XXXXXXXXXXXXXXXXX","1297.65",,"67849.69"
,"03/03/2025","8400/000 : FNB","50.12 FRAPPE CLOUD 4XX*5191 28 FEB XX0584 50.12 FRAPPE CLOUD 4XXXXX*5191 28 FEB XXXXXXXXXXXXXXXXXXX0","Account Payment","50.12 FRAPPE CLOUD 4XX*5191 28 FEB XX0584 50.12 FRAPPE CLOUD 4XXXXX*5191 28 FEB XXXXXXXXXXXXXXXXXXX","945.83",,"68795.52"
,"03/03/2025","8400/000 : FNB","Digitalocean 47.84 DIGITALOCEAN. 4XXXXX*5191 01 MAR XXXXXXXXXXXXXXXXXXX0133 Digitalocean","Account Payment","Digitalocean 47.84 DIGITALOCEAN. 4XXXXX*5191 01 MAR XXXXXXXXXXXXXXXXXXX0133 Digitalocean","914.95",,"69710.47"
,"03/03/2025","8400/000 : FNB","29.99 BEENVERIFIED 4XX*5191 28 FEB XX6964 29.99 BEENVERIFIED 4XXXXX*5191 28 FEB XXXXXXXXXXXXXXXXXXX6","Account Payment","29.99 BEENVERIFIED 4XX*5191 28 FEB XX6964 29.99 BEENVERIFIED 4XXXXX*5191 28 FEB XXXXXXXXXXXXXXXXXXX","565.95",,"70276.42"
,"03/03/2025","8400/000 : FNB","430.00 Dlocal *Micr 4XX*5191 28 FEB XX0372 430.00 Dlocal *Micr 4XXXXX*5191 28 FEB XXXXXXXXXXXXXXXXXX","Account Payment","430.00 Dlocal *Micr 4XX*5191 28 FEB XX0372 430.00 Dlocal *Micr 4XXXXX*5191 28 FEB XXXXXXXXXXXXXXXXX","430",,"70706.42"
,"03/03/2025","8400/000 : FNB","21.37 LINODE . AKAM 4XX*5191 01 MAR XX7671 21.37 LINODE . AKAM 4XXXXX*5191 01 MAR XXXXXXXXXXXXXXXXXX","Account Payment","21.37 LINODE . AKAM 4XX*5191 01 MAR XX7671 21.37 LINODE . AKAM 4XXXXX*5191 01 MAR XXXXXXXXXXXXXXXXX","408.7",,"71115.12"
,"03/03/2025","8400/000 : FNB","9.00 GITPOD.IO 4XX*5191 28 FEB XX4731 9.00 GITPOD.IO 4XXXXX*5191 28 FEB XXXXXXXXXXXXXXXXXXX4731","Account Payment","9.00 GITPOD.IO 4XX*5191 28 FEB XX4731 9.00 GITPOD.IO 4XXXXX*5191 28 FEB XXXXXXXXXXXXXXXXXXX4731","169.84",,"71284.96"
,"03/03/2025","8400/000 : FNB","5.00 COMPONENTS.STU 4XX*5191 28 FEB XX9447 5.00 COMPONENTS.STU 4XXXXX*5191 28 FEB XXXXXXXXXXXXXXXXXX","Account Payment","5.00 COMPONENTS.STU 4XX*5191 28 FEB XX9447 5.00 COMPONENTS.STU 4XXXXX*5191 28 FEB XXXXXXXXXXXXXXXXX","94.36",,"71379.32"
,"03/03/2025","8400/000 : FNB","5050.80 FRESHWORKS 4XX*5225 28 FEB XX6851 5050.80 FRESHWORKS 4XXXXX*5225 28 FEB XXXXXXXXXXXXXXXXXXX6","Account Payment","5050.80 FRESHWORKS 4XX*5225 28 FEB XX6851 5050.80 FRESHWORKS 4XXXXX*5225 28 FEB XXXXXXXXXXXXXXXXXXX","5050.8",,"76430.12"
,"04/03/2025","8400/000 : FNB","1.00 VERCEL INC. 4XX*5225 01 MAR XX7108 1.00 VERCEL INC. 4XXXXX*5225 01 MAR XXXXXXXXXXXXXXXXXXX7108","Account Payment","1.00 VERCEL INC. 4XX*5225 01 MAR XX7108 1.00 VERCEL INC. 4XXXXX*5225 01 MAR XXXXXXXXXXXXXXXXXXX7108","19.13",,"76449.25"
,"04/03/2025","8400/000 : FNB","1150.00 AUTH0.COM 4XX*5191 01 MAR XX9706 1150.00 AUTH0.COM 4XXXXX*5191 01 MAR XXXXXXXXXXXXXXXXXXX970","Account Payment","1150.00 AUTH0.COM 4XX*5191 01 MAR XX9706 1150.00 AUTH0.COM 4XXXXX*5191 01 MAR XXXXXXXXXXXXXXXXXXX97","21994.1",,"98443.35"
,"04/03/2025","8400/000 : FNB","450.00 WAPPALYZER 4XX*5191 02 MAR XX0593 450.00 WAPPALYZER 4XXXXX*5191 02 MAR XXXXXXXXXXXXXXXXXXX059","Account Payment","450.00 WAPPALYZER 4XX*5191 02 MAR XX0593 450.00 WAPPALYZER 4XXXXX*5191 02 MAR XXXXXXXXXXXXXXXXXXX05","8606.38",,"107049.73"
,"04/03/2025","8400/000 : FNB","Google Store 365.04 Google GSUIT 4XXXXX*5225 01 MAR XXXXXXXXXXXXXXXXXXX0052 Google Store","Account Payment","Google Store 365.04 Google GSUIT 4XXXXX*5225 01 MAR XXXXXXXXXXXXXXXXXXX0052 Google Store","7255.77",,"114305.5"
,"04/03/2025","8400/000 : FNB","Wix.com 182.85 Wix.Com, Inc 4XXXXX*5191 03 MAR XXXXXXXXXXXXXXXXXXX9071 Wix.com","Account Payment","Wix.com 182.85 Wix.Com, Inc 4XXXXX*5191 03 MAR XXXXXXXXXXXXXXXXXXX9071 Wix.com","3450.62",,"117756.12"
,"04/03/2025","8400/000 : FNB","134.00 SINCH MAILGU 4XX*5191 01 MAR XX1232 134.00 SINCH MAILGU 4XXXXX*5191 01 MAR XXXXXXXXXXXXXXXXXX","Account Payment","134.00 SINCH MAILGU 4XX*5191 01 MAR XX1232 134.00 SINCH MAILGU 4XXXXX*5191 01 MAR XXXXXXXXXXXXXXXXX","2562.79",,"120318.91"
,"04/03/2025","8400/000 : FNB","44.13 GOOGLE*GSUITE 4XX*5225 01 MAR XX1686 44.13 GOOGLE*GSUITE 4XXXXX*5225 01 MAR XXXXXXXXXXXXXXXXXX","Account Payment","44.13 GOOGLE*GSUITE 4XX*5225 01 MAR XX1686 44.13 GOOGLE*GSUITE 4XXXXX*5225 01 MAR XXXXXXXXXXXXXXXXX","877.16",,"121196.07"
,"04/03/2025","8400/000 : FNB","Google Store 39.82 Google GSUITE 4XXXXX*5191 01 MAR XXXXXXXXXXXXXXXXXXX9050 Google Store","Account Payment","Google Store 39.82 Google GSUITE 4XXXXX*5191 01 MAR XXXXXXXXXXXXXXXXXXX9050 Google Store","791.49",,"121987.56"
,"04/03/2025","8400/000 : FNB","Facebook 651.14 FACEBK *9QFB 4XXXXX*5191 02 MAR XXXXXXXXXXXXXXXXXXX5350 Facebook","Account Payment","Facebook 651.14 FACEBK *9QFB 4XXXXX*5191 02 MAR XXXXXXXXXXXXXXXXXXX5350 Facebook","651.14",,"122638.7"
,"04/03/2025","8400/000 : FNB","Facebook 23.00 FACEBK *4KCYX 4XXXXX*5191 01 MAR XXXXXXXXXXXXXXXXXXX6040 Facebook","Account Payment","Facebook 23.00 FACEBK *4KCYX 4XXXXX*5191 01 MAR XXXXXXXXXXXXXXXXXXX6040 Facebook","439.89",,"123078.59"
,"04/03/2025","8400/000 : FNB","20.00 HUGGINGFACE 4XX*5191 01 MAR XX7397 20.00 HUGGINGFACE 4XXXXX*5191 01 MAR XXXXXXXXXXXXXXXXXXX739","Account Payment","20.00 HUGGINGFACE 4XX*5191 01 MAR XX7397 20.00 HUGGINGFACE 4XXXXX*5191 01 MAR XXXXXXXXXXXXXXXXXXX73","382.51",,"123461.1"
,"04/03/2025","8400/000 : FNB","17.25 SLACK T06A3T4 4XX*5191 01 MAR XX2061 17.25 SLACK T06A3T4 4XXXXX*5191 01 MAR XXXXXXXXXXXXXXXXXX","Account Payment","17.25 SLACK T06A3T4 4XX*5191 01 MAR XX2061 17.25 SLACK T06A3T4 4XXXXX*5191 01 MAR XXXXXXXXXXXXXXXXX","329.91",,"123791.01"
,"04/03/2025","8400/000 : FNB","Facebook 13.80 FACEBK *5YVGC 4XXXXX*5191 01 MAR XXXXXXXXXXXXXXXXXXX0025 Facebook","Account Payment","Facebook 13.80 FACEBK *5YVGC 4XXXXX*5191 01 MAR XXXXXXXXXXXXXXXXXXX0025 Facebook","263.93",,"124054.94"
,"04/03/2025","8400/000 : FNB","Facebook 4.60 FACEBK *7GMZUL 4XXXXX*5191 01 MAR XXXXXXXXXXXXXXXXXXX1026 Facebook","Account Payment","Facebook 4.60 FACEBK *7GMZUL 4XXXXX*5191 01 MAR XXXXXXXXXXXXXXXXXXX1026 Facebook","87.98",,"124142.92"
,"05/03/2025","8400/000 : FNB","56.38 PADDLE.NET* W 4XX*5191 04 MAR XX1231 56.38 PADDLE.NET* W 4XXXXX*5191 04 MAR XXXXXXXXXXXXXXXXXX","Account Payment","56.38 PADDLE.NET* W 4XX*5191 04 MAR XX1231 56.38 PADDLE.NET* W 4XXXXX*5191 04 MAR XXXXXXXXXXXXXXXXX","1077.71",,"125220.63"
,"05/03/2025","8400/000 : FNB","60.00 INSOMNIA TEAM 4XX*5191 03 MAR XX4767 60.00 INSOMNIA TEAM 4XXXXX*5191 03 MAR XXXXXXXXXXXXXXXXXX","Account Payment","60.00 INSOMNIA TEAM 4XX*5191 03 MAR XX4767 60.00 INSOMNIA TEAM 4XXXXX*5191 03 MAR XXXXXXXXXXXXXXXXX","1146.91",,"126367.54"
,"05/03/2025","8400/000 : FNB","99.00 DMNS.APP BUSI 4XX*5191 04 MAR XX5178 99.00 DMNS.APP BUSI 4XXXXX*5191 04 MAR XXXXXXXXXXXXXXXXXX","Account Payment","99.00 DMNS.APP BUSI 4XX*5191 04 MAR XX5178 99.00 DMNS.APP BUSI 4XXXXX*5191 04 MAR XXXXXXXXXXXXXXXXX","1892.4",,"128259.94"
,"05/03/2025","8400/000 : FNB","179.00 MOZSEO:HELP@ 4XX*5191 03 MAR XX9244 179.00 MOZSEO:HELP@ 4XXXXX*5191 03 MAR XXXXXXXXXXXXXXXXXX","Account Payment","179.00 MOZSEO:HELP@ 4XX*5191 03 MAR XX9244 179.00 MOZSEO:HELP@ 4XXXXX*5191 03 MAR XXXXXXXXXXXXXXXXX","3423.43",,"131683.37"
,"05/03/2025","8400/000 : FNB","Stable 249.00 STABLE 4XXXXX*5191 04 MAR XXXXXXXXXXXXXXXXXXX6281 Stable","Account Payment","Stable 249.00 STABLE 4XXXXX*5191 04 MAR XXXXXXXXXXXXXXXXXXX6281 Stable","4759.66",,"136443.03"
,"05/03/2025","8400/000 : FNB","920.00 AUTH0.COM 4XX*5191 03 MAR XX3089 920.00 AUTH0.COM 4XXXXX*5191 03 MAR XXXXXXXXXXXXXXXXXXX3089","Account Payment","920.00 AUTH0.COM 4XX*5191 03 MAR XX3089 920.00 AUTH0.COM 4XXXXX*5191 03 MAR XXXXXXXXXXXXXXXXXXX3089","17595.28",,"154038.31"
,"05/03/2025","8400/000 : FNB","1499.00 APPDIRECT 4XX*5225 04 MAR XX3188 1499.00 APPDIRECT 4XXXXX*5225 04 MAR XXXXXXXXXXXXXXXXXXX318","Account Payment","1499.00 APPDIRECT 4XX*5225 04 MAR XX3188 1499.00 APPDIRECT 4XXXXX*5225 04 MAR XXXXXXXXXXXXXXXXXXX31","28653.51",,"182691.82"
,"06/03/2025","8400/000 : FNB","19.00 CHATBASE 4XX*5191 05 MAR XX2845 19.00 CHATBASE 4XXXXX*5191 05 MAR XXXXXXXXXXXXXXXXXXX2845","Account Payment","19.00 CHATBASE 4XX*5191 05 MAR XX2845 19.00 CHATBASE 4XXXXX*5191 05 MAR XXXXXXXXXXXXXXXXXXX2845","362.06",,"183053.88"
,"06/03/2025","8400/000 : FNB","Github Inc. 19.00 GITHUB, INC. 4XXXXX*5225 04 MAR XXXXXXXXXXXXXXXXXXX7103 Github Inc.","Account Payment","Github Inc. 19.00 GITHUB, INC. 4XXXXX*5225 04 MAR XXXXXXXXXXXXXXXXXXX7103 Github Inc.","363.19",,"183417.07"
,"06/03/2025","8400/000 : FNB","Github Inc. 54.74 GITHUB, INC. 4XXXXX*5225 04 MAR XXXXXXXXXXXXXXXXXXX1490 Github Inc.","Account Payment","Github Inc. 54.74 GITHUB, INC. 4XXXXX*5225 04 MAR XXXXXXXXXXXXXXXXXXX1490 Github Inc.","1046.36",,"184463.43"
,"06/03/2025","8400/000 : FNB","99.99 JINA.AI 4XX*5191 04 MAR XX3658 99.99 JINA.AI 4XXXXX*5191 04 MAR XXXXXXXXXXXXXXXXXXX3658","Account Payment","99.99 JINA.AI 4XX*5191 04 MAR XX3658 99.99 JINA.AI 4XXXXX*5191 04 MAR XXXXXXXXXXXXXXXXXXX3658","1911.32",,"186374.75"
,"06/03/2025","8400/000 : FNB","ManageWP 120.75 MANAGEWP 4XXXXX*5225 05 MAR XXXXXXXXXXXXXXXXXXX7424 ManageWP","Account Payment","ManageWP 120.75 MANAGEWP 4XXXXX*5225 05 MAR XXXXXXXXXXXXXXXXXXX7424 ManageWP","2300.97",,"188675.72"
,"06/03/2025","8400/000 : FNB","ManageWP 120.75 MANAGEWP 4XXXXX*5225 05 MAR XXXXXXXXXXXXXXXXXXX1977 ManageWP","Account Payment","ManageWP 120.75 MANAGEWP 4XXXXX*5225 05 MAR XXXXXXXXXXXXXXXXXXX1977 ManageWP","2300.97",,"190976.69"
,"06/03/2025","8400/000 : FNB","Sage SAGE ACC 4XXXXX*5225 04 MAR XXXXXXXXXXXXXXXXXXX9975 Sage","Account Payment","Sage SAGE ACC 4XXXXX*5225 04 MAR XXXXXXXXXXXXXXXXXXX9975 Sage","3438",,"194414.69"
,"06/03/2025","8400/000 : FNB","599.00 TRIPLE WHALE 4XX*5191 04 MAR XX6482 599.00 TRIPLE WHALE 4XXXXX*5191 04 MAR XXXXXXXXXXXXXXXXXX","Account Payment","599.00 TRIPLE WHALE 4XX*5191 04 MAR XX6482 599.00 TRIPLE WHALE 4XXXXX*5191 04 MAR XXXXXXXXXXXXXXXXX","11449.94",,"205864.63"
,"06/03/2025","8400/000 : FNB","Shopify 2550.98 SHOPIFY* 33 4XXXXX*5191 04 MAR XXXXXXXXXXXXXXXXXXX7342 Shopify","Account Payment","Shopify 2550.98 SHOPIFY* 33 4XXXXX*5191 04 MAR XXXXXXXXXXXXXXXXXXX7342 Shopify","48762.2",,"254626.83"
,"07/03/2025","8400/000 : FNB","9.00 TWENTY.COM 4XX*5191 06 MAR XX0964 9.00 TWENTY.COM 4XXXXX*5191 06 MAR XXXXXXXXXXXXXXXXXXX0964","Account Payment","9.00 TWENTY.COM 4XX*5191 06 MAR XX0964 9.00 TWENTY.COM 4XXXXX*5191 06 MAR XXXXXXXXXXXXXXXXXXX0964","170.4",,"254797.23"
,"07/03/2025","8400/000 : FNB","Paddle 187.94 PADDLE.NET* 4XXXXX*5191 05 MAR XXXXXXXXXXXXXXXXXXX9070 Paddle","Account Payment","Paddle 187.94 PADDLE.NET* 4XXXXX*5191 05 MAR XXXXXXXXXXXXXXXXXXX9070 Paddle","187.94",,"254985.17"
,"07/03/2025","8400/000 : FNB","Hightail 15.00 HIGHTAIL 4XXXXX*5191 06 MAR XXXXXXXXXXXXXXXXXXX5594 Hightail","Account Payment","Hightail 15.00 HIGHTAIL 4XXXXX*5191 06 MAR XXXXXXXXXXXXXXXXXXX5594 Hightail","284",,"255269.17"
,"07/03/2025","8400/000 : FNB","50.00 ANACONDA INC. 4XX*5191 05 MAR XX7414 50.00 ANACONDA INC. 4XXXXX*5191 05 MAR XXXXXXXXXXXXXXXXXX","Account Payment","50.00 ANACONDA INC. 4XX*5191 05 MAR XX7414 50.00 ANACONDA INC. 4XXXXX*5191 05 MAR XXXXXXXXXXXXXXXXX","952.78",,"256221.95"
,"07/03/2025","8400/000 : FNB","99.00 CHATBASE 4XX*5191 05 MAR XX4802 99.00 CHATBASE 4XXXXX*5191 05 MAR XXXXXXXXXXXXXXXXXXX4802","Account Payment","99.00 CHATBASE 4XX*5191 05 MAR XX4802 99.00 CHATBASE 4XXXXX*5191 05 MAR XXXXXXXXXXXXXXXXXXX4802","1886.51",,"258108.46"
,"07/03/2025","8400/000 : FNB","115.08 OPENAI 4XX*5191 06 MAR XX4643 115.08 OPENAI 4XXXXX*5191 06 MAR XXXXXXXXXXXXXXXXXXX4643","Account Payment","115.08 OPENAI 4XX*5191 06 MAR XX4643 115.08 OPENAI 4XXXXX*5191 06 MAR XXXXXXXXXXXXXXXXXXX4643","2178.84",,"260287.3"
,"07/03/2025","8400/000 : FNB","174.00 INTERCOM R&D 4XX*5191 06 MAR XX4593 174.00 INTERCOM R&D 4XXXXX*5191 06 MAR XXXXXXXXXXXXXXXXXX","Account Payment","174.00 INTERCOM R&D 4XX*5191 06 MAR XX4593 174.00 INTERCOM R&D 4XXXXX*5191 06 MAR XXXXXXXXXXXXXXXXX","3294.4",,"263581.7"
,"08/03/2025","8400/000 : FNB","3.60 GETADDRESS.IO 4XX*5225 07 MAR XX0922 3.60 GETADDRESS.IO 4XXXXX*5225 07 MAR XXXXXXXXXXXXXXXXXXX0","Account Payment","3.60 GETADDRESS.IO 4XX*5225 07 MAR XX0922 3.60 GETADDRESS.IO 4XXXXX*5225 07 MAR XXXXXXXXXXXXXXXXXXX","87.28",,"263668.98"
,"08/03/2025","8400/000 : FNB","7.00 NPM, INC. 4XX*5191 07 MAR XX2762 7.00 NPM, INC. 4XXXXX*5191 07 MAR XXXXXXXXXXXXXXXXXXX2762","Account Payment","7.00 NPM, INC. 4XX*5191 07 MAR XX2762 7.00 NPM, INC. 4XXXXX*5191 07 MAR XXXXXXXXXXXXXXXXXXX2762","131.31",,"263800.29"
,"08/03/2025","8400/000 : FNB","7.00 NPM, INC. 4XX*5191 07 MAR XX9987 7.00 NPM, INC. 4XXXXX*5191 07 MAR XXXXXXXXXXXXXXXXXXX9987","Account Payment","7.00 NPM, INC. 4XX*5191 07 MAR XX9987 7.00 NPM, INC. 4XXXXX*5191 07 MAR XXXXXXXXXXXXXXXXXXX9987","131.31",,"263931.6"
,"08/03/2025","8400/000 : FNB","7.00 NPM, INC. 4XX*5191 07 MAR XX4649 7.00 NPM, INC. 4XXXXX*5191 07 MAR XXXXXXXXXXXXXXXXXXX4649","Account Payment","7.00 NPM, INC. 4XX*5191 07 MAR XX4649 7.00 NPM, INC. 4XXXXX*5191 07 MAR XXXXXXXXXXXXXXXXXXX4649","131.31",,"264062.91"
,"08/03/2025","8400/000 : FNB","7.00 NPM, INC. 4XX*5191 07 MAR XX5500 7.00 NPM, INC. 4XXXXX*5191 07 MAR XXXXXXXXXXXXXXXXXXX5500","Account Payment","7.00 NPM, INC. 4XX*5191 07 MAR XX5500 7.00 NPM, INC. 4XXXXX*5191 07 MAR XXXXXXXXXXXXXXXXXXX5500","131.31",,"264194.22"
,"08/03/2025","8400/000 : FNB","224.99 Google Chara 4XX*5191 06 MAR XX3042 224.99 Google Chara 4XXXXX*5191 06 MAR XXXXXXXXXXXXXXXXXX","Account Payment","224.99 Google Chara 4XX*5191 06 MAR XX3042 224.99 Google Chara 4XXXXX*5191 06 MAR XXXXXXXXXXXXXXXXX","224.99",,"264419.21"
,"08/03/2025","8400/000 : FNB","Woocommerce 19.99 WOOCOMMERCE S 4XXXXX*5225 06 MAR XXXXXXXXXXXXXXXXXXX5333 Woocommerce","Account Payment","Woocommerce 19.99 WOOCOMMERCE S 4XXXXX*5225 06 MAR XXXXXXXXXXXXXXXXXXX5333 Woocommerce","378.48",,"264797.69"
,"08/03/2025","8400/000 : FNB","72.00 TERMIUS CORPO 4XX*5191 06 MAR XX6444 72.00 TERMIUS CORPO 4XXXXX*5191 06 MAR XXXXXXXXXXXXXXXXXX","Account Payment","72.00 TERMIUS CORPO 4XX*5191 06 MAR XX6444 72.00 TERMIUS CORPO 4XXXXX*5191 06 MAR XXXXXXXXXXXXXXXXX","1363.2",,"266160.89"
,"10/03/2025","8400/000 : FNB","12.00 CODESANDBOX 4XX*5191 07 MAR XX4426 12.00 CODESANDBOX 4XXXXX*5191 07 MAR XXXXXXXXXXXXXXXXXXX442","Account Payment","12.00 CODESANDBOX 4XX*5191 07 MAR XX4426 12.00 CODESANDBOX 4XXXXX*5191 07 MAR XXXXXXXXXXXXXXXXXXX44","225.1",,"266385.99"
,"10/03/2025","8400/000 : FNB","Intuit 570.40 INTUIT *QBoo 4XXXXX*5225 07 MAR XXXXXXXXXXXXXXXXXXX8537 Intuit","Account Payment","Intuit 570.40 INTUIT *QBoo 4XXXXX*5225 07 MAR XXXXXXXXXXXXXXXXXXX8537 Intuit","570.4",,"266956.39"
,"10/03/2025","8400/000 : FNB","99.00 MIOSALON.COM( 4XX*5225 07 MAR XX2296 99.00 MIOSALON.COM( 4XXXXX*5225 07 MAR XXXXXXXXXXXXXXXXXX","Account Payment","99.00 MIOSALON.COM( 4XX*5225 07 MAR XX2296 99.00 MIOSALON.COM( 4XXXXX*5225 07 MAR XXXXXXXXXXXXXXXXX","1857.1",,"268813.49"
,"10/03/2025","8400/000 : FNB","99.00 MIOSALON.COM( 4XX*5225 07 MAR XX0163 99.00 MIOSALON.COM( 4XXXXX*5225 07 MAR XXXXXXXXXXXXXXXXXX","Account Payment","99.00 MIOSALON.COM( 4XX*5225 07 MAR XX0163 99.00 MIOSALON.COM( 4XXXXX*5225 07 MAR XXXXXXXXXXXXXXXXX","1857.1",,"270670.59"
,"10/03/2025","8400/000 : FNB","105.00 NOTION LABS, 4XX*5191 07 MAR XX5876 105.00 NOTION LABS, 4XXXXX*5191 07 MAR XXXXXXXXXXXXXXXXXX","Account Payment","105.00 NOTION LABS, 4XX*5191 07 MAR XX5876 105.00 NOTION LABS, 4XXXXX*5191 07 MAR XXXXXXXXXXXXXXXXX","1969.65",,"272640.24"
,"10/03/2025","8400/000 : FNB","Paddle 171.35 PADDLE.NET* 4XXXXX*5191 08 MAR XXXXXXXXXXXXXXXXXXX9314 Paddle","Account Payment","Paddle 171.35 PADDLE.NET* 4XXXXX*5191 08 MAR XXXXXXXXXXXXXXXXXXX9314 Paddle","3206.61",,"275846.85"
,"11/03/2025","8400/000 : FNB","Google Store 34.99 Google One 4XXXXX*5191 07 MAR XXXXXXXXXXXXXXXXXXX2023 Google Store","Account Payment","Google Store 34.99 Google One 4XXXXX*5191 07 MAR XXXXXXXXXXXXXXXXXXX2023 Google Store","34.99",,"275881.84"
,"11/03/2025","8400/000 : FNB","7.00 CHATBASE 4XX*5191 10 MAR XX1702 7.00 CHATBASE 4XXXXX*5191 10 MAR XXXXXXXXXXXXXXXXXXX1702","Account Payment","7.00 CHATBASE 4XX*5191 10 MAR XX1702 7.00 CHATBASE 4XXXXX*5191 10 MAR XXXXXXXXXXXXXXXXXXX1702","131",,"276012.84"
,"11/03/2025","8400/000 : FNB","10.00 REPLIT, INC. 4XX*5191 10 MAR XX9715 10.00 REPLIT, INC. 4XXXXX*5191 10 MAR XXXXXXXXXXXXXXXXXXX9","Account Payment","10.00 REPLIT, INC. 4XX*5191 10 MAR XX9715 10.00 REPLIT, INC. 4XXXXX*5191 10 MAR XXXXXXXXXXXXXXXXXXX","187.14",,"276199.98"
,"11/03/2025","8400/000 : FNB","20.00 VERCEL INC. 4XX*5191 09 MAR XX9112 20.00 VERCEL INC. 4XXXXX*5191 09 MAR XXXXXXXXXXXXXXXXXXX911","Account Payment","20.00 VERCEL INC. 4XX*5191 09 MAR XX9112 20.00 VERCEL INC. 4XXXXX*5191 09 MAR XXXXXXXXXXXXXXXXXXX91","374.28",,"276574.26"
,"11/03/2025","8400/000 : FNB","20.00 VERCEL INC. 4XX*5225 08 MAR XX4526 20.00 VERCEL INC. 4XXXXX*5225 08 MAR XXXXXXXXXXXXXXXXXXX452","Account Payment","20.00 VERCEL INC. 4XX*5225 08 MAR XX4526 20.00 VERCEL INC. 4XXXXX*5225 08 MAR XXXXXXXXXXXXXXXXXXX45","374.28",,"276948.54"
,"11/03/2025","8400/000 : FNB","21.56 SLACK T0740DV 4XX*5191 10 MAR XX2797 21.56 SLACK T0740DV 4XXXXX*5191 10 MAR XXXXXXXXXXXXXXXXXX","Account Payment","21.56 SLACK T0740DV 4XX*5191 10 MAR XX2797 21.56 SLACK T0740DV 4XXXXX*5191 10 MAR XXXXXXXXXXXXXXXXX","403.47",,"277352.01"
,"11/03/2025","8400/000 : FNB","Google Play 434.99 Google Perpl 4XXXXX*5191 08 MAR XXXXXXXXXXXXXXXXXXX7043 Google Play","Account Payment","Google Play 434.99 Google Perpl 4XXXXX*5191 08 MAR XXXXXXXXXXXXXXXXXXX7043 Google Play","434.99",,"277787"
,"11/03/2025","8400/000 : FNB","25.00 BEECEPTOR 4XX*5191 09 MAR XX0094 25.00 BEECEPTOR 4XXXXX*5191 09 MAR XXXXXXXXXXXXXXXXXXX0094","Account Payment","25.00 BEECEPTOR 4XX*5191 09 MAR XX0094 25.00 BEECEPTOR 4XXXXX*5191 09 MAR XXXXXXXXXXXXXXXXXXX0094","467.84",,"278254.84"
,"11/03/2025","8400/000 : FNB","25.00 BEECEPTOR 4XX*5191 09 MAR XX0054 25.00 BEECEPTOR 4XXXXX*5191 09 MAR XXXXXXXXXXXXXXXXXXX0054","Account Payment","25.00 BEECEPTOR 4XX*5191 09 MAR XX0054 25.00 BEECEPTOR 4XXXXX*5191 09 MAR XXXXXXXXXXXXXXXXXXX0054","467.84",,"278722.68"
,"11/03/2025","8400/000 : FNB","25.00 NOTION LABS, 4XX*5191 08 MAR XX7381 25.00 NOTION LABS, 4XXXXX*5191 08 MAR XXXXXXXXXXXXXXXXXXX7","Account Payment","25.00 NOTION LABS, 4XX*5191 08 MAR XX7381 25.00 NOTION LABS, 4XXXXX*5191 08 MAR XXXXXXXXXXXXXXXXXXX","467.84",,"279190.52"
,"11/03/2025","8400/000 : FNB","30.00 ISHRAQ LLC 4XX*5191 09 MAR XX3096 30.00 ISHRAQ LLC 4XXXXX*5191 09 MAR XXXXXXXXXXXXXXXXXXX3096","Account Payment","30.00 ISHRAQ LLC 4XX*5191 09 MAR XX3096 30.00 ISHRAQ LLC 4XXXXX*5191 09 MAR XXXXXXXXXXXXXXXXXXX3096","561.42",,"279751.94"
,"11/03/2025","8400/000 : FNB","Intuit 570.40 INTUIT *QBoo 4XXXXX*5225 09 MAR XXXXXXXXXXXXXXXXXXX7617 Intuit","Account Payment","Intuit 570.40 INTUIT *QBoo 4XXXXX*5225 09 MAR XXXXXXXXXXXXXXXXXXX7617 Intuit","570.4",,"280322.34"
,"11/03/2025","8400/000 : FNB","40.00 REPLIT, INC. 4XX*5191 09 MAR XX3571 40.00 REPLIT, INC. 4XXXXX*5191 09 MAR XXXXXXXXXXXXXXXXXXX3","Account Payment","40.00 REPLIT, INC. 4XX*5191 09 MAR XX3571 40.00 REPLIT, INC. 4XXXXX*5191 09 MAR XXXXXXXXXXXXXXXXXXX","748.55",,"281070.89"
,"11/03/2025","8400/000 : FNB","40.00 VERCEL INC. 4XX*5225 08 MAR XX3613 40.00 VERCEL INC. 4XXXXX*5225 08 MAR XXXXXXXXXXXXXXXXXXX361","Account Payment","40.00 VERCEL INC. 4XX*5225 08 MAR XX3613 40.00 VERCEL INC. 4XXXXX*5225 08 MAR XXXXXXXXXXXXXXXXXXX36","748.55",,"281819.44"
,"11/03/2025","8400/000 : FNB","49.00 SKRAPP.IO STA 4XX*5191 09 MAR XX6590 49.00 SKRAPP.IO STA 4XXXXX*5191 09 MAR XXXXXXXXXXXXXXXXXX","Account Payment","49.00 SKRAPP.IO STA 4XX*5191 09 MAR XX6590 49.00 SKRAPP.IO STA 4XXXXX*5191 09 MAR XXXXXXXXXXXXXXXXX","916.98",,"282736.42"
,"11/03/2025","8400/000 : FNB","69.00 OPENAI *CHATG 4XX*5191 09 MAR XX3181 69.00 OPENAI *CHATG 4XXXXX*5191 09 MAR XXXXXXXXXXXXXXXXXX","Account Payment","69.00 OPENAI *CHATG 4XX*5191 09 MAR XX3181 69.00 OPENAI *CHATG 4XXXXX*5191 09 MAR XXXXXXXXXXXXXXXXX","1291.25",,"284027.67"
,"11/03/2025","8400/000 : FNB","70.00 NOTION LABS, 4XX*5191 10 MAR XX6201 70.00 NOTION LABS, 4XXXXX*5191 10 MAR XXXXXXXXXXXXXXXXXXX6","Account Payment","70.00 NOTION LABS, 4XX*5191 10 MAR XX6201 70.00 NOTION LABS, 4XXXXX*5191 10 MAR XXXXXXXXXXXXXXXXXXX","1309.97",,"285337.64"
,"11/03/2025","8400/000 : FNB","Github Inc. 91.00 GITHUB, INC. 4XXXXX*5191 08 MAR XXXXXXXXXXXXXXXXXXX4888 Github Inc.","Account Payment","Github Inc. 91.00 GITHUB, INC. 4XXXXX*5191 08 MAR XXXXXXXXXXXXXXXXXXX4888 Github Inc.","1702.96",,"287040.6"
,"11/03/2025","8400/000 : FNB","150.00 AUTH0.COM 4XX*5191 08 MAR XX9532 150.00 AUTH0.COM 4XXXXX*5191 08 MAR XXXXXXXXXXXXXXXXXXX9532","Account Payment","150.00 AUTH0.COM 4XX*5191 08 MAR XX9532 150.00 AUTH0.COM 4XXXXX*5191 08 MAR XXXXXXXXXXXXXXXXXXX9532","2807.07",,"289847.67"
,"11/03/2025","8400/000 : FNB","499.00 CASSIDYAI.CO 4XX*5191 09 MAR XX6861 499.00 CASSIDYAI.CO 4XXXXX*5191 09 MAR XXXXXXXXXXXXXXXXXX","Account Payment","499.00 CASSIDYAI.CO 4XX*5191 09 MAR XX6861 499.00 CASSIDYAI.CO 4XXXXX*5191 09 MAR XXXXXXXXXXXXXXXXX","9338.19",,"299185.86"
,"12/03/2025","8400/000 : FNB","32.00 BUBBLE STARTE 4XX*5191 11 MAR XX7091 32.00 BUBBLE STARTE 4XXXXX*5191 11 MAR XXXXXXXXXXXXXXXXXX","Account Payment","32.00 BUBBLE STARTE 4XX*5191 11 MAR XX7091 32.00 BUBBLE STARTE 4XXXXX*5191 11 MAR XXXXXXXXXXXXXXXXX","600.59",,"299786.45"
,"12/03/2025","8400/000 : FNB","Shopify 3633.95 SHOPIFY* 33 4XXXXX*5225 10 MAR XXXXXXXXXXXXXXXXXXX5039 Shopify","Account Payment","Shopify 3633.95 SHOPIFY* 33 4XXXXX*5225 10 MAR XXXXXXXXXXXXXXXXXXX5039 Shopify","68005.05",,"367791.5"
,"12/03/2025","8400/000 : FNB","99.00 DYNAMIC.XYZ 4XX*5191 11 MAR XX0875 99.00 DYNAMIC.XYZ 4XXXXX*5191 11 MAR XXXXXXXXXXXXXXXXXXX087","Account Payment","99.00 DYNAMIC.XYZ 4XX*5191 11 MAR XX0875 99.00 DYNAMIC.XYZ 4XXXXX*5191 11 MAR XXXXXXXXXXXXXXXXXXX08","1858.06",,"369649.56"
,"13/03/2025","8400/000 : FNB","Intuit 570.40 INTUIT *QBoo 4XXXXX*5225 11 MAR XXXXXXXXXXXXXXXXXXX8146 Intuit","Account Payment","Intuit 570.40 INTUIT *QBoo 4XXXXX*5225 11 MAR XXXXXXXXXXXXXXXXXXX8146 Intuit","570.4",,"370219.96"
,"13/03/2025","8400/000 : FNB","Intuit 570.40 INTUIT *QBoo 4XXXXX*5225 11 MAR XXXXXXXXXXXXXXXXXXX8112 Intuit","Account Payment","Intuit 570.40 INTUIT *QBoo 4XXXXX*5225 11 MAR XXXXXXXXXXXXXXXXXXX8112 Intuit","570.4",,"370790.36"
,"13/03/2025","8400/000 : FNB","Github Inc. 42.00 GITHUB, INC. 4XXXXX*5191 11 MAR XXXXXXXXXXXXXXXXXXX9230 Github Inc.","Account Payment","Github Inc. 42.00 GITHUB, INC. 4XXXXX*5191 11 MAR XXXXXXXXXXXXXXXXXXX9230 Github Inc.","788.27",,"371578.63"
,"13/03/2025","8400/000 : FNB","Github Inc. 65.85 GITHUB, INC. 4XXXXX*5191 11 MAR XXXXXXXXXXXXXXXXXXX1385 Github Inc.","Account Payment","Github Inc. 65.85 GITHUB, INC. 4XXXXX*5191 11 MAR XXXXXXXXXXXXXXXXXXX1385 Github Inc.","1235.89",,"372814.52"
,"13/03/2025","8400/000 : FNB","Shopify 74.75 SHOPIFY* 3401 4XXXXX*5225 11 MAR XXXXXXXXXXXXXXXXXXX9481 Shopify","Account Payment","Shopify 74.75 SHOPIFY* 3401 4XXXXX*5225 11 MAR XXXXXXXXXXXXXXXXXXX9481 Shopify","1402.93",,"374217.45"
,"13/03/2025","8400/000 : FNB","Github Inc. 210.00 GITHUB, INC. 4XXXXX*5225 11 MAR XXXXXXXXXXXXXXXXXXX8335 Github Inc.","Account Payment","Github Inc. 210.00 GITHUB, INC. 4XXXXX*5225 11 MAR XXXXXXXXXXXXXXXXXXX8335 Github Inc.","3941.34",,"378158.79"
,"14/03/2025","8400/000 : FNB","15.00 TABNINE 4XX*5191 12 MAR XX1486 15.00 TABNINE 4XXXXX*5191 12 MAR XXXXXXXXXXXXXXXXXXX1486","Account Payment","15.00 TABNINE 4XX*5191 12 MAR XX1486 15.00 TABNINE 4XXXXX*5191 12 MAR XXXXXXXXXXXXXXXXXXX1486","281.74",,"378440.53"
,"15/03/2025","8400/000 : FNB","180.00 AGENCYANALYT 4XX*5225 13 MAR XX2929 180.00 AGENCYANALYT 4XXXXX*5225 13 MAR XXXXXXXXXXXXXXXXXX","Account Payment","180.00 AGENCYANALYT 4XX*5225 13 MAR XX2929 180.00 AGENCYANALYT 4XXXXX*5225 13 MAR XXXXXXXXXXXXXXXXX","3391.46",,"381831.99"
,"15/03/2025","8400/000 : FNB","11.49 GOOGLE *Colab 4XX*5191 14 MAR XX8368 11.49 GOOGLE *Colab 4XXXXX*5191 14 MAR XXXXXXXXXXXXXXXXXX","Account Payment","11.49 GOOGLE *Colab 4XX*5191 14 MAR XX8368 11.49 GOOGLE *Colab 4XXXXX*5191 14 MAR XXXXXXXXXXXXXXXXX","216.29",,"382048.28"
,"15/03/2025","8400/000 : FNB","27.55 RAILWAY 4XX*5191 13 MAR XX4684 27.55 RAILWAY 4XXXXX*5191 13 MAR XXXXXXXXXXXXXXXXXXX4684","Account Payment","27.55 RAILWAY 4XX*5191 13 MAR XX4684 27.55 RAILWAY 4XXXXX*5191 13 MAR XXXXXXXXXXXXXXXXXXX4684","519.08",,"382567.36"
,"15/03/2025","8400/000 : FNB","5.00 WWW.FLUX.AI 4XX*5191 13 MAR XX5103 5.00 WWW.FLUX.AI 4XXXXX*5191 13 MAR XXXXXXXXXXXXXXXXXXX5103","Account Payment","5.00 WWW.FLUX.AI 4XX*5191 13 MAR XX5103 5.00 WWW.FLUX.AI 4XXXXX*5191 13 MAR XXXXXXXXXXXXXXXXXXX5103","94.21",,"382661.57"
,"15/03/2025","8400/000 : FNB","113.85 DNH*GODADDY# 4XX*5191 12 MAR XX7948 113.85 DNH*GODADDY# 4XXXXX*5191 12 MAR XXXXXXXXXXXXXXXXXX","Account Payment","113.85 DNH*GODADDY 4XX*5191 12 MAR XX7948 113.85 DNH*GODADDY 4XXXXX*5191 12 MAR XXXXXXXXXXXXXXXXX","113.85",,"382775.42"
,"17/03/2025","8400/000 : FNB","1.00 VERCEL INC. 4XXXXX*5225 13 MAR XXXXXXXXXXXXXXXXXXX7346 1.00 VERCEL INC. 4XXXXX*5225 13 MAR XXXX","Account Receipt","1.00 VERCEL INC. 4XXXXX*5225 13 MAR XXXXXXXXXXXXXXXXXXX7346 1.00 VERCEL INC. 4XXXXX*5225 13 MAR XXX",,"17.76","382757.66"
,"17/03/2025","8400/000 : FNB","Github Inc. 14.00 GITHUB, INC. 4XXXXX*5225 14 MAR XXXXXXXXXXXXXXXXXXX8781 Github Inc.","Account Payment","Github Inc. 14.00 GITHUB, INC. 4XXXXX*5225 14 MAR XXXXXXXXXXXXXXXXXXX8781 Github Inc.","263.54",,"383021.2"
,"17/03/2025","8400/000 : FNB","Intuit 570.40 INTUIT *QBoo 4XXXXX*5225 14 MAR XXXXXXXXXXXXXXXXXXX8698 Intuit","Account Payment","Intuit 570.40 INTUIT *QBoo 4XXXXX*5225 14 MAR XXXXXXXXXXXXXXXXXXX8698 Intuit","570.4",,"383591.6"
,"17/03/2025","8400/000 : FNB","41.86 REPLIT, INC. 4XX*5191 14 MAR XX2877 41.86 REPLIT, INC. 4XXXXX*5191 14 MAR XXXXXXXXXXXXXXXXXXX2","Account Payment","41.86 REPLIT, INC. 4XX*5191 14 MAR XX2877 41.86 REPLIT, INC. 4XXXXX*5191 14 MAR XXXXXXXXXXXXXXXXXXX","787.97",,"384379.57"
,"17/03/2025","8400/000 : FNB","55.52 RAILWAY 4XX*5191 14 MAR XX1139 55.52 RAILWAY 4XXXXX*5191 14 MAR XXXXXXXXXXXXXXXXXXX1139","Account Payment","55.52 RAILWAY 4XX*5191 14 MAR XX1139 55.52 RAILWAY 4XXXXX*5191 14 MAR XXXXXXXXXXXXXXXXXXX1139","1045.1",,"385424.67"
,"17/03/2025","8400/000 : FNB","172.50 OPENAI *CHAT 4XX*5191 14 MAR XX7850 172.50 OPENAI *CHAT 4XXXXX*5191 14 MAR XXXXXXXXXXXXXXXXXX","Account Payment","172.50 OPENAI *CHAT 4XX*5191 14 MAR XX7850 172.50 OPENAI *CHAT 4XXXXX*5191 14 MAR XXXXXXXXXXXXXXXXX","3247.12",,"388671.79"
,"18/03/2025","8400/000 : FNB","227.70 DNH*GODADDY# 4XX*5191 14 MAR XX9865 227.70 DNH*GODADDY# 4XXXXX*5191 14 MAR XXXXXXXXXXXXXXXXXX","Account Payment","227.70 DNH*GODADDY 4XX*5191 14 MAR XX9865 227.70 DNH*GODADDY 4XXXXX*5191 14 MAR XXXXXXXXXXXXXXXXX","227.7",,"388899.49"
,"18/03/2025","8400/000 : FNB","139.24 SLACK T0MN3D 4XX*5225 15 MAR XX6829 139.24 SLACK T0MN3D 4XXXXX*5225 15 MAR XXXXXXXXXXXXXXXXXX","Account Payment","139.24 SLACK T0MN3D 4XX*5225 15 MAR XX6829 139.24 SLACK T0MN3D 4XXXXX*5225 15 MAR XXXXXXXXXXXXXXXXX","2610.88",,"391510.37"
,"18/03/2025","8400/000 : FNB","231.95 HOLASPIRIT 4XX*5225 15 MAR XX5392 231.95 HOLASPIRIT 4XXXXX*5225 15 MAR XXXXXXXXXXXXXXXXXXX539","Account Payment","231.95 HOLASPIRIT 4XX*5225 15 MAR XX5392 231.95 HOLASPIRIT 4XXXXX*5225 15 MAR XXXXXXXXXXXXXXXXXXX53","4710.77",,"396221.14"
,"18/03/2025","8400/000 : FNB","280.00 WIZA.CO 4XX*5191 14 MAR XX1430 280.00 WIZA.CO 4XXXXX*5191 14 MAR XXXXXXXXXXXXXXXXXXX1430","Account Payment","280.00 WIZA.CO 4XX*5191 14 MAR XX1430 280.00 WIZA.CO 4XXXXX*5191 14 MAR XXXXXXXXXXXXXXXXXXX1430","5270.69",,"401491.83"
,"18/03/2025","8400/000 : FNB","376.40 HOLASPIRIT 4XX*5225 15 MAR XX4648 376.40 HOLASPIRIT 4XXXXX*5225 15 MAR XXXXXXXXXXXXXXXXXXX464","Account Payment","376.40 HOLASPIRIT 4XX*5225 15 MAR XX4648 376.40 HOLASPIRIT 4XXXXX*5225 15 MAR XXXXXXXXXXXXXXXXXXX46","7644.46",,"409136.29"
,"19/03/2025","8400/000 : FNB","10.08 REPLIT, INC. 4XX*5191 17 MAR XX2665 10.08 REPLIT, INC. 4XXXXX*5191 17 MAR XXXXXXXXXXXXXXXXXXX2","Account Payment","10.08 REPLIT, INC. 4XX*5191 17 MAR XX2665 10.08 REPLIT, INC. 4XXXXX*5191 17 MAR XXXXXXXXXXXXXXXXXXX","189.01",,"409325.3"
,"19/03/2025","8400/000 : FNB","20.00 HUGGINGFACE 4XX*5191 18 MAR XX4194 20.00 HUGGINGFACE 4XXXXX*5191 18 MAR XXXXXXXXXXXXXXXXXXX419","Account Payment","20.00 HUGGINGFACE 4XX*5191 18 MAR XX4194 20.00 HUGGINGFACE 4XXXXX*5191 18 MAR XXXXXXXXXXXXXXXXXXX41","372.77",,"409698.07"
,"19/03/2025","8400/000 : FNB","50.16 LINODE . AKAM 4XX*5191 18 MAR XX6276 50.16 LINODE . AKAM 4XXXXX*5191 18 MAR XXXXXXXXXXXXXXXXXX","Account Payment","50.16 LINODE . AKAM 4XX*5191 18 MAR XX6276 50.16 LINODE . AKAM 4XXXXX*5191 18 MAR XXXXXXXXXXXXXXXXX","934.91",,"410632.98"
,"19/03/2025","8400/000 : FNB","Google Service Charges/Fees #INT PYMT FEE-434.99 Goog Google","Account Payment","Google Service Charges/Fees INT PYMT FEE-434.99 Goog Google","8.7",,"410641.68"
,"19/03/2025","8400/000 : FNB","Google Service Charges/Fees #INT PYMT FEE-34.99 Googl Google","Account Payment","Google Service Charges/Fees INT PYMT FEE-34.99 Googl Google","0.7",,"410642.38"
,"20/03/2025","8400/000 : FNB","4.98 REPLIT, INC. 4XX*5191 19 MAR XX3377 4.98 REPLIT, INC. 4XXXXX*5191 19 MAR XXXXXXXXXXXXXXXXXXX337","Account Payment","4.98 REPLIT, INC. 4XX*5191 19 MAR XX3377 4.98 REPLIT, INC. 4XXXXX*5191 19 MAR XXXXXXXXXXXXXXXXXXX33","92.36",,"410734.74"
,"20/03/2025","8400/000 : FNB","350.00 FRAMER.COM 4XX*5191 18 MAR XX0754 350.00 FRAMER.COM 4XXXXX*5191 18 MAR XXXXXXXXXXXXXXXXXXX075","Account Payment","350.00 FRAMER.COM 4XX*5191 18 MAR XX0754 350.00 FRAMER.COM 4XXXXX*5191 18 MAR XXXXXXXXXXXXXXXXXXX07","350",,"411084.74"
,"20/03/2025","8400/000 : FNB","20.00 VERCEL INC. 4XX*5191 18 MAR XX3704 20.00 VERCEL INC. 4XXXXX*5191 18 MAR XXXXXXXXXXXXXXXXXXX370","Account Payment","20.00 VERCEL INC. 4XX*5191 18 MAR XX3704 20.00 VERCEL INC. 4XXXXX*5191 18 MAR XXXXXXXXXXXXXXXXXXX37","372.77",,"411457.51"
,"22/03/2025","8400/000 : FNB","9.90 REPLIT, INC. 4XX*5191 20 MAR XX5597 9.90 REPLIT, INC. 4XXXXX*5191 20 MAR XXXXXXXXXXXXXXXXXXX559","Account Payment","9.90 REPLIT, INC. 4XX*5191 20 MAR XX5597 9.90 REPLIT, INC. 4XXXXX*5191 20 MAR XXXXXXXXXXXXXXXXXXX55","184.76",,"411642.27"
,"22/03/2025","8400/000 : FNB","10.03 REPLIT, INC. 4XX*5191 19 MAR XX0791 10.03 REPLIT, INC. 4XXXXX*5191 19 MAR XXXXXXXXXXXXXXXXXXX0","Account Payment","10.03 REPLIT, INC. 4XX*5191 19 MAR XX0791 10.03 REPLIT, INC. 4XXXXX*5191 19 MAR XXXXXXXXXXXXXXXXXXX","186.02",,"411828.29"
,"22/03/2025","8400/000 : FNB","54.00 AIRTABLE.COM/ 4XX*5191 21 MAR XX5485 54.00 AIRTABLE.COM/ 4XXXXX*5191 21 MAR XXXXXXXXXXXXXXXXXX","Account Payment","54.00 AIRTABLE.COM/ 4XX*5191 21 MAR XX5485 54.00 AIRTABLE.COM/ 4XXXXX*5191 21 MAR XXXXXXXXXXXXXXXXX","1006.08",,"412834.37"
,"22/03/2025","8400/000 : FNB","59.00 GREENBACK.COM 4XX*5225 19 MAR XX7950 59.00 GREENBACK.COM 4XXXXX*5225 19 MAR XXXXXXXXXXXXXXXXXX","Account Payment","59.00 GREENBACK.COM 4XX*5225 19 MAR XX7950 59.00 GREENBACK.COM 4XXXXX*5225 19 MAR XXXXXXXXXXXXXXXXX","1094.19",,"413928.56"
,"22/03/2025","8400/000 : FNB","1265.00 FACEBK *WPX 4XX*5191 20 MAR XX7070 1265.00 FACEBK *WPX 4XXXXX*5191 20 MAR XXXXXXXXXXXXXXXXXX","Account Payment","1265.00 FACEBK *WPX 4XX*5191 20 MAR XX7070 1265.00 FACEBK *WPX 4XXXXX*5191 20 MAR XXXXXXXXXXXXXXXXX","1265",,"415193.56"
,"22/03/2025","8400/000 : FNB","74.00 PIPEDREAM, IN 4XX*5191 20 MAR XX4703 74.00 PIPEDREAM, IN 4XXXXX*5191 20 MAR XXXXXXXXXXXXXXXXXX","Account Payment","74.00 PIPEDREAM, IN 4XX*5191 20 MAR XX4703 74.00 PIPEDREAM, IN 4XXXXX*5191 20 MAR XXXXXXXXXXXXXXXXX","1381.09",,"416574.65"
,"22/03/2025","8400/000 : FNB","103.64 OPENAI 4XX*5191 20 MAR XX9574 103.64 OPENAI 4XXXXX*5191 20 MAR XXXXXXXXXXXXXXXXXXX9574","Account Payment","103.64 OPENAI 4XX*5191 20 MAR XX9574 103.64 OPENAI 4XXXXX*5191 20 MAR XXXXXXXXXXXXXXXXXXX9574","1934.27",,"418508.92"
,"22/03/2025","8400/000 : FNB","103.85 OPENAI 4XX*5191 20 MAR XX5742 103.85 OPENAI 4XXXXX*5191 20 MAR XXXXXXXXXXXXXXXXXXX5742","Account Payment","103.85 OPENAI 4XX*5191 20 MAR XX5742 103.85 OPENAI 4XXXXX*5191 20 MAR XXXXXXXXXXXXXXXXXXX5742","1934.84",,"420443.76"
,"22/03/2025","8400/000 : FNB","103.81 OPENAI 4XX*5191 20 MAR XX1230 103.81 OPENAI 4XXXXX*5191 20 MAR XXXXXXXXXXXXXXXXXXX1230","Account Payment","103.81 OPENAI 4XX*5191 20 MAR XX1230 103.81 OPENAI 4XXXXX*5191 20 MAR XXXXXXXXXXXXXXXXXXX1230","1937.44",,"422381.2"
,"22/03/2025","8400/000 : FNB","104.13 OPENAI 4XX*5191 20 MAR XX6719 104.13 OPENAI 4XXXXX*5191 20 MAR XXXXXXXXXXXXXXXXXXX6719","Account Payment","104.13 OPENAI 4XX*5191 20 MAR XX6719 104.13 OPENAI 4XXXXX*5191 20 MAR XXXXXXXXXXXXXXXXXXX6719","1943.42",,"424324.62"
,"22/03/2025","8400/000 : FNB","104.32 OPENAI 4XX*5191 21 MAR XX9252 104.32 OPENAI 4XXXXX*5191 21 MAR XXXXXXXXXXXXXXXXXXX9252","Account Payment","104.32 OPENAI 4XX*5191 21 MAR XX9252 104.32 OPENAI 4XXXXX*5191 21 MAR XXXXXXXXXXXXXXXXXXX9252","1943.6",,"426268.22"
,"22/03/2025","8400/000 : FNB","106.02 OPENAI 4XX*5191 21 MAR XX6542 106.02 OPENAI 4XXXXX*5191 21 MAR XXXXXXXXXXXXXXXXXXX6542","Account Payment","106.02 OPENAI 4XX*5191 21 MAR XX6542 106.02 OPENAI 4XXXXX*5191 21 MAR XXXXXXXXXXXXXXXXXXX6542","1975.27",,"428243.49"
,"22/03/2025","8400/000 : FNB","115.00 OPENAI 4XX*5191 19 MAR XX2236 115.00 OPENAI 4XXXXX*5191 19 MAR XXXXXXXXXXXXXXXXXXX2236","Account Payment","115.00 OPENAI 4XX*5191 19 MAR XX2236 115.00 OPENAI 4XXXXX*5191 19 MAR XXXXXXXXXXXXXXXXXXX2236","2132.76",,"430376.25"
,"22/03/2025","8400/000 : FNB","3085.00 FRAMER.COM 4XX*5191 20 MAR XX2632 3085.00 FRAMER.COM 4XXXXX*5191 20 MAR XXXXXXXXXXXXXXXXXXX2","Account Payment","3085.00 FRAMER.COM 4XX*5191 20 MAR XX2632 3085.00 FRAMER.COM 4XXXXX*5191 20 MAR XXXXXXXXXXXXXXXXXXX","3085",,"433461.25"
,"22/03/2025","8400/000 : FNB","374.00 MANGOAPPS 4XX*5191 19 MAR XX7618 374.00 MANGOAPPS 4XXXXX*5191 19 MAR XXXXXXXXXXXXXXXXXXX7618","Account Payment","374.00 MANGOAPPS 4XX*5191 19 MAR XX7618 374.00 MANGOAPPS 4XXXXX*5191 19 MAR XXXXXXXXXXXXXXXXXXX7618","6936.1",,"440397.35"
,"22/03/2025","8400/000 : FNB","456.00 ANIMA APP, I 4XX*5191 20 MAR XX6065 456.00 ANIMA APP, I 4XXXXX*5191 20 MAR XXXXXXXXXXXXXXXXXX","Account Payment","456.00 ANIMA APP, I 4XX*5191 20 MAR XX6065 456.00 ANIMA APP, I 4XXXXX*5191 20 MAR XXXXXXXXXXXXXXXXX","8510.48",,"448907.83"
,"22/03/2025","8400/000 : FNB","456.00 ANIMA APP, I 4XX*5191 20 MAR XX0583 456.00 ANIMA APP, I 4XXXXX*5191 20 MAR XXXXXXXXXXXXXXXXXX","Account Payment","456.00 ANIMA APP, I 4XX*5191 20 MAR XX0583 456.00 ANIMA APP, I 4XXXXX*5191 20 MAR XXXXXXXXXXXXXXXXX","8510.48",,"457418.31"
,"24/03/2025","8400/000 : FNB","103.68 OPENAI 4XX*5191 21 MAR XX0574 103.68 OPENAI 4XXXXX*5191 21 MAR XXXXXXXXXXXXXXXXXXX0574","Account Payment","103.68 OPENAI 4XX*5191 21 MAR XX0574 103.68 OPENAI 4XXXXX*5191 21 MAR XXXXXXXXXXXXXXXXXXX0574","1931.68",,"459349.99"
,"24/03/2025","8400/000 : FNB","103.66 OPENAI 4XX*5191 21 MAR XX9278 103.66 OPENAI 4XXXXX*5191 21 MAR XXXXXXXXXXXXXXXXXXX9278","Account Payment","103.66 OPENAI 4XX*5191 21 MAR XX9278 103.66 OPENAI 4XXXXX*5191 21 MAR XXXXXXXXXXXXXXXXXXX9278","1932.03",,"461282.02"
,"24/03/2025","8400/000 : FNB","103.74 OPENAI 4XX*5191 22 MAR XX4295 103.74 OPENAI 4XXXXX*5191 22 MAR XXXXXXXXXXXXXXXXXXX4295","Account Payment","103.74 OPENAI 4XX*5191 22 MAR XX4295 103.74 OPENAI 4XXXXX*5191 22 MAR XXXXXXXXXXXXXXXXXXX4295","1933.52",,"463215.54"
,"24/03/2025","8400/000 : FNB","104.02 OPENAI 4XX*5191 21 MAR XX3447 104.02 OPENAI 4XXXXX*5191 21 MAR XXXXXXXXXXXXXXXXXXX3447","Account Payment","104.02 OPENAI 4XX*5191 21 MAR XX3447 104.02 OPENAI 4XXXXX*5191 21 MAR XXXXXXXXXXXXXXXXXXX3447","1938.01",,"465153.55"
,"24/03/2025","8400/000 : FNB","104.10 OPENAI 4XX*5191 22 MAR XX4974 104.10 OPENAI 4XXXXX*5191 22 MAR XXXXXXXXXXXXXXXXXXX4974","Account Payment","104.10 OPENAI 4XX*5191 22 MAR XX4974 104.10 OPENAI 4XXXXX*5191 22 MAR XXXXXXXXXXXXXXXXXXX4974","1940.23",,"467093.78"
,"24/03/2025","8400/000 : FNB","105.04 OPENAI 4XX*5191 21 MAR XX5004 105.04 OPENAI 4XXXXX*5191 21 MAR XXXXXXXXXXXXXXXXXXX5004","Account Payment","105.04 OPENAI 4XX*5191 21 MAR XX5004 105.04 OPENAI 4XXXXX*5191 21 MAR XXXXXXXXXXXXXXXXXXX5004","1957.01",,"469050.79"
,"24/03/2025","8400/000 : FNB","105.66 OPENAI 4XX*5191 21 MAR XX6438 105.66 OPENAI 4XXXXX*5191 21 MAR XXXXXXXXXXXXXXXXXXX6438","Account Payment","105.66 OPENAI 4XX*5191 21 MAR XX6438 105.66 OPENAI 4XXXXX*5191 21 MAR XXXXXXXXXXXXXXXXXXX6438","1968.56",,"471019.35"
,"24/03/2025","8400/000 : FNB","105.88 OPENAI 4XX*5191 21 MAR XX3405 105.88 OPENAI 4XXXXX*5191 21 MAR XXXXXXXXXXXXXXXXXXX3405","Account Payment","105.88 OPENAI 4XX*5191 21 MAR XX3405 105.88 OPENAI 4XXXXX*5191 21 MAR XXXXXXXXXXXXXXXXXXX3405","1972.66",,"472992.01"
,"25/03/2025","8400/000 : FNB","6.00 DOCKER, INC. 4XX*5191 24 MAR XX1623 6.00 DOCKER, INC. 4XXXXX*5191 24 MAR XXXXXXXXXXXXXXXXXXX162","Account Payment","6.00 DOCKER, INC. 4XX*5191 24 MAR XX1623 6.00 DOCKER, INC. 4XXXXX*5191 24 MAR XXXXXXXXXXXXXXXXXXX16","111.83",,"473103.84"
,"25/03/2025","8400/000 : FNB","30.00 HASURA 4XX*5191 23 MAR XX8567 30.00 HASURA 4XXXXX*5191 23 MAR XXXXXXXXXXXXXXXXXXX8567","Account Payment","30.00 HASURA 4XX*5191 23 MAR XX8567 30.00 HASURA 4XXXXX*5191 23 MAR XXXXXXXXXXXXXXXXXXX8567","559.14",,"473662.98"
,"25/03/2025","8400/000 : FNB","89.00 SENTRY 4XX*5191 24 MAR XX9774 89.00 SENTRY 4XXXXX*5191 24 MAR XXXXXXXXXXXXXXXXXXX9774","Account Payment","89.00 SENTRY 4XX*5191 24 MAR XX9774 89.00 SENTRY 4XXXXX*5191 24 MAR XXXXXXXXXXXXXXXXXXX9774","1658.8",,"475321.78"
,"25/03/2025","8400/000 : FNB","103.65 OPENAI 4XX*5191 23 MAR XX9251 103.65 OPENAI 4XXXXX*5191 23 MAR XXXXXXXXXXXXXXXXXXX9251","Account Payment","103.65 OPENAI 4XX*5191 23 MAR XX9251 103.65 OPENAI 4XXXXX*5191 23 MAR XXXXXXXXXXXXXXXXXXX9251","1931.84",,"477253.62"
,"25/03/2025","8400/000 : FNB","103.66 OPENAI 4XX*5191 22 MAR XX9090 103.66 OPENAI 4XXXXX*5191 22 MAR XXXXXXXXXXXXXXXXXXX9090","Account Payment","103.66 OPENAI 4XX*5191 22 MAR XX9090 103.66 OPENAI 4XXXXX*5191 22 MAR XXXXXXXXXXXXXXXXXXX9090","1932.03",,"479185.65"
,"25/03/2025","8400/000 : FNB","103.97 OPENAI 4XX*5191 23 MAR XX2958 103.97 OPENAI 4XXXXX*5191 23 MAR XXXXXXXXXXXXXXXXXXX2958","Account Payment","103.97 OPENAI 4XX*5191 23 MAR XX2958 103.97 OPENAI 4XXXXX*5191 23 MAR XXXXXXXXXXXXXXXXXXX2958","1937.81",,"481123.46"
,"25/03/2025","8400/000 : FNB","103.97 OPENAI 4XX*5191 23 MAR XX3880 103.97 OPENAI 4XXXXX*5191 23 MAR XXXXXXXXXXXXXXXXXXX3880","Account Payment","103.97 OPENAI 4XX*5191 23 MAR XX3880 103.97 OPENAI 4XXXXX*5191 23 MAR XXXXXXXXXXXXXXXXXXX3880","1937.81",,"483061.27"
,"25/03/2025","8400/000 : FNB","104.01 OPENAI 4XX*5191 24 MAR XX0502 104.01 OPENAI 4XXXXX*5191 24 MAR XXXXXXXXXXXXXXXXXXX0502","Account Payment","104.01 OPENAI 4XX*5191 24 MAR XX0502 104.01 OPENAI 4XXXXX*5191 24 MAR XXXXXXXXXXXXXXXXXXX0502","1938.55",,"484999.82"
,"25/03/2025","8400/000 : FNB","104.13 OPENAI 4XX*5191 22 MAR XX3241 104.13 OPENAI 4XXXXX*5191 22 MAR XXXXXXXXXXXXXXXXXXX3241","Account Payment","104.13 OPENAI 4XX*5191 22 MAR XX3241 104.13 OPENAI 4XXXXX*5191 22 MAR XXXXXXXXXXXXXXXXXXX3241","1940.78",,"486940.6"
,"25/03/2025","8400/000 : FNB","104.27 OPENAI 4XX*5191 23 MAR XX4863 104.27 OPENAI 4XXXXX*5191 23 MAR XXXXXXXXXXXXXXXXXXX4863","Account Payment","104.27 OPENAI 4XX*5191 23 MAR XX4863 104.27 OPENAI 4XXXXX*5191 23 MAR XXXXXXXXXXXXXXXXXXX4863","1943.4",,"488884"
,"25/03/2025","8400/000 : FNB","104.33 OPENAI 4XX*5191 23 MAR XX7841 104.33 OPENAI 4XXXXX*5191 23 MAR XXXXXXXXXXXXXXXXXXX7841","Account Payment","104.33 OPENAI 4XX*5191 23 MAR XX7841 104.33 OPENAI 4XXXXX*5191 23 MAR XXXXXXXXXXXXXXXXXXX7841","1944.52",,"490828.52"
,"25/03/2025","8400/000 : FNB","104.33 OPENAI 4XX*5191 23 MAR XX2618 104.33 OPENAI 4XXXXX*5191 23 MAR XXXXXXXXXXXXXXXXXXX2618","Account Payment","104.33 OPENAI 4XX*5191 23 MAR XX2618 104.33 OPENAI 4XXXXX*5191 23 MAR XXXXXXXXXXXXXXXXXXX2618","1944.52",,"492773.04"
,"25/03/2025","8400/000 : FNB","104.62 OPENAI 4XX*5191 23 MAR XX3592 104.62 OPENAI 4XXXXX*5191 23 MAR XXXXXXXXXXXXXXXXXXX3592","Account Payment","104.62 OPENAI 4XX*5191 23 MAR XX3592 104.62 OPENAI 4XXXXX*5191 23 MAR XXXXXXXXXXXXXXXXXXX3592","1949.92",,"494722.96"
,"25/03/2025","8400/000 : FNB","104.68 OPENAI 4XX*5191 24 MAR XX4651 104.68 OPENAI 4XXXXX*5191 24 MAR XXXXXXXXXXXXXXXXXXX4651","Account Payment","104.68 OPENAI 4XX*5191 24 MAR XX4651 104.68 OPENAI 4XXXXX*5191 24 MAR XXXXXXXXXXXXXXXXXXX4651","1951.04",,"496674"
,"25/03/2025","8400/000 : FNB","104.91 OPENAI 4XX*5191 22 MAR XX7585 104.91 OPENAI 4XXXXX*5191 22 MAR XXXXXXXXXXXXXXXXXXX7585","Account Payment","104.91 OPENAI 4XX*5191 22 MAR XX7585 104.91 OPENAI 4XXXXX*5191 22 MAR XXXXXXXXXXXXXXXXXXX7585","1955.33",,"498629.33"
,"25/03/2025","8400/000 : FNB","104.95 OPENAI 4XX*5191 23 MAR XX2690 104.95 OPENAI 4XXXXX*5191 23 MAR XXXXXXXXXXXXXXXXXXX2690","Account Payment","104.95 OPENAI 4XX*5191 23 MAR XX2690 104.95 OPENAI 4XXXXX*5191 23 MAR XXXXXXXXXXXXXXXXXXX2690","1956.07",,"500585.4"
,"25/03/2025","8400/000 : FNB","105.11 OPENAI 4XX*5191 23 MAR XX1046 105.11 OPENAI 4XXXXX*5191 23 MAR XXXXXXXXXXXXXXXXXXX1046","Account Payment","105.11 OPENAI 4XX*5191 23 MAR XX1046 105.11 OPENAI 4XXXXX*5191 23 MAR XXXXXXXXXXXXXXXXXXX1046","1959.05",,"502544.45"
,"25/03/2025","8400/000 : FNB","106.00 OPENAI 4XX*5191 23 MAR XX6236 106.00 OPENAI 4XXXXX*5191 23 MAR XXXXXXXXXXXXXXXXXXX6236","Account Payment","106.00 OPENAI 4XX*5191 23 MAR XX6236 106.00 OPENAI 4XXXXX*5191 23 MAR XXXXXXXXXXXXXXXXXXX6236","1975.64",,"504520.09"
,"25/03/2025","8400/000 : FNB","106.43 OPENAI 4XX*5191 23 MAR XX4883 106.43 OPENAI 4XXXXX*5191 23 MAR XXXXXXXXXXXXXXXXXXX4883","Account Payment","106.43 OPENAI 4XX*5191 23 MAR XX4883 106.43 OPENAI 4XXXXX*5191 23 MAR XXXXXXXXXXXXXXXXXXX4883","1983.66",,"506503.75"
,"25/03/2025","8400/000 : FNB","106.46 OPENAI 4XX*5191 22 MAR XX6085 106.46 OPENAI 4XXXXX*5191 22 MAR XXXXXXXXXXXXXXXXXXX6085","Account Payment","106.46 OPENAI 4XX*5191 22 MAR XX6085 106.46 OPENAI 4XXXXX*5191 22 MAR XXXXXXXXXXXXXXXXXXX6085","1984.22",,"508487.97"
,"25/03/2025","8400/000 : FNB","106.54 OPENAI 4XX*5191 23 MAR XX5802 106.54 OPENAI 4XXXXX*5191 23 MAR XXXXXXXXXXXXXXXXXXX5802","Account Payment","106.54 OPENAI 4XX*5191 23 MAR XX5802 106.54 OPENAI 4XXXXX*5191 23 MAR XXXXXXXXXXXXXXXXXXX5802","1985.71",,"510473.68"
,"25/03/2025","8400/000 : FNB","106.86 OPENAI 4XX*5191 24 MAR XX1897 106.86 OPENAI 4XXXXX*5191 24 MAR XXXXXXXXXXXXXXXXXXX1897","Account Payment","106.86 OPENAI 4XX*5191 24 MAR XX1897 106.86 OPENAI 4XXXXX*5191 24 MAR XXXXXXXXXXXXXXXXXXX1897","1991.67",,"512465.35"
,"25/03/2025","8400/000 : FNB","107.10 OPENAI 4XX*5191 24 MAR XX7744 107.10 OPENAI 4XXXXX*5191 24 MAR XXXXXXXXXXXXXXXXXXX7744","Account Payment","107.10 OPENAI 4XX*5191 24 MAR XX7744 107.10 OPENAI 4XXXXX*5191 24 MAR XXXXXXXXXXXXXXXXXXX7744","1996.14",,"514461.49"
,"25/03/2025","8400/000 : FNB","107.35 OPENAI 4XX*5191 24 MAR XX5461 107.35 OPENAI 4XXXXX*5191 24 MAR XXXXXXXXXXXXXXXXXXX5461","Account Payment","107.35 OPENAI 4XX*5191 24 MAR XX5461 107.35 OPENAI 4XXXXX*5191 24 MAR XXXXXXXXXXXXXXXXXXX5461","2000.8",,"516462.29"
,"25/03/2025","8400/000 : FNB","108.63 OPENAI 4XX*5191 24 MAR XX6389 108.63 OPENAI 4XXXXX*5191 24 MAR XXXXXXXXXXXXXXXXXXX6389","Account Payment","108.63 OPENAI 4XX*5191 24 MAR XX6389 108.63 OPENAI 4XXXXX*5191 24 MAR XXXXXXXXXXXXXXXXXXX6389","2024.66",,"518486.95"
,"25/03/2025","8400/000 : FNB","299.00 ORG CHART 4XX*5191 22 MAR XX6885 299.00 ORG CHART 4XXXXX*5191 22 MAR XXXXXXXXXXXXXXXXXXX6885","Account Payment","299.00 ORG CHART 4XX*5191 22 MAR XX6885 299.00 ORG CHART 4XXXXX*5191 22 MAR XXXXXXXXXXXXXXXXXXX6885","5572.8",,"524059.75"
,"26/03/2025","8400/000 : FNB","108.46 OPENAI 4XX*5191 25 MAR XX0638 108.46 OPENAI 4XXXXX*5191 25 MAR XXXXXXXXXXXXXXXXXXX0638","Account Payment","108.46 OPENAI 4XX*5191 25 MAR XX0638 108.46 OPENAI 4XXXXX*5191 25 MAR XXXXXXXXXXXXXXXXXXX0638","2021.32",,"526081.07"
,"26/03/2025","8400/000 : FNB","108.04 OPENAI 4XX*5191 24 MAR XX2821 108.04 OPENAI 4XXXXX*5191 24 MAR XXXXXXXXXXXXXXXXXXX2821","Account Payment","108.04 OPENAI 4XX*5191 24 MAR XX2821 108.04 OPENAI 4XXXXX*5191 24 MAR XXXXXXXXXXXXXXXXXXX2821","2013.66",,"528094.73"
,"26/03/2025","8400/000 : FNB","107.46 OPENAI 4XX*5191 25 MAR XX3161 107.46 OPENAI 4XXXXX*5191 25 MAR XXXXXXXXXXXXXXXXXXX3161","Account Payment","107.46 OPENAI 4XX*5191 25 MAR XX3161 107.46 OPENAI 4XXXXX*5191 25 MAR XXXXXXXXXXXXXXXXXXX3161","2002.69",,"530097.42"
,"26/03/2025","8400/000 : FNB","107.17 OPENAI 4XX*5191 24 MAR XX6665 107.17 OPENAI 4XXXXX*5191 24 MAR XXXXXXXXXXXXXXXXXXX6665","Account Payment","107.17 OPENAI 4XX*5191 24 MAR XX6665 107.17 OPENAI 4XXXXX*5191 24 MAR XXXXXXXXXXXXXXXXXXX6665","1997.45",,"532094.87"
,"26/03/2025","8400/000 : FNB","107.08 OPENAI 4XX*5191 24 MAR XX0012 107.08 OPENAI 4XXXXX*5191 24 MAR XXXXXXXXXXXXXXXXXXX0012","Account Payment","107.08 OPENAI 4XX*5191 24 MAR XX0012 107.08 OPENAI 4XXXXX*5191 24 MAR XXXXXXXXXXXXXXXXXXX0012","1995.77",,"534090.64"
,"26/03/2025","8400/000 : FNB","107.00 OPENAI 4XX*5191 24 MAR XX1221 107.00 OPENAI 4XXXXX*5191 24 MAR XXXXXXXXXXXXXXXXXXX1221","Account Payment","107.00 OPENAI 4XX*5191 24 MAR XX1221 107.00 OPENAI 4XXXXX*5191 24 MAR XXXXXXXXXXXXXXXXXXX1221","1994.28",,"536084.92"
,"26/03/2025","8400/000 : FNB","106.98 OPENAI 4XX*5191 24 MAR XX1851 106.98 OPENAI 4XXXXX*5191 24 MAR XXXXXXXXXXXXXXXXXXX1851","Account Payment","106.98 OPENAI 4XX*5191 24 MAR XX1851 106.98 OPENAI 4XXXXX*5191 24 MAR XXXXXXXXXXXXXXXXXXX1851","1993.91",,"538078.83"
,"26/03/2025","8400/000 : FNB","106.43 OPENAI 4XX*5191 25 MAR XX7191 106.43 OPENAI 4XXXXX*5191 25 MAR XXXXXXXXXXXXXXXXXXX7191","Account Payment","106.43 OPENAI 4XX*5191 25 MAR XX7191 106.43 OPENAI 4XXXXX*5191 25 MAR XXXXXXXXXXXXXXXXXXX7191","1983.49",,"540062.32"
,"26/03/2025","8400/000 : FNB","106.15 OPENAI 4XX*5191 25 MAR XX7891 106.15 OPENAI 4XXXXX*5191 25 MAR XXXXXXXXXXXXXXXXXXX7891","Account Payment","106.15 OPENAI 4XX*5191 25 MAR XX7891 106.15 OPENAI 4XXXXX*5191 25 MAR XXXXXXXXXXXXXXXXXXX7891","1978.28",,"542040.6"
,"26/03/2025","8400/000 : FNB","106.13 OPENAI 4XX*5191 24 MAR XX2989 106.13 OPENAI 4XXXXX*5191 24 MAR XXXXXXXXXXXXXXXXXXX2989","Account Payment","106.13 OPENAI 4XX*5191 24 MAR XX2989 106.13 OPENAI 4XXXXX*5191 24 MAR XXXXXXXXXXXXXXXXXXX2989","1978.07",,"544018.67"
,"26/03/2025","8400/000 : FNB","105.63 OPENAI 4XX*5191 24 MAR XX8765 105.63 OPENAI 4XXXXX*5191 24 MAR XXXXXXXXXXXXXXXXXXX8765","Account Payment","105.63 OPENAI 4XX*5191 24 MAR XX8765 105.63 OPENAI 4XXXXX*5191 24 MAR XXXXXXXXXXXXXXXXXXX8765","1968.58",,"545987.25"
,"26/03/2025","8400/000 : FNB","105.08 OPENAI 4XX*5191 25 MAR XX0314 105.08 OPENAI 4XXXXX*5191 25 MAR XXXXXXXXXXXXXXXXXXX0314","Account Payment","105.08 OPENAI 4XX*5191 25 MAR XX0314 105.08 OPENAI 4XXXXX*5191 25 MAR XXXXXXXXXXXXXXXXXXX0314","1958.34",,"547945.59"
,"26/03/2025","8400/000 : FNB","104.87 OPENAI 4XX*5191 24 MAR XX9661 104.87 OPENAI 4XXXXX*5191 24 MAR XXXXXXXXXXXXXXXXXXX9661","Account Payment","104.87 OPENAI 4XX*5191 24 MAR XX9661 104.87 OPENAI 4XXXXX*5191 24 MAR XXXXXXXXXXXXXXXXXXX9661","1954.59",,"549900.18"
,"26/03/2025","8400/000 : FNB","104.47 OPENAI 4XX*5191 25 MAR XX4738 104.47 OPENAI 4XXXXX*5191 25 MAR XXXXXXXXXXXXXXXXXXX4738","Account Payment","104.47 OPENAI 4XX*5191 25 MAR XX4738 104.47 OPENAI 4XXXXX*5191 25 MAR XXXXXXXXXXXXXXXXXXX4738","1946.97",,"551847.15"
,"26/03/2025","8400/000 : FNB","104.19 OPENAI 4XX*5191 24 MAR XX2173 104.19 OPENAI 4XXXXX*5191 24 MAR XXXXXXXXXXXXXXXXXXX2173","Account Payment","104.19 OPENAI 4XX*5191 24 MAR XX2173 104.19 OPENAI 4XXXXX*5191 24 MAR XXXXXXXXXXXXXXXXXXX2173","1941.91",,"553789.06"
,"26/03/2025","8400/000 : FNB","103.76 OPENAI 4XX*5191 25 MAR XX3290 103.76 OPENAI 4XXXXX*5191 25 MAR XXXXXXXXXXXXXXXXXXX3290","Account Payment","103.76 OPENAI 4XX*5191 25 MAR XX3290 103.76 OPENAI 4XXXXX*5191 25 MAR XXXXXXXXXXXXXXXXXXX3290","1933.74",,"555722.8"
,"26/03/2025","8400/000 : FNB","10.00 MATTERMOST 4XX*5191 24 MAR XX9398 10.00 MATTERMOST 4XXXXX*5191 24 MAR XXXXXXXXXXXXXXXXXXX9398","Account Payment","10.00 MATTERMOST 4XX*5191 24 MAR XX9398 10.00 MATTERMOST 4XXXXX*5191 24 MAR XXXXXXXXXXXXXXXXXXX9398","186.36",,"555909.16"
,"27/03/2025","8400/000 : FNB","150.00 AUTH0.COM 4XX*5191 25 MAR XX9784 150.00 AUTH0.COM 4XXXXX*5191 25 MAR XXXXXXXXXXXXXXXXXXX9784","Account Payment","150.00 AUTH0.COM 4XX*5191 25 MAR XX9784 150.00 AUTH0.COM 4XXXXX*5191 25 MAR XXXXXXXXXXXXXXXXXXX9784","2798.68",,"558707.84"
,"27/03/2025","8400/000 : FNB","107.10 OPENAI 4XX*5191 25 MAR XX6604 107.10 OPENAI 4XXXXX*5191 25 MAR XXXXXXXXXXXXXXXXXXX6604","Account Payment","107.10 OPENAI 4XX*5191 25 MAR XX6604 107.10 OPENAI 4XXXXX*5191 25 MAR XXXXXXXXXXXXXXXXXXX6604","1995.98",,"560703.82"
,"27/03/2025","8400/000 : FNB","104.64 OPENAI 4XX*5191 25 MAR XX0251 104.64 OPENAI 4XXXXX*5191 25 MAR XXXXXXXXXXXXXXXXXXX0251","Account Payment","104.64 OPENAI 4XX*5191 25 MAR XX0251 104.64 OPENAI 4XXXXX*5191 25 MAR XXXXXXXXXXXXXXXXXXX0251","1950.14",,"562653.96"
,"27/03/2025","8400/000 : FNB","103.81 OPENAI 4XX*5191 25 MAR XX3740 103.81 OPENAI 4XXXXX*5191 25 MAR XXXXXXXXXXXXXXXXXXX3740","Account Payment","103.81 OPENAI 4XX*5191 25 MAR XX3740 103.81 OPENAI 4XXXXX*5191 25 MAR XXXXXXXXXXXXXXXXXXX3740","1934.66",,"564588.62"
,"01/04/2025","8400/000 : FNB","5050.80 FRESHWORKS 4XX*5225 29 MAR XX0267 5050.80 FRESHWORKS 4XXXXX*5225 29 MAR XXXXXXXXXXXXXXXXXXX0","Account Payment","5050.80 FRESHWORKS 4XX*5225 29 MAR XX0267 5050.80 FRESHWORKS 4XXXXX*5225 29 MAR XXXXXXXXXXXXXXXXXXX","5050.8",,"569639.42"
,"01/04/2025","8400/000 : FNB","Facebook 346.90 FACEBK *YEG2 4XXXXX*5191 30 MAR XXXXXXXXXXXXXXXXXXX3172 Facebook","Account Payment","Facebook 346.90 FACEBK *YEG2 4XXXXX*5191 30 MAR XXXXXXXXXXXXXXXXXXX3172 Facebook","346.9",,"569986.32"
,"01/04/2025","8400/000 : FNB","1150.00 AUTH0.COM 4XX*5191 30 MAR XX1523 1150.00 AUTH0.COM 4XXXXX*5191 30 MAR XXXXXXXXXXXXXXXXXXX152","Account Payment","1150.00 AUTH0.COM 4XX*5191 30 MAR XX1523 1150.00 AUTH0.COM 4XXXXX*5191 30 MAR XXXXXXXXXXXXXXXXXXX15","21695.19",,"591681.51"
,"01/04/2025","8400/000 : FNB","50.00 OBSIDIAN.MD 4XX*5191 30 MAR XX5048 50.00 OBSIDIAN.MD 4XXXXX*5191 30 MAR XXXXXXXXXXXXXXXXXXX504","Account Payment","50.00 OBSIDIAN.MD 4XX*5191 30 MAR XX5048 50.00 OBSIDIAN.MD 4XXXXX*5191 30 MAR XXXXXXXXXXXXXXXXXXX50","943.27",,"592624.78"
,"02/04/2025","8400/000 : FNB","Shopify 3421.17 SHOPIFY* 34 4XXXXX*5191 31 MAR XXXXXXXXXXXXXXXXXXX1409 Shopify","Account Payment","Shopify 3421.17 SHOPIFY* 34 4XXXXX*5191 31 MAR XXXXXXXXXXXXXXXXXXX1409 Shopify","64541.66",,"657166.44"
,"02/04/2025","8400/000 : FNB","Wix.com 182.85 WIX.COM 4XXXXX*5191 01 APR XXXXXXXXXXXXXXXXXXX6957 Wix.com","Account Payment","Wix.com 182.85 WIX.COM 4XXXXX*5191 01 APR XXXXXXXXXXXXXXXXXXX6957 Wix.com","3440.11",,"660606.55"
,"02/04/2025","8400/000 : FNB","Digitalocean 47.84 DIGITALOCEAN. 4XXXXX*5191 01 APR XXXXXXXXXXXXXXXXXXX2879 Digitalocean","Account Payment","Digitalocean 47.84 DIGITALOCEAN. 4XXXXX*5191 01 APR XXXXXXXXXXXXXXXXXXX2879 Digitalocean","900.06",,"661506.61"
,"02/04/2025","8400/000 : FNB","31.84 LINODE . AKAM 4XX*5191 01 APR XX3030 31.84 LINODE . AKAM 4XXXXX*5191 01 APR XXXXXXXXXXXXXXXXXX","Account Payment","31.84 LINODE . AKAM 4XX*5191 01 APR XX3030 31.84 LINODE . AKAM 4XXXXX*5191 01 APR XXXXXXXXXXXXXXXXX","599.04",,"662105.65"
,"03/04/2025","8400/000 : FNB","1.00 VERCEL INC. 4XX*5225 01 APR XX5234 1.00 VERCEL INC. 4XXXXX*5225 01 APR XXXXXXXXXXXXXXXXXXX5234","Account Payment","1.00 VERCEL INC. 4XX*5225 01 APR XX5234 1.00 VERCEL INC. 4XXXXX*5225 01 APR XXXXXXXXXXXXXXXXXXX5234","18.81",,"662124.46"
,"03/04/2025","8400/000 : FNB","Facebook 23.00 FACEBK *98CT8 4XXXXX*5191 01 APR XXXXXXXXXXXXXXXXXXX2090 Facebook","Account Payment","Facebook 23.00 FACEBK *98CT8 4XXXXX*5191 01 APR XXXXXXXXXXXXXXXXXXX2090 Facebook","432.71",,"662557.17"
,"03/04/2025","8400/000 : FNB","17.25 SLACK T06A3T4 4XX*5191 01 APR XX1018 17.25 SLACK T06A3T4 4XXXXX*5191 01 APR XXXXXXXXXXXXXXXXXX","Account Payment","17.25 SLACK T06A3T4 4XX*5191 01 APR XX1018 17.25 SLACK T06A3T4 4XXXXX*5191 01 APR XXXXXXXXXXXXXXXXX","324.54",,"662881.71"
,"03/04/2025","8400/000 : FNB","Facebook 13.80 FACEBK *QZB2S 4XXXXX*5191 01 APR XXXXXXXXXXXXXXXXXXX5098 Facebook","Account Payment","Facebook 13.80 FACEBK *QZB2S 4XXXXX*5191 01 APR XXXXXXXXXXXXXXXXXXX5098 Facebook","259.63",,"663141.34"
,"03/04/2025","8400/000 : FNB","Facebook 4.60 FACEBK *U8ZVWK 4XXXXX*5191 01 APR XXXXXXXXXXXXXXXXXXX5070 Facebook","Account Payment","Facebook 4.60 FACEBK *U8ZVWK 4XXXXX*5191 01 APR XXXXXXXXXXXXXXXXXXX5070 Facebook","86.55",,"663227.89"
,"03/04/2025","8400/000 : FNB","134.00 SINCH MAILGU 4XX*5191 01 APR XX3060 134.00 SINCH MAILGU 4XXXXX*5191 01 APR XXXXXXXXXXXXXXXXXX","Account Payment","134.00 SINCH MAILGU 4XX*5191 01 APR XX3060 134.00 SINCH MAILGU 4XXXXX*5191 01 APR XXXXXXXXXXXXXXXXX","2521.06",,"665748.95"
,"03/04/2025","8400/000 : FNB","50.00 ANACONDA INC. 4XX*5191 01 APR XX6959 50.00 ANACONDA INC. 4XXXXX*5191 01 APR XXXXXXXXXXXXXXXXXX","Account Payment","50.00 ANACONDA INC. 4XX*5191 01 APR XX6959 50.00 ANACONDA INC. 4XXXXX*5191 01 APR XXXXXXXXXXXXXXXXX","940.7",,"666689.65"
,"04/04/2025","8400/000 : FNB","450.00 WAPPALYZER 4XX*5191 02 APR XX3036 450.00 WAPPALYZER 4XXXXX*5191 02 APR XXXXXXXXXXXXXXXXXXX303","Account Payment","450.00 WAPPALYZER 4XX*5191 02 APR XX3036 450.00 WAPPALYZER 4XXXXX*5191 02 APR XXXXXXXXXXXXXXXXXXX30","8504.11",,"675193.76"
,"07/04/2025","8400/000 : FNB","Github Inc. 16.56 GITHUB, INC. 4XXXXX*5225 04 APR XXXXXXXXXXXXXXXXXXX6188 Github Inc.","Account Payment","Github Inc. 16.56 GITHUB, INC. 4XXXXX*5225 04 APR XXXXXXXXXXXXXXXXXXX6188 Github Inc.","321.46",,"675515.22"
,"07/04/2025","8400/000 : FNB","1499.00 APPDIRECT 4XX*5225 04 APR XX5248 1499.00 APPDIRECT 4XXXXX*5225 04 APR XXXXXXXXXXXXXXXXXXX524","Account Payment","1499.00 APPDIRECT 4XX*5225 04 APR XX5248 1499.00 APPDIRECT 4XXXXX*5225 04 APR XXXXXXXXXXXXXXXXXXX52","29098.33",,"704613.55"
,"07/04/2025","8400/000 : FNB","Github Inc. 48.90 GITHUB, INC. 4XXXXX*5225 04 APR XXXXXXXXXXXXXXXXXXX0239 Github Inc.","Account Payment","Github Inc. 48.90 GITHUB, INC. 4XXXXX*5225 04 APR XXXXXXXXXXXXXXXXXXX0239 Github Inc.","949.24",,"705562.79"
,"08/04/2025","8400/000 : FNB","3.60 GETADDRESS.IO 4XX*5225 07 APR XX0033 3.60 GETADDRESS.IO 4XXXXX*5225 07 APR XXXXXXXXXXXXXXXXXXX0","Account Payment","3.60 GETADDRESS.IO 4XX*5225 07 APR XX0033 3.60 GETADDRESS.IO 4XXXXX*5225 07 APR XXXXXXXXXXXXXXXXXXX","91.65",,"705654.44"
,"08/04/2025","8400/000 : FNB","Shopify 2558.98 SHOPIFY* 35 4XXXXX*5191 06 APR XXXXXXXXXXXXXXXXXXX1790 Shopify","Account Payment","Shopify 2558.98 SHOPIFY* 35 4XXXXX*5191 06 APR XXXXXXXXXXXXXXXXXXX1790 Shopify","50087.98",,"755742.42"
,"08/04/2025","8400/000 : FNB","40.00 VERCEL INC. 4XX*5225 06 APR XX1664 40.00 VERCEL INC. 4XXXXX*5225 06 APR XXXXXXXXXXXXXXXXXXX166","Account Payment","40.00 VERCEL INC. 4XX*5225 06 APR XX1664 40.00 VERCEL INC. 4XXXXX*5225 06 APR XXXXXXXXXXXXXXXXXXX16","782.93",,"756525.35"
,"08/04/2025","8400/000 : FNB","20.00 VERCEL INC. 4XX*5225 06 APR XX3971 20.00 VERCEL INC. 4XXXXX*5225 06 APR XXXXXXXXXXXXXXXXXXX397","Account Payment","20.00 VERCEL INC. 4XX*5225 06 APR XX3971 20.00 VERCEL INC. 4XXXXX*5225 06 APR XXXXXXXXXXXXXXXXXXX39","391.47",,"756916.82"
,"08/04/2025","8400/000 : FNB","Woocommerce 19.99 WOOCOMMERCE S 4XXXXX*5225 06 APR XXXXXXXXXXXXXXXXXXX1039 Woocommerce","Account Payment","Woocommerce 19.99 WOOCOMMERCE S 4XXXXX*5225 06 APR XXXXXXXXXXXXXXXXXXX1039 Woocommerce","391.27",,"757308.09"
,"09/04/2025","8400/000 : FNB","105.00 NOTION LABS, 4XX*5225 07 APR XX1970 105.00 NOTION LABS, 4XXXXX*5225 07 APR XXXXXXXXXXXXXXXXXX","Account Payment","105.00 NOTION LABS, 4XX*5225 07 APR XX1970 105.00 NOTION LABS, 4XXXXX*5225 07 APR XXXXXXXXXXXXXXXXX","2055.21",,"759363.3"
,"10/04/2025","8400/000 : FNB","399.99 POE.COM 4XX*5191 09 APR XX6712 399.99 POE.COM 4XXXXX*5191 09 APR XXXXXXXXXXXXXXXXXXX6712","Account Payment","399.99 POE.COM 4XX*5191 09 APR XX6712 399.99 POE.COM 4XXXXX*5191 09 APR XXXXXXXXXXXXXXXXXXX6712","399.99",,"759763.29"
,"10/04/2025","8400/000 : FNB","25.00 NOTION LABS, 4XX*5225 08 APR XX3159 25.00 NOTION LABS, 4XXXXX*5225 08 APR XXXXXXXXXXXXXXXXXXX3","Account Payment","25.00 NOTION LABS, 4XX*5225 08 APR XX3159 25.00 NOTION LABS, 4XXXXX*5225 08 APR XXXXXXXXXXXXXXXXXXX","500.93",,"760264.22"
,"10/04/2025","8400/000 : FNB","99.00 CHATBASE 4XX*5191 09 APR XX1631 99.00 CHATBASE 4XXXXX*5191 09 APR XXXXXXXXXXXXXXXXXXX1631","Account Payment","99.00 CHATBASE 4XX*5191 09 APR XX1631 99.00 CHATBASE 4XXXXX*5191 09 APR XXXXXXXXXXXXXXXXXXX1631","1998.95",,"762263.17"
,"10/04/2025","8400/000 : FNB","Paddle 171.35 PADDLE.NET* 4XXXXX*5191 09 APR XXXXXXXXXXXXXXXXXXX5772 Paddle","Account Payment","Paddle 171.35 PADDLE.NET* 4XXXXX*5191 09 APR XXXXXXXXXXXXXXXXXXX5772 Paddle","3459.79",,"765722.96"
,"10/04/2025","8400/000 : FNB","599.00 TRIPLE WHALE 4XX*5191 09 APR XX0816 599.00 TRIPLE WHALE 4XXXXX*5191 09 APR XXXXXXXXXXXXXXXXXX","Account Payment","599.00 TRIPLE WHALE 4XX*5191 09 APR XX0816 599.00 TRIPLE WHALE 4XXXXX*5191 09 APR XXXXXXXXXXXXXXXXX","12094.61",,"777817.57"
,"11/04/2025","8400/000 : FNB","920.00 AUTH0.COM 4XX*5191 09 APR XX0119 920.00 AUTH0.COM 4XXXXX*5191 09 APR XXXXXXXXXXXXXXXXXXX0119","Account Payment","920.00 AUTH0.COM 4XX*5191 09 APR XX0119 920.00 AUTH0.COM 4XXXXX*5191 09 APR XXXXXXXXXXXXXXXXXXX0119","18576.04",,"796393.61"
,"11/04/2025","8400/000 : FNB","499.00 CASSIDYAI.CO 4XX*5191 09 APR XX6408 499.00 CASSIDYAI.CO 4XXXXX*5191 09 APR XXXXXXXXXXXXXXXXXX","Account Payment","499.00 CASSIDYAI.CO 4XX*5191 09 APR XX6408 499.00 CASSIDYAI.CO 4XXXXX*5191 09 APR XXXXXXXXXXXXXXXXX","10075.48",,"806469.09"
,"11/04/2025","8400/000 : FNB","Stable 249.00 STABLE 4XXXXX*5191 09 APR XXXXXXXXXXXXXXXXXXX0035 Stable","Account Payment","Stable 249.00 STABLE 4XXXXX*5191 09 APR XXXXXXXXXXXXXXXXXXX0035 Stable","5027.64",,"811496.73"
,"11/04/2025","8400/000 : FNB","ManageWP 120.75 MANAGEWP 4XXXXX*5225 05 APR XXXXXXXXXXXXXXXXXXX2108 ManageWP","Account Payment","ManageWP 120.75 MANAGEWP 4XXXXX*5225 05 APR XXXXXXXXXXXXXXXXXXX2108 ManageWP","2363.49",,"813860.22"
,"11/04/2025","8400/000 : FNB","ManageWP 120.75 MANAGEWP 4XXXXX*5225 05 APR XXXXXXXXXXXXXXXXXXX6131 ManageWP","Account Payment","ManageWP 120.75 MANAGEWP 4XXXXX*5225 05 APR XXXXXXXXXXXXXXXXXXX6131 ManageWP","2363.49",,"816223.71"
,"11/04/2025","8400/000 : FNB","70.00 NOTION LABS, 4XX*5191 10 APR XX9065 70.00 NOTION LABS, 4XXXXX*5191 10 APR XXXXXXXXXXXXXXXXXXX9","Account Payment","70.00 NOTION LABS, 4XX*5191 10 APR XX9065 70.00 NOTION LABS, 4XXXXX*5191 10 APR XXXXXXXXXXXXXXXXXXX","1415.12",,"817638.83"
,"11/04/2025","8400/000 : FNB","60.00 INSOMNIA TEAM 4XX*5191 09 APR XX6479 60.00 INSOMNIA TEAM 4XXXXX*5191 09 APR XXXXXXXXXXXXXXXXXX","Account Payment","60.00 INSOMNIA TEAM 4XX*5191 09 APR XX6479 60.00 INSOMNIA TEAM 4XXXXX*5191 09 APR XXXXXXXXXXXXXXXXX","1212.95",,"818851.78"
,"11/04/2025","8400/000 : FNB","49.00 SKRAPP.IO STA 4XX*5191 09 APR XX3718 49.00 SKRAPP.IO STA 4XXXXX*5191 09 APR XXXXXXXXXXXXXXXXXX","Account Payment","49.00 SKRAPP.IO STA 4XX*5191 09 APR XX3718 49.00 SKRAPP.IO STA 4XXXXX*5191 09 APR XXXXXXXXXXXXXXXXX","989.38",,"819841.16"
,"11/04/2025","8400/000 : FNB","46.67 REPLIT, INC. 4XX*5191 09 APR XX2115 46.67 REPLIT, INC. 4XXXXX*5191 09 APR XXXXXXXXXXXXXXXXXXX2","Account Payment","46.67 REPLIT, INC. 4XX*5191 09 APR XX2115 46.67 REPLIT, INC. 4XXXXX*5191 09 APR XXXXXXXXXXXXXXXXXXX","942.33",,"820783.49"
,"11/04/2025","8400/000 : FNB","40.00 REPLIT, INC. 4XX*5191 09 APR XX9314 40.00 REPLIT, INC. 4XXXXX*5191 09 APR XXXXXXXXXXXXXXXXXXX9","Account Payment","40.00 REPLIT, INC. 4XX*5191 09 APR XX9314 40.00 REPLIT, INC. 4XXXXX*5191 09 APR XXXXXXXXXXXXXXXXXXX","807.66",,"821591.15"
,"11/04/2025","8400/000 : FNB","30.00 ISHRAQ LLC 4XX*5191 09 APR XX2578 30.00 ISHRAQ LLC 4XXXXX*5191 09 APR XXXXXXXXXXXXXXXXXXX2578","Account Payment","30.00 ISHRAQ LLC 4XX*5191 09 APR XX2578 30.00 ISHRAQ LLC 4XXXXX*5191 09 APR XXXXXXXXXXXXXXXXXXX2578","605.74",,"822196.89"
,"11/04/2025","8400/000 : FNB","12.00 CODESANDBOX 4XX*5191 10 APR XX9018 12.00 CODESANDBOX 4XXXXX*5191 10 APR XXXXXXXXXXXXXXXXXXX901","Account Payment","12.00 CODESANDBOX 4XX*5191 10 APR XX9018 12.00 CODESANDBOX 4XXXXX*5191 10 APR XXXXXXXXXXXXXXXXXXX90","242.59",,"822439.48"
,"11/04/2025","8400/000 : FNB","Paddle 187.94 PADDLE.NET* 4XXXXX*5191 05 APR XXXXXXXXXXXXXXXXXXX2072 Paddle","Account Payment","Paddle 187.94 PADDLE.NET* 4XXXXX*5191 05 APR XXXXXXXXXXXXXXXXXXX2072 Paddle","187.94",,"822627.42"
,"11/04/2025","8400/000 : FNB","7.00 CHATBASE 4XX*5191 10 APR XX5320 7.00 CHATBASE 4XXXXX*5191 10 APR XXXXXXXXXXXXXXXXXXX5320","Account Payment","7.00 CHATBASE 4XX*5191 10 APR XX5320 7.00 CHATBASE 4XXXXX*5191 10 APR XXXXXXXXXXXXXXXXXXX5320","141.51",,"822768.93"
,"11/04/2025","8400/000 : FNB","Google 34.99 Google One 4XXXXX*5191 09 APR XXXXXXXXXXXXXXXXXXX2068 Google","Account Payment","Google 34.99 Google One 4XXXXX*5191 09 APR XXXXXXXXXXXXXXXXXXX2068 Google","34.99",,"822803.92"
,"11/04/2025","8400/000 : FNB","25.00 BEECEPTOR 4XX*5191 09 APR XX0012 25.00 BEECEPTOR 4XXXXX*5191 09 APR XXXXXXXXXXXXXXXXXXX0012","Account Payment","25.00 BEECEPTOR 4XX*5191 09 APR XX0012 25.00 BEECEPTOR 4XXXXX*5191 09 APR XXXXXXXXXXXXXXXXXXX0012","504.79",,"823308.71"
,"11/04/2025","8400/000 : FNB","25.00 BEECEPTOR 4XX*5191 09 APR XX0024 25.00 BEECEPTOR 4XXXXX*5191 09 APR XXXXXXXXXXXXXXXXXXX0024","Account Payment","25.00 BEECEPTOR 4XX*5191 09 APR XX0024 25.00 BEECEPTOR 4XXXXX*5191 09 APR XXXXXXXXXXXXXXXXXXX0024","504.79",,"823813.5"
,"11/04/2025","8400/000 : FNB","21.56 SLACK T0740DV 4XX*5191 10 APR XX8597 21.56 SLACK T0740DV 4XXXXX*5191 10 APR XXXXXXXXXXXXXXXXXX","Account Payment","21.56 SLACK T0740DV 4XX*5191 10 APR XX8597 21.56 SLACK T0740DV 4XXXXX*5191 10 APR XXXXXXXXXXXXXXXXX","435.86",,"824249.36"
,"11/04/2025","8400/000 : FNB","Google Play 434.99 Google Perpl 4XXXXX*5191 10 APR XXXXXXXXXXXXXXXXXXX0049 Google Play","Account Payment","Google Play 434.99 Google Perpl 4XXXXX*5191 10 APR XXXXXXXXXXXXXXXXXXX0049 Google Play","434.99",,"824684.35"
,"11/04/2025","8400/000 : FNB","20.00 VERCEL INC. 4XX*5191 09 APR XX2884 20.00 VERCEL INC. 4XXXXX*5191 09 APR XXXXXXXXXXXXXXXXXXX288","Account Payment","20.00 VERCEL INC. 4XX*5191 09 APR XX2884 20.00 VERCEL INC. 4XXXXX*5191 09 APR XXXXXXXXXXXXXXXXXXX28","403.83",,"825088.18"
,"12/04/2025","8400/000 : FNB","99.00 DYNAMIC.XYZ 4XX*5191 11 APR XX7007 99.00 DYNAMIC.XYZ 4XXXXX*5191 11 APR XXXXXXXXXXXXXXXXXXX700","Account Payment","99.00 DYNAMIC.XYZ 4XX*5191 11 APR XX7007 99.00 DYNAMIC.XYZ 4XXXXX*5191 11 APR XXXXXXXXXXXXXXXXXXX70","1981.67",,"827069.85"
,"12/04/2025","8400/000 : FNB","99.00 DMNS.APP BUSI 4XX*5191 11 APR XX7265 99.00 DMNS.APP BUSI 4XXXXX*5191 11 APR XXXXXXXXXXXXXXXXXX","Account Payment","99.00 DMNS.APP BUSI 4XX*5191 11 APR XX7265 99.00 DMNS.APP BUSI 4XXXXX*5191 11 APR XXXXXXXXXXXXXXXXX","1981.67",,"829051.52"
,"12/04/2025","8400/000 : FNB","Shopify 74.75 SHOPIFY* 3522 4XXXXX*5225 10 APR XXXXXXXXXXXXXXXXXXX0590 Shopify","Account Payment","Shopify 74.75 SHOPIFY* 3522 4XXXXX*5225 10 APR XXXXXXXXXXXXXXXXXXX0590 Shopify","1511.14",,"830562.66"
,"12/04/2025","8400/000 : FNB","72.00 TERMIUS CORPO 4XX*5191 10 APR XX7687 72.00 TERMIUS CORPO 4XXXXX*5191 10 APR XXXXXXXXXXXXXXXXXX","Account Payment","72.00 TERMIUS CORPO 4XX*5191 10 APR XX7687 72.00 TERMIUS CORPO 4XXXXX*5191 10 APR XXXXXXXXXXXXXXXXX","1455.55",,"832018.21"
,"12/04/2025","8400/000 : FNB","49.91 FRAPPE CLOUD 4XX*5191 11 APR XX0011 49.91 FRAPPE CLOUD 4XXXXX*5191 11 APR XXXXXXXXXXXXXXXXXXX0","Account Payment","49.91 FRAPPE CLOUD 4XX*5191 11 APR XX0011 49.91 FRAPPE CLOUD 4XXXXX*5191 11 APR XXXXXXXXXXXXXXXXXXX","999.04",,"833017.25"
,"12/04/2025","8400/000 : FNB","32.00 BUBBLE STARTE 4XX*5191 11 APR XX7313 32.00 BUBBLE STARTE 4XXXXX*5191 11 APR XXXXXXXXXXXXXXXXXX","Account Payment","32.00 BUBBLE STARTE 4XX*5191 11 APR XX7313 32.00 BUBBLE STARTE 4XXXXX*5191 11 APR XXXXXXXXXXXXXXXXX","640.54",,"833657.79"
,"12/04/2025","8400/000 : FNB","224.99 Google Chara 4XX*5191 10 APR XX3020 224.99 Google Chara 4XXXXX*5191 10 APR XXXXXXXXXXXXXXXXXX","Account Payment","224.99 Google Chara 4XX*5191 10 APR XX3020 224.99 Google Chara 4XXXXX*5191 10 APR XXXXXXXXXXXXXXXXX","224.99",,"833882.78"
,"12/04/2025","8400/000 : FNB","7.00 NPM, INC. 4XX*5191 11 APR XX6938 7.00 NPM, INC. 4XXXXX*5191 11 APR XXXXXXXXXXXXXXXXXXX6938","Account Payment","7.00 NPM, INC. 4XX*5191 11 APR XX6938 7.00 NPM, INC. 4XXXXX*5191 11 APR XXXXXXXXXXXXXXXXXXX6938","140.12",,"834022.9"
,"12/04/2025","8400/000 : FNB","7.00 NPM, INC. 4XX*5191 11 APR XX9574 7.00 NPM, INC. 4XXXXX*5191 11 APR XXXXXXXXXXXXXXXXXXX9574","Account Payment","7.00 NPM, INC. 4XX*5191 11 APR XX9574 7.00 NPM, INC. 4XXXXX*5191 11 APR XXXXXXXXXXXXXXXXXXX9574","140.12",,"834163.02"
,"12/04/2025","8400/000 : FNB","7.00 NPM, INC. 4XX*5191 11 APR XX6750 7.00 NPM, INC. 4XXXXX*5191 11 APR XXXXXXXXXXXXXXXXXXX6750","Account Payment","7.00 NPM, INC. 4XX*5191 11 APR XX6750 7.00 NPM, INC. 4XXXXX*5191 11 APR XXXXXXXXXXXXXXXXXXX6750","140.12",,"834303.14"
,"12/04/2025","8400/000 : FNB","7.00 NPM, INC. 4XX*5191 11 APR XX4575 7.00 NPM, INC. 4XXXXX*5191 11 APR XXXXXXXXXXXXXXXXXXX4575","Account Payment","7.00 NPM, INC. 4XX*5191 11 APR XX4575 7.00 NPM, INC. 4XXXXX*5191 11 APR XXXXXXXXXXXXXXXXXXX4575","140.12",,"834443.26"
,"12/04/2025","8400/000 : FNB","Shopify 3633.95 SHOPIFY* 35 4XXXXX*5225 10 APR XXXXXXXXXXXXXXXXXXX4740 Shopify","Account Payment","Shopify 3633.95 SHOPIFY* 35 4XXXXX*5225 10 APR XXXXXXXXXXXXXXXXXXX4740 Shopify","73463.77",,"907907.03"
,"12/04/2025","8400/000 : FNB","179.00 MOZSEO:HELP@ 4XX*5191 10 APR XX6069 179.00 MOZSEO:HELP@ 4XXXXX*5191 10 APR XXXXXXXXXXXXXXXXXX","Account Payment","179.00 MOZSEO:HELP@ 4XX*5191 10 APR XX6069 179.00 MOZSEO:HELP@ 4XXXXX*5191 10 APR XXXXXXXXXXXXXXXXX","3618.65",,"911525.68"
,"12/04/2025","8400/000 : FNB","150.00 AUTH0.COM 4XX*5191 10 APR XX9515 150.00 AUTH0.COM 4XXXXX*5191 10 APR XXXXXXXXXXXXXXXXXXX9515","Account Payment","150.00 AUTH0.COM 4XX*5191 10 APR XX9515 150.00 AUTH0.COM 4XXXXX*5191 10 APR XXXXXXXXXXXXXXXXXXX9515","3032.39",,"914558.07"
,"12/04/2025","8400/000 : FNB","99.99 JINA.AI 4XX*5191 11 APR XX9360 99.99 JINA.AI 4XXXXX*5191 11 APR XXXXXXXXXXXXXXXXXXX9360","Account Payment","99.99 JINA.AI 4XX*5191 11 APR XX9360 99.99 JINA.AI 4XXXXX*5191 11 APR XXXXXXXXXXXXXXXXXXX9360","2001.48",,"916559.55"
,"14/04/2025","8400/000 : FNB","1104.00 SQSP* INV17 4XX*5191 11 APR XX3470 1104.00 SQSP* INV17 4XXXXX*5191 11 APR XXXXXXXXXXXXXXXXXX","Account Payment","1104.00 SQSP* INV17 4XX*5191 11 APR XX3470 1104.00 SQSP* INV17 4XXXXX*5191 11 APR XXXXXXXXXXXXXXXXX","1104",,"917663.55"
,"14/04/2025","8400/000 : FNB","430.00 Dlocal *Micr 4XX*5191 11 APR XX5528 430.00 Dlocal *Micr 4XXXXX*5191 11 APR XXXXXXXXXXXXXXXXXX","Account Payment","430.00 Dlocal *Micr 4XX*5191 11 APR XX5528 430.00 Dlocal *Micr 4XXXXX*5191 11 APR XXXXXXXXXXXXXXXXX","430",,"918093.55"
,"14/04/2025","8400/000 : FNB","9.00 TWENTY.COM 4XX*5191 11 APR XX4060 9.00 TWENTY.COM 4XXXXX*5191 11 APR XXXXXXXXXXXXXXXXXXX4060","Account Payment","9.00 TWENTY.COM 4XX*5191 11 APR XX4060 9.00 TWENTY.COM 4XXXXX*5191 11 APR XXXXXXXXXXXXXXXXXXX4060","180.15",,"918273.7"
,"14/04/2025","8400/000 : FNB","Github Inc. 210.00 GITHUB, INC. 4XXXXX*5225 11 APR XXXXXXXXXXXXXXXXXXX7308 Github Inc.","Account Payment","Github Inc. 210.00 GITHUB, INC. 4XXXXX*5225 11 APR XXXXXXXXXXXXXXXXXXX7308 Github Inc.","4203.54",,"922477.24"
,"14/04/2025","8400/000 : FNB","Github Inc. 67.18 GITHUB, INC. 4XXXXX*5191 11 APR XXXXXXXXXXXXXXXXXXX2885 Github Inc.","Account Payment","Github Inc. 67.18 GITHUB, INC. 4XXXXX*5191 11 APR XXXXXXXXXXXXXXXXXXX2885 Github Inc.","1344.74",,"923821.98"
,"14/04/2025","8400/000 : FNB","Github Inc. 42.00 GITHUB, INC. 4XXXXX*5191 11 APR XXXXXXXXXXXXXXXXXXX7698 Github Inc.","Account Payment","Github Inc. 42.00 GITHUB, INC. 4XXXXX*5191 11 APR XXXXXXXXXXXXXXXXXXX7698 Github Inc.","840.7",,"924662.68"
,"15/04/2025","8400/000 : FNB","9.00 GITPOD.IO 4XX*5191 12 APR XX8368 9.00 GITPOD.IO 4XXXXX*5191 12 APR XXXXXXXXXXXXXXXXXXX8368","Account Payment","9.00 GITPOD.IO 4XX*5191 12 APR XX8368 9.00 GITPOD.IO 4XXXXX*5191 12 APR XXXXXXXXXXXXXXXXXXX8368","179.31",,"924841.99"
,"15/04/2025","8400/000 : FNB","11.49 GOOGLE *Colab 4XX*5191 14 APR XX8863 11.49 GOOGLE *Colab 4XXXXX*5191 14 APR XXXXXXXXXXXXXXXXXX","Account Payment","11.49 GOOGLE *Colab 4XX*5191 14 APR XX8863 11.49 GOOGLE *Colab 4XXXXX*5191 14 APR XXXXXXXXXXXXXXXXX","228.92",,"925070.91"
,"15/04/2025","8400/000 : FNB","15.00 TABNINE 4XX*5191 12 APR XX2448 15.00 TABNINE 4XXXXX*5191 12 APR XXXXXXXXXXXXXXXXXXX2448","Account Payment","15.00 TABNINE 4XX*5191 12 APR XX2448 15.00 TABNINE 4XXXXX*5191 12 APR XXXXXXXXXXXXXXXXXXX2448","298.85",,"925369.76"
,"15/04/2025","8400/000 : FNB","Hightail 15.00 HIGHTAIL 4XXXXX*5191 13 APR XXXXXXXXXXXXXXXXXXX0413 Hightail","Account Payment","Hightail 15.00 HIGHTAIL 4XXXXX*5191 13 APR XXXXXXXXXXXXXXXXXXX0413 Hightail","298.85",,"925668.61"
,"15/04/2025","8400/000 : FNB","20.00 HUGGINGFACE 4XX*5191 12 APR XX1733 20.00 HUGGINGFACE 4XXXXX*5191 12 APR XXXXXXXXXXXXXXXXXXX173","Account Payment","20.00 HUGGINGFACE 4XX*5191 12 APR XX1733 20.00 HUGGINGFACE 4XXXXX*5191 12 APR XXXXXXXXXXXXXXXXXXX17","398.46",,"926067.07"
,"15/04/2025","8400/000 : FNB","29.09 RAILWAY 4XX*5191 13 APR XX7403 29.09 RAILWAY 4XXXXX*5191 13 APR XXXXXXXXXXXXXXXXXXX7403","Account Payment","29.09 RAILWAY 4XX*5191 13 APR XX7403 29.09 RAILWAY 4XXXXX*5191 13 APR XXXXXXXXXXXXXXXXXXX7403","579.56",,"926646.63"
,"15/04/2025","8400/000 : FNB","54.98 PADDLE.NET* W 4XX*5191 14 APR XX1459 54.98 PADDLE.NET* W 4XXXXX*5191 14 APR XXXXXXXXXXXXXXXXXX","Account Payment","54.98 PADDLE.NET* W 4XX*5191 14 APR XX1459 54.98 PADDLE.NET* W 4XXXXX*5191 14 APR XXXXXXXXXXXXXXXXX","1095.38",,"927742.01"
,"15/04/2025","8400/000 : FNB","67.85 LEMSQZY* CHAT 4XX*5191 13 APR XX0136 67.85 LEMSQZY* CHAT 4XXXXX*5191 13 APR XXXXXXXXXXXXXXXXXX","Account Payment","67.85 LEMSQZY* CHAT 4XX*5191 13 APR XX0136 67.85 LEMSQZY* CHAT 4XXXXX*5191 13 APR XXXXXXXXXXXXXXXXX","1351.79",,"929093.8"
,"15/04/2025","8400/000 : FNB","174.00 INTERCOM R&D 4XX*5191 13 APR XX3868 174.00 INTERCOM R&D 4XXXXX*5191 13 APR XXXXXXXXXXXXXXXXXX","Account Payment","174.00 INTERCOM R&D 4XX*5191 13 APR XX3868 174.00 INTERCOM R&D 4XXXXX*5191 13 APR XXXXXXXXXXXXXXXXX","3466.63",,"932560.43"
,"15/04/2025","8400/000 : FNB","180.00 AGENCYANALYT 4XX*5225 13 APR XX6689 180.00 AGENCYANALYT 4XXXXX*5225 13 APR XXXXXXXXXXXXXXXXXX","Account Payment","180.00 AGENCYANALYT 4XX*5225 13 APR XX6689 180.00 AGENCYANALYT 4XXXXX*5225 13 APR XXXXXXXXXXXXXXXXX","3586.17",,"936146.6"
,"15/04/2025","8400/000 : FNB","5.00 WWW.FLUX.AI 4XX*5191 13 APR XX9483 5.00 WWW.FLUX.AI 4XXXXX*5191 13 APR XXXXXXXXXXXXXXXXXXX9483","Account Payment","5.00 WWW.FLUX.AI 4XX*5191 13 APR XX9483 5.00 WWW.FLUX.AI 4XXXXX*5191 13 APR XXXXXXXXXXXXXXXXXXX9483","99.61",,"936246.21"
,"16/04/2025","8400/000 : FNB","47.45 REPLIT, INC. 4XX*5191 14 APR XX9172 47.45 REPLIT, INC. 4XXXXX*5191 14 APR XXXXXXXXXXXXXXXXXXX9","Account Payment","47.45 REPLIT, INC. 4XX*5191 14 APR XX9172 47.45 REPLIT, INC. 4XXXXX*5191 14 APR XXXXXXXXXXXXXXXXXXX","945.36",,"937191.57"
,"16/04/2025","8400/000 : FNB","151.35 SLACK T0MN3D 4XX*5225 15 APR XX3502 151.35 SLACK T0MN3D 4XXXXX*5225 15 APR XXXXXXXXXXXXXXXXXX","Account Payment","151.35 SLACK T0MN3D 4XX*5225 15 APR XX3502 151.35 SLACK T0MN3D 4XXXXX*5225 15 APR XXXXXXXXXXXXXXXXX","2955.84",,"940147.41"
,"16/04/2025","8400/000 : FNB","280.00 WIZA.CO 4XX*5191 14 APR XX3347 280.00 WIZA.CO 4XXXXX*5191 14 APR XXXXXXXXXXXXXXXXXXX3347","Account Payment","280.00 WIZA.CO 4XX*5191 14 APR XX3347 280.00 WIZA.CO 4XXXXX*5191 14 APR XXXXXXXXXXXXXXXXXXX3347","5578.48",,"945725.89"
,"16/04/2025","8400/000 : FNB","Github Inc. 14.00 GITHUB, INC. 4XXXXX*5225 14 APR XXXXXXXXXXXXXXXXXXX3015 Github Inc.","Account Payment","Github Inc. 14.00 GITHUB, INC. 4XXXXX*5225 14 APR XXXXXXXXXXXXXXXXXXX3015 Github Inc.","278.93",,"946004.82"
,"16/04/2025","8400/000 : FNB","33.27 RAILWAY 4XX*5191 14 APR XX6376 33.27 RAILWAY 4XXXXX*5191 14 APR XXXXXXXXXXXXXXXXXXX6376","Account Payment","33.27 RAILWAY 4XX*5191 14 APR XX6376 33.27 RAILWAY 4XXXXX*5191 14 APR XXXXXXXXXXXXXXXXXXX6376","662.85",,"946667.67"
,"17/04/2025","8400/000 : FNB","Google 199.99 Google AppDa 4XXXXX*5191 15 APR XXXXXXXXXXXXXXXXXXX7031 Google","Account Payment","Google 199.99 Google AppDa 4XXXXX*5191 15 APR XXXXXXXXXXXXXXXXXXX7031 Google","199.99",,"946867.66"
,"17/04/2025","8400/000 : FNB","350.00 FRAMER.COM 4XX*5191 16 APR XX4544 350.00 FRAMER.COM 4XXXXX*5191 16 APR XXXXXXXXXXXXXXXXXXX454","Account Payment","350.00 FRAMER.COM 4XX*5191 16 APR XX4544 350.00 FRAMER.COM 4XXXXX*5191 16 APR XXXXXXXXXXXXXXXXXXX45","350",,"947217.66"
,"17/04/2025","8400/000 : FNB","Github Inc. 91.00 GITHUB, INC. 4XXXXX*5191 15 APR XXXXXXXXXXXXXXXXXXX1721 Github Inc.","Account Payment","Github Inc. 91.00 GITHUB, INC. 4XXXXX*5191 15 APR XXXXXXXXXXXXXXXXXXX1721 Github Inc.","1777.22",,"948994.88"
,"17/04/2025","8400/000 : FNB","231.95 HOLASPIRIT 4XX*5225 15 APR XX9286 231.95 HOLASPIRIT 4XXXXX*5225 15 APR XXXXXXXXXXXXXXXXXXX928","Account Payment","231.95 HOLASPIRIT 4XX*5225 15 APR XX9286 231.95 HOLASPIRIT 4XXXXX*5225 15 APR XXXXXXXXXXXXXXXXXXX92","5152.32",,"954147.2"
,"17/04/2025","8400/000 : FNB","376.40 HOLASPIRIT 4XX*5225 15 APR XX3826 376.40 HOLASPIRIT 4XXXXX*5225 15 APR XXXXXXXXXXXXXXXXXXX382","Account Payment","376.40 HOLASPIRIT 4XX*5225 15 APR XX3826 376.40 HOLASPIRIT 4XXXXX*5225 15 APR XXXXXXXXXXXXXXXXXXX38","8360.98",,"962508.18"
,"19/04/2025","8400/000 : FNB","20.00 VERCEL INC. 4XX*5191 16 APR XX1645 20.00 VERCEL INC. 4XXXXX*5191 16 APR XXXXXXXXXXXXXXXXXXX164","Account Payment","20.00 VERCEL INC. 4XX*5191 16 APR XX1645 20.00 VERCEL INC. 4XXXXX*5191 16 APR XXXXXXXXXXXXXXXXXXX16","389.76",,"962897.94"
,"19/04/2025","8400/000 : FNB","Facebook 1265.00 FACEBK *36H 4XXXXX*5191 17 APR XXXXXXXXXXXXXXXXXXX3072 Facebook","Account Payment","Facebook 1265.00 FACEBK *36H 4XXXXX*5191 17 APR XXXXXXXXXXXXXXXXXXX3072 Facebook","1265",,"964162.94"
,"22/04/2025","8400/000 : FNB","374.00 MANGOAPPS 4XX*5191 20 APR XX7388 374.00 MANGOAPPS 4XXXXX*5191 20 APR XXXXXXXXXXXXXXXXXXX7388","Account Payment","374.00 MANGOAPPS 4XX*5191 20 APR XX7388 374.00 MANGOAPPS 4XXXXX*5191 20 APR XXXXXXXXXXXXXXXXXXX7388","7211.49",,"971374.43"
,"22/04/2025","8400/000 : FNB","20.00 HUGGINGFACE 4XX*5191 20 APR XX8924 20.00 HUGGINGFACE 4XXXXX*5191 20 APR XXXXXXXXXXXXXXXXXXX892","Account Payment","20.00 HUGGINGFACE 4XX*5191 20 APR XX8924 20.00 HUGGINGFACE 4XXXXX*5191 20 APR XXXXXXXXXXXXXXXXXXX89","385.64",,"971760.07"
,"22/04/2025","8400/000 : FNB","50.01 REPLIT, INC. 4XX*5191 19 APR XX6133 50.01 REPLIT, INC. 4XXXXX*5191 19 APR XXXXXXXXXXXXXXXXXXX6","Account Payment","50.01 REPLIT, INC. 4XX*5191 19 APR XX6133 50.01 REPLIT, INC. 4XXXXX*5191 19 APR XXXXXXXXXXXXXXXXXXX","964.3",,"972724.37"
,"22/04/2025","8400/000 : FNB","50.15 LINODE . AKAM 4XX*5191 20 APR XX2060 50.15 LINODE . AKAM 4XXXXX*5191 20 APR XXXXXXXXXXXXXXXXXX","Account Payment","50.15 LINODE . AKAM 4XX*5191 20 APR XX2060 50.15 LINODE . AKAM 4XXXXX*5191 20 APR XXXXXXXXXXXXXXXXX","966.99",,"973691.36"
,"22/04/2025","8400/000 : FNB","54.00 AIRTABLE.COM/ 4XX*5191 21 APR XX7919 54.00 AIRTABLE.COM/ 4XXXXX*5191 21 APR XXXXXXXXXXXXXXXXXX","Account Payment","54.00 AIRTABLE.COM/ 4XX*5191 21 APR XX7919 54.00 AIRTABLE.COM/ 4XXXXX*5191 21 APR XXXXXXXXXXXXXXXXX","1041.24",,"974732.6"
,"22/04/2025","8400/000 : FNB","59.00 GREENBACK.COM 4XX*5225 19 APR XX2616 59.00 GREENBACK.COM 4XXXXX*5225 19 APR XXXXXXXXXXXXXXXXXX","Account Payment","59.00 GREENBACK.COM 4XX*5225 19 APR XX2616 59.00 GREENBACK.COM 4XXXXX*5225 19 APR XXXXXXXXXXXXXXXXX","1137.65",,"975870.25"
,"22/04/2025","8400/000 : FNB","74.00 PIPEDREAM, IN 4XX*5191 20 APR XX2751 74.00 PIPEDREAM, IN 4XXXXX*5191 20 APR XXXXXXXXXXXXXXXXXX","Account Payment","74.00 PIPEDREAM, IN 4XX*5191 20 APR XX2751 74.00 PIPEDREAM, IN 4XXXXX*5191 20 APR XXXXXXXXXXXXXXXXX","1426.87",,"977297.12"
,"24/04/2025","8400/000 : FNB","299.00 ORG CHART 4XX*5191 22 APR XX4935 299.00 ORG CHART 4XXXXX*5191 22 APR XXXXXXXXXXXXXXXXXXX4935","Account Payment","299.00 ORG CHART 4XX*5191 22 APR XX4935 299.00 ORG CHART 4XXXXX*5191 22 APR XXXXXXXXXXXXXXXXXXX4935","5751.77",,"983048.89"
,"24/04/2025","8400/000 : FNB","Google Service Charges/Fees #INT PYMT FEE-199.99 Goog Google","Account Payment","Google Service Charges/Fees INT PYMT FEE-199.99 Goog Google","4",,"983052.89"
,"24/04/2025","8400/000 : FNB","#INT PYMT FEE-570.40 INTU #INT PYMT FEE-570.40 INTU","Account Payment","INT PYMT FEE-570.40 INTU INT PYMT FEE-570.40 INTU","11.41",,"983064.3"
,"25/04/2025","8400/000 : FNB","6.00 DOCKER, INC. 4XX*5191 24 APR XX9103 6.00 DOCKER, INC. 4XXXXX*5191 24 APR XXXXXXXXXXXXXXXXXXX910","Account Payment","6.00 DOCKER, INC. 4XX*5191 24 APR XX9103 6.00 DOCKER, INC. 4XXXXX*5191 24 APR XXXXXXXXXXXXXXXXXXX91","114.57",,"983178.87"
,"25/04/2025","8400/000 : FNB","30.00 HASURA 4XX*5191 23 APR XX9485 30.00 HASURA 4XXXXX*5191 23 APR XXXXXXXXXXXXXXXXXXX9485","Account Payment","30.00 HASURA 4XX*5191 23 APR XX9485 30.00 HASURA 4XXXXX*5191 23 APR XXXXXXXXXXXXXXXXXXX9485","572.81",,"983751.68"
,"25/04/2025","8400/000 : FNB","89.00 SENTRY 4XX*5191 24 APR XX7038 89.00 SENTRY 4XXXXX*5191 24 APR XXXXXXXXXXXXXXXXXXX7038","Account Payment","89.00 SENTRY 4XX*5191 24 APR XX7038 89.00 SENTRY 4XXXXX*5191 24 APR XXXXXXXXXXXXXXXXXXX7038","1699.35",,"985451.03"
,"26/04/2025","8400/000 : FNB","10.00 MATTERMOST 4XX*5191 24 APR XX2646 10.00 MATTERMOST 4XXXXX*5191 24 APR XXXXXXXXXXXXXXXXXXX2646","Account Payment","10.00 MATTERMOST 4XX*5191 24 APR XX2646 10.00 MATTERMOST 4XXXXX*5191 24 APR XXXXXXXXXXXXXXXXXXX2646","190.93",,"985641.96"
,"26/04/2025","8400/000 : FNB","15.00 WINDSURF 4XX*5191 24 APR XX1008 15.00 WINDSURF 4XXXXX*5191 24 APR XXXXXXXXXXXXXXXXXXX1008","Account Payment","15.00 WINDSURF 4XX*5191 24 APR XX1008 15.00 WINDSURF 4XXXXX*5191 24 APR XXXXXXXXXXXXXXXXXXX1008","288.55",,"985930.51"
,"26/04/2025","8400/000 : FNB","Dropbox 18.38 DROPBOX*W7M5N 4XXXXX*5191 24 APR XXXXXXXXXXXXXXXXXXX0200 Dropbox","Account Payment","Dropbox 18.38 DROPBOX*W7M5N 4XXXXX*5191 24 APR XXXXXXXXXXXXXXXXXXX0200 Dropbox","350.94",,"986281.45"
,"29/04/2025","8400/000 : FNB","499.00 CBA*CCLEANER 4XX*5191 28 APR XX8946 499.00 CBA*CCLEANER 4XXXXX*5191 28 APR XXXXXXXXXXXXXXXXXX","Account Payment","499.00 CBA*CCLEANER 4XX*5191 28 APR XX8946 499.00 CBA*CCLEANER 4XXXXX*5191 28 APR XXXXXXXXXXXXXXXXX","499",,"986780.45"
,"29/04/2025","8400/000 : FNB","399.99 POE.COM 4XX*5191 26 APR XX2349 399.99 POE.COM 4XXXXX*5191 26 APR XXXXXXXXXXXXXXXXXXX2349","Account Payment","399.99 POE.COM 4XX*5191 26 APR XX2349 399.99 POE.COM 4XXXXX*5191 26 APR XXXXXXXXXXXXXXXXXXX2349","399.99",,"987180.44"
,"29/04/2025","8400/000 : FNB","Facebook 585.90 FACEBK *4PQK 4XXXXX*5191 26 APR XXXXXXXXXXXXXXXXXXX2020 Facebook","Account Payment","Facebook 585.90 FACEBK *4PQK 4XXXXX*5191 26 APR XXXXXXXXXXXXXXXXXXX2020 Facebook","585.9",,"987766.34"
,"29/04/2025","8400/000 : FNB","50.00 ANACONDA INC. 4XX*5191 26 APR XX9561 50.00 ANACONDA INC. 4XXXXX*5191 26 APR XXXXXXXXXXXXXXXXXX","Account Payment","50.00 ANACONDA INC. 4XX*5191 26 APR XX9561 50.00 ANACONDA INC. 4XXXXX*5191 26 APR XXXXXXXXXXXXXXXXX","965.76",,"988732.1"
,"29/04/2025","8400/000 : FNB","150.00 AUTH0.COM 4XX*5191 25 APR XX4454 150.00 AUTH0.COM 4XXXXX*5191 25 APR XXXXXXXXXXXXXXXXXXX4454","Account Payment","150.00 AUTH0.COM 4XX*5191 25 APR XX4454 150.00 AUTH0.COM 4XXXXX*5191 25 APR XXXXXXXXXXXXXXXXXXX4454","2897.27",,"991629.37"
,"29/04/2025","8400/000 : FNB","Wix.com 182.85 WIX.COM 4XXXXX*5191 28 APR XXXXXXXXXXXXXXXXXXX3969 Wix.com","Account Payment","Wix.com 182.85 WIX.COM 4XXXXX*5191 28 APR XXXXXXXXXXXXXXXXXXX3969 Wix.com","3531.77",,"995161.14"
,"29/04/2025","8400/000 : FNB","1150.00 AUTH0.COM 4XX*5191 26 APR XX1473 1150.00 AUTH0.COM 4XXXXX*5191 26 APR XXXXXXXXXXXXXXXXXXX147","Account Payment","1150.00 AUTH0.COM 4XX*5191 26 APR XX1473 1150.00 AUTH0.COM 4XXXXX*5191 26 APR XXXXXXXXXXXXXXXXXXX14","22212.38",,"1017373.52"
,"29/04/2025","8400/000 : FNB","Shopify 3421.17 SHOPIFY* 35 4XXXXX*5191 27 APR XXXXXXXXXXXXXXXXXXX5362 Shopify","Account Payment","Shopify 3421.17 SHOPIFY* 35 4XXXXX*5191 27 APR XXXXXXXXXXXXXXXXXXX5362 Shopify","66080.27",,"1083453.79"
,"30/04/2025","8400/000 : FNB","9.00 GITPOD.IO 4XX*5191 28 APR XX3654 9.00 GITPOD.IO 4XXXXX*5191 28 APR XXXXXXXXXXXXXXXXXXX3654","Account Payment","9.00 GITPOD.IO 4XX*5191 28 APR XX3654 9.00 GITPOD.IO 4XXXXX*5191 28 APR XXXXXXXXXXXXXXXXXXX3654","173.84",,"1083627.63"
,"02/05/2025","8400/000 : FNB","5.00 COMPONENTS.STU 4XX*5191 29 APR XX6888 5.00 COMPONENTS.STU 4XXXXX*5191 29 APR XXXXXXXXXXXXXXXXXX","Account Payment","5.00 COMPONENTS.STU 4XX*5191 29 APR XX6888 5.00 COMPONENTS.STU 4XXXXX*5191 29 APR XXXXXXXXXXXXXXXXX","95.83",,"1083723.46"
,"02/05/2025","8400/000 : FNB","50.10 FRAPPE CLOUD 4XX*5191 30 APR XX0635 50.10 FRAPPE CLOUD 4XXXXX*5191 30 APR XXXXXXXXXXXXXXXXXXX0","Account Payment","50.10 FRAPPE CLOUD 4XX*5191 30 APR XX0635 50.10 FRAPPE CLOUD 4XXXXX*5191 30 APR XXXXXXXXXXXXXXXXXXX","951.04",,"1084674.5"
,"02/05/2025","8400/000 : FNB","50.16 LINODE . AKAM 4XX*5191 30 APR XX4891 50.16 LINODE . AKAM 4XXXXX*5191 30 APR XXXXXXXXXXXXXXXXXX","Account Payment","50.16 LINODE . AKAM 4XX*5191 30 APR XX4891 50.16 LINODE . AKAM 4XXXXX*5191 30 APR XXXXXXXXXXXXXXXXX","952.18",,"1085626.68"
,"02/05/2025","8400/000 : FNB","50.00 OBSIDIAN.MD 4XX*5191 29 APR XX3810 50.00 OBSIDIAN.MD 4XXXXX*5191 29 APR XXXXXXXXXXXXXXXXXXX381","Account Payment","50.00 OBSIDIAN.MD 4XX*5191 29 APR XX3810 50.00 OBSIDIAN.MD 4XXXXX*5191 29 APR XXXXXXXXXXXXXXXXXXX38","958.25",,"1086584.93"
,"02/05/2025","8400/000 : FNB","2162.00 SNAPPY LLC 4XX*5191 29 APR XX0123 2162.00 SNAPPY LLC 4XXXXX*5191 29 APR XXXXXXXXXXXXXXXXXXX0","Account Payment","2162.00 SNAPPY LLC 4XX*5191 29 APR XX0123 2162.00 SNAPPY LLC 4XXXXX*5191 29 APR XXXXXXXXXXXXXXXXXXX","2162",,"1088746.93"
,"02/05/2025","8400/000 : FNB","5050.80 FRESHWORKS 4XX*5225 29 APR XX1842 5050.80 FRESHWORKS 4XXXXX*5225 29 APR XXXXXXXXXXXXXXXXXXX1","Account Payment","5050.80 FRESHWORKS 4XX*5225 29 APR XX1842 5050.80 FRESHWORKS 4XXXXX*5225 29 APR XXXXXXXXXXXXXXXXXXX","5050.8",,"1093797.73"
,"03/05/2025","8400/000 : FNB","Google Store 365.04 Google GSUIT 4XXXXX*5225 01 MAY XXXXXXXXXXXXXXXXXXX5083 Google Store","Account Payment","Google Store 365.04 Google GSUIT 4XXXXX*5225 01 MAY XXXXXXXXXXXXXXXXXXX5083 Google Store","7902.57",,"1101700.3"
,"03/05/2025","8400/000 : FNB","44.14 GOOGLE*GSUITE 4XX*5225 01 MAY XX7258 44.14 GOOGLE*GSUITE 4XXXXX*5225 01 MAY XXXXXXXXXXXXXXXXXX","Account Payment","44.14 GOOGLE*GSUITE 4XX*5225 01 MAY XX7258 44.14 GOOGLE*GSUITE 4XXXXX*5225 01 MAY XXXXXXXXXXXXXXXXX","955.57",,"1102655.87"
,"03/05/2025","8400/000 : FNB","39.82 GOOGLE*GSUITE 4XX*5225 01 MAY XX6975 39.82 GOOGLE*GSUITE 4XXXXX*5225 01 MAY XXXXXXXXXXXXXXXXXX","Account Payment","39.82 GOOGLE*GSUITE 4XX*5225 01 MAY XX6975 39.82 GOOGLE*GSUITE 4XXXXX*5225 01 MAY XXXXXXXXXXXXXXXXX","862.04",,"1103517.91"
,"03/05/2025","8400/000 : FNB","1.00 VERCEL-NEON 4XX*5225 01 MAY XX6564 1.00 VERCEL-NEON 4XXXXX*5225 01 MAY XXXXXXXXXXXXXXXXXXX6564","Account Payment","1.00 VERCEL-NEON 4XX*5225 01 MAY XX6564 1.00 VERCEL-NEON 4XXXXX*5225 01 MAY XXXXXXXXXXXXXXXXXXX6564","19.03",,"1103536.94"
,"06/05/2025","8400/000 : FNB","1499.00 APPDIRECT 4XX*5225 04 MAY XX5301 1499.00 APPDIRECT 4XXXXX*5225 04 MAY XXXXXXXXXXXXXXXXXXX530","Account Payment","1499.00 APPDIRECT 4XX*5225 04 MAY XX5301 1499.00 APPDIRECT 4XXXXX*5225 04 MAY XXXXXXXXXXXXXXXXXXX53","28597.4",,"1132134.34"
,"06/05/2025","8400/000 : FNB","ManageWP 120.75 MANAGEWP 4XXXXX*5225 05 MAY XXXXXXXXXXXXXXXXXXX3794 ManageWP","Account Payment","ManageWP 120.75 MANAGEWP 4XXXXX*5225 05 MAY XXXXXXXXXXXXXXXXXXX3794 ManageWP","2303.63",,"1134437.97"
,"06/05/2025","8400/000 : FNB","ManageWP 120.75 MANAGEWP 4XXXXX*5225 05 MAY XXXXXXXXXXXXXXXXXXX2183 ManageWP","Account Payment","ManageWP 120.75 MANAGEWP 4XXXXX*5225 05 MAY XXXXXXXXXXXXXXXXXXX2183 ManageWP","2303.63",,"1136741.6"
,"06/05/2025","8400/000 : FNB","Github Inc. 19.00 GITHUB, INC. 4XXXXX*5225 04 MAY XXXXXXXXXXXXXXXXXXX7956 Github Inc.","Account Payment","Github Inc. 19.00 GITHUB, INC. 4XXXXX*5225 04 MAY XXXXXXXXXXXXXXXXXXX7956 Github Inc.","362.48",,"1137104.08"
,"06/05/2025","8400/000 : FNB","Github Inc. GITHUB, INC. 4XXXXX*5225 04 MAY XXXXXXXXXXXXXXXXXXX5760 Github Inc.","Account Payment","Github Inc. GITHUB, INC. 4XXXXX*5225 04 MAY XXXXXXXXXXXXXXXXXXX5760 Github Inc.","15.65",,"1137119.73"
,"07/05/2025","8400/000 : FNB","Facebook Service Charges/Fees #INT PYMT FEE-585.90 FACE Facebook","Account Payment","Facebook Service Charges/Fees INT PYMT FEE-585.90 FACE Facebook","11.72",,"1137131.45"
,"08/05/2025","8400/000 : FNB","40.00 VERCEL INC. 4XX*5225 06 MAY XX2938 40.00 VERCEL INC. 4XXXXX*5225 06 MAY XXXXXXXXXXXXXXXXXXX293","Account Payment","40.00 VERCEL INC. 4XX*5225 06 MAY XX2938 40.00 VERCEL INC. 4XXXXX*5225 06 MAY XXXXXXXXXXXXXXXXXXX29","752.61",,"1137884.06"
,"08/05/2025","8400/000 : FNB","20.00 VERCEL INC. 4XX*5225 06 MAY XX1373 20.00 VERCEL INC. 4XXXXX*5225 06 MAY XXXXXXXXXXXXXXXXXXX137","Account Payment","20.00 VERCEL INC. 4XX*5225 06 MAY XX1373 20.00 VERCEL INC. 4XXXXX*5225 06 MAY XXXXXXXXXXXXXXXXXXX13","376.3",,"1138260.36"
,"08/05/2025","8400/000 : FNB","Woocommerce 19.99 WOOCOMMERCE S 4XXXXX*5225 06 MAY XXXXXXXXXXXXXXXXXXX6750 Woocommerce","Account Payment","Woocommerce 19.99 WOOCOMMERCE S 4XXXXX*5225 06 MAY XXXXXXXXXXXXXXXXXXX6750 Woocommerce","376.11",,"1138636.47"
,"08/05/2025","8400/000 : FNB","3.60 GETADDRESS.IO 4XX*5225 07 MAY XX5162 3.60 GETADDRESS.IO 4XXXXX*5225 07 MAY XXXXXXXXXXXXXXXXXXX5","Account Payment","3.60 GETADDRESS.IO 4XX*5225 07 MAY XX5162 3.60 GETADDRESS.IO 4XXXXX*5225 07 MAY XXXXXXXXXXXXXXXXXXX","89.78",,"1138726.25"
,"09/05/2025","8400/000 : FNB","Paddle 171.35 PADDLE.NET* 4XXXXX*5191 08 MAY XXXXXXXXXXXXXXXXXXX6983 Paddle","Account Payment","Paddle 171.35 PADDLE.NET* 4XXXXX*5191 08 MAY XXXXXXXXXXXXXXXXXXX6983 Paddle","3207.42",,"1141933.67"
,"09/05/2025","8400/000 : FNB","134.00 SINCH MAILGU 4XX*5191 07 MAY XX3741 134.00 SINCH MAILGU 4XXXXX*5191 07 MAY XXXXXXXXXXXXXXXXXX","Account Payment","134.00 SINCH MAILGU 4XX*5191 07 MAY XX3741 134.00 SINCH MAILGU 4XXXXX*5191 07 MAY XXXXXXXXXXXXXXXXX","2503.14",,"1144436.81"
,"09/05/2025","8400/000 : FNB","105.00 NOTION LABS, 4XX*5191 07 MAY XX9327 105.00 NOTION LABS, 4XXXXX*5191 07 MAY XXXXXXXXXXXXXXXXXX","Account Payment","105.00 NOTION LABS, 4XX*5191 07 MAY XX9327 105.00 NOTION LABS, 4XXXXX*5191 07 MAY XXXXXXXXXXXXXXXXX","1961.42",,"1146398.23"
,"09/05/2025","8400/000 : FNB","99.99 JINA.AI 4XX*5191 07 MAY XX5366 99.99 JINA.AI 4XXXXX*5191 07 MAY XXXXXXXXXXXXXXXXXXX5366","Account Payment","99.99 JINA.AI 4XX*5191 07 MAY XX5366 99.99 JINA.AI 4XXXXX*5191 07 MAY XXXXXXXXXXXXXXXXXXX5366","1867.82",,"1148266.05"
,"09/05/2025","8400/000 : FNB","99.00 MIOSALON.COM( 4XX*5225 07 MAY XX4045 99.00 MIOSALON.COM( 4XXXXX*5225 07 MAY XXXXXXXXXXXXXXXXXX","Account Payment","99.00 MIOSALON.COM( 4XX*5225 07 MAY XX4045 99.00 MIOSALON.COM( 4XXXXX*5225 07 MAY XXXXXXXXXXXXXXXXX","1849.33",,"1150115.38"
,"09/05/2025","8400/000 : FNB","99.00 MIOSALON.COM( 4XX*5225 07 MAY XX9889 99.00 MIOSALON.COM( 4XXXXX*5225 07 MAY XXXXXXXXXXXXXXXXXX","Account Payment","99.00 MIOSALON.COM( 4XX*5225 07 MAY XX9889 99.00 MIOSALON.COM( 4XXXXX*5225 07 MAY XXXXXXXXXXXXXXXXX","1849.33",,"1151964.71"
,"09/05/2025","8400/000 : FNB","Intuit 570.40 INTUIT *QBoo 4XXXXX*5225 07 MAY XXXXXXXXXXXXXXXXXXX4227 Intuit","Account Payment","Intuit 570.40 INTUIT *QBoo 4XXXXX*5225 07 MAY XXXXXXXXXXXXXXXXXXX4227 Intuit","570.4",,"1152535.11"
,"09/05/2025","8400/000 : FNB","20.00 HUGGINGFACE 4XX*5191 07 MAY XX3488 20.00 HUGGINGFACE 4XXXXX*5191 07 MAY XXXXXXXXXXXXXXXXXXX348","Account Payment","20.00 HUGGINGFACE 4XX*5191 07 MAY XX3488 20.00 HUGGINGFACE 4XXXXX*5191 07 MAY XXXXXXXXXXXXXXXXXXX34","373.61",,"1152908.72"
,"09/05/2025","8400/000 : FNB","17.25 SLACK T06A3T4 4XX*5191 07 MAY XX7425 17.25 SLACK T06A3T4 4XXXXX*5191 07 MAY XXXXXXXXXXXXXXXXXX","Account Payment","17.25 SLACK T06A3T4 4XX*5191 07 MAY XX7425 17.25 SLACK T06A3T4 4XXXXX*5191 07 MAY XXXXXXXXXXXXXXXXX","322.23",,"1153230.95"
,"09/05/2025","8400/000 : FNB","224.99 Google Chara 4XX*5191 07 MAY XX2066 224.99 Google Chara 4XXXXX*5191 07 MAY XXXXXXXXXXXXXXXXXX","Account Payment","224.99 Google Chara 4XX*5191 07 MAY XX2066 224.99 Google Chara 4XXXXX*5191 07 MAY XXXXXXXXXXXXXXXXX","224.99",,"1153455.94"
,"09/05/2025","8400/000 : FNB","12.00 CODESANDBOX 4XX*5191 07 MAY XX4385 12.00 CODESANDBOX 4XXXXX*5191 07 MAY XXXXXXXXXXXXXXXXXXX438","Account Payment","12.00 CODESANDBOX 4XX*5191 07 MAY XX4385 12.00 CODESANDBOX 4XXXXX*5191 07 MAY XXXXXXXXXXXXXXXXXXX43","224.17",,"1153680.11"
,"09/05/2025","8400/000 : FNB","7.00 NPM, INC. 4XX*5191 08 MAY XX1842 7.00 NPM, INC. 4XXXXX*5191 08 MAY XXXXXXXXXXXXXXXXXXX1842","Account Payment","7.00 NPM, INC. 4XX*5191 08 MAY XX1842 7.00 NPM, INC. 4XXXXX*5191 08 MAY XXXXXXXXXXXXXXXXXXX1842","131.03",,"1153811.14"
,"09/05/2025","8400/000 : FNB","7.00 NPM, INC. 4XX*5191 08 MAY XX1809 7.00 NPM, INC. 4XXXXX*5191 08 MAY XXXXXXXXXXXXXXXXXXX1809","Account Payment","7.00 NPM, INC. 4XX*5191 08 MAY XX1809 7.00 NPM, INC. 4XXXXX*5191 08 MAY XXXXXXXXXXXXXXXXXXX1809","131.03",,"1153942.17"
,"09/05/2025","8400/000 : FNB","7.00 NPM, INC. 4XX*5191 08 MAY XX2543 7.00 NPM, INC. 4XXXXX*5191 08 MAY XXXXXXXXXXXXXXXXXXX2543","Account Payment","7.00 NPM, INC. 4XX*5191 08 MAY XX2543 7.00 NPM, INC. 4XXXXX*5191 08 MAY XXXXXXXXXXXXXXXXXXX2543","131.03",,"1154073.2"
,"09/05/2025","8400/000 : FNB","7.00 NPM, INC. 4XX*5191 08 MAY XX4451 7.00 NPM, INC. 4XXXXX*5191 08 MAY XXXXXXXXXXXXXXXXXXX4451","Account Payment","7.00 NPM, INC. 4XX*5191 08 MAY XX4451 7.00 NPM, INC. 4XXXXX*5191 08 MAY XXXXXXXXXXXXXXXXXXX4451","131.03",,"1154204.23"
,"10/05/2025","8400/000 : FNB","Shopify 2558.98 SHOPIFY* 36 4XXXXX*5191 08 MAY XXXXXXXXXXXXXXXXXXX2019 Shopify","Account Payment","Shopify 2558.98 SHOPIFY* 36 4XXXXX*5191 08 MAY XXXXXXXXXXXXXXXXXXX2019 Shopify","47900.31",,"1202104.54"
,"10/05/2025","8400/000 : FNB","599.00 TRIPLE WHALE 4XX*5191 08 MAY XX4842 599.00 TRIPLE WHALE 4XXXXX*5191 08 MAY XXXXXXXXXXXXXXXXXX","Account Payment","599.00 TRIPLE WHALE 4XX*5191 08 MAY XX4842 599.00 TRIPLE WHALE 4XXXXX*5191 08 MAY XXXXXXXXXXXXXXXXX","11212.39",,"1213316.93"
,"10/05/2025","8400/000 : FNB","Stable 249.00 STABLE 4XXXXX*5191 09 MAY XXXXXXXXXXXXXXXXXXX1770 Stable","Account Payment","Stable 249.00 STABLE 4XXXXX*5191 09 MAY XXXXXXXXXXXXXXXXXXX1770 Stable","4661.09",,"1217978.02"
,"10/05/2025","8400/000 : FNB","179.00 MOZSEO:HELP@ 4XX*5191 08 MAY XX6597 179.00 MOZSEO:HELP@ 4XXXXX*5191 08 MAY XXXXXXXXXXXXXXXXXX","Account Payment","179.00 MOZSEO:HELP@ 4XX*5191 08 MAY XX6597 179.00 MOZSEO:HELP@ 4XXXXX*5191 08 MAY XXXXXXXXXXXXXXXXX","3350.74",,"1221328.76"
,"10/05/2025","8400/000 : FNB","150.00 AUTH0.COM 4XX*5191 08 MAY XX0874 150.00 AUTH0.COM 4XXXXX*5191 08 MAY XXXXXXXXXXXXXXXXXXX0874","Account Payment","150.00 AUTH0.COM 4XX*5191 08 MAY XX0874 150.00 AUTH0.COM 4XXXXX*5191 08 MAY XXXXXXXXXXXXXXXXXXX0874","2807.77",,"1224136.53"
,"10/05/2025","8400/000 : FNB","99.00 CHATBASE 4XX*5191 09 MAY XX6889 99.00 CHATBASE 4XXXXX*5191 09 MAY XXXXXXXXXXXXXXXXXXX6889","Account Payment","99.00 CHATBASE 4XX*5191 09 MAY XX6889 99.00 CHATBASE 4XXXXX*5191 09 MAY XXXXXXXXXXXXXXXXXXX6889","1853.21",,"1225989.74"
,"10/05/2025","8400/000 : FNB","Github Inc. 91.00 GITHUB, INC. 4XXXXX*5191 08 MAY XXXXXXXXXXXXXXXXXXX2406 Github Inc.","Account Payment","Github Inc. 91.00 GITHUB, INC. 4XXXXX*5191 08 MAY XXXXXXXXXXXXXXXXXXX2406 Github Inc.","1703.39",,"1227693.13"
,"10/05/2025","8400/000 : FNB","72.00 TERMIUS CORPO 4XX*5191 08 MAY XX3711 72.00 TERMIUS CORPO 4XXXXX*5191 08 MAY XXXXXXXXXXXXXXXXXX","Account Payment","72.00 TERMIUS CORPO 4XX*5191 08 MAY XX3711 72.00 TERMIUS CORPO 4XXXXX*5191 08 MAY XXXXXXXXXXXXXXXXX","1347.74",,"1229040.87"
,"10/05/2025","8400/000 : FNB","25.00 NOTION LABS, 4XX*5191 08 MAY XX5089 25.00 NOTION LABS, 4XXXXX*5191 08 MAY XXXXXXXXXXXXXXXXXXX5","Account Payment","25.00 NOTION LABS, 4XX*5191 08 MAY XX5089 25.00 NOTION LABS, 4XXXXX*5191 08 MAY XXXXXXXXXXXXXXXXXXX","467.97",,"1229508.84"
,"10/05/2025","8400/000 : FNB","Google Play 434.99 Google Perpl 4XXXXX*5191 09 MAY XXXXXXXXXXXXXXXXXXX1035 Google Play","Account Payment","Google Play 434.99 Google Perpl 4XXXXX*5191 09 MAY XXXXXXXXXXXXXXXXXXX1035 Google Play","434.99",,"1229943.83"
,"10/05/2025","8400/000 : FNB","19.00 CHATBASE 4XX*5191 08 MAY XX6135 19.00 CHATBASE 4XXXXX*5191 08 MAY XXXXXXXXXXXXXXXXXXX6135","Account Payment","19.00 CHATBASE 4XX*5191 08 MAY XX6135 19.00 CHATBASE 4XXXXX*5191 08 MAY XXXXXXXXXXXXXXXXXXX6135","355.65",,"1230299.48"
,"10/05/2025","8400/000 : FNB","Paddle 187.94 PADDLE.NET* 4XXXXX*5191 08 MAY XXXXXXXXXXXXXXXXXXX5165 Paddle","Account Payment","Paddle 187.94 PADDLE.NET* 4XXXXX*5191 08 MAY XXXXXXXXXXXXXXXXXXX5165 Paddle","187.94",,"1230487.42"
,"10/05/2025","8400/000 : FNB","Google Store 34.99 Google One 4XXXXX*5191 08 MAY XXXXXXXXXXXXXXXXXXX1020 Google Store","Account Payment","Google Store 34.99 Google One 4XXXXX*5191 08 MAY XXXXXXXXXXXXXXXXXXX1020 Google Store","34.99",,"1230522.41"
,"12/05/2025","8400/000 : FNB","920.00 AUTH0.COM 4XX*5191 09 MAY XX9909 920.00 AUTH0.COM 4XXXXX*5191 09 MAY XXXXXXXXXXXXXXXXXXX9909","Account Payment","920.00 AUTH0.COM 4XX*5191 09 MAY XX9909 920.00 AUTH0.COM 4XXXXX*5191 09 MAY XXXXXXXXXXXXXXXXXXX9909","17221.7",,"1247744.11"
,"12/05/2025","8400/000 : FNB","174.00 INTERCOM R&D 4XX*5191 09 MAY XX8678 174.00 INTERCOM R&D 4XXXXX*5191 09 MAY XXXXXXXXXXXXXXXXXX","Account Payment","174.00 INTERCOM R&D 4XX*5191 09 MAY XX8678 174.00 INTERCOM R&D 4XXXXX*5191 09 MAY XXXXXXXXXXXXXXXXX","3257.15",,"1251001.26"
,"12/05/2025","8400/000 : FNB","70.00 NOTION LABS, 4XX*5191 10 MAY XX5242 70.00 NOTION LABS, 4XXXXX*5191 10 MAY XXXXXXXXXXXXXXXXXXX5","Account Payment","70.00 NOTION LABS, 4XX*5191 10 MAY XX5242 70.00 NOTION LABS, 4XXXXX*5191 10 MAY XXXXXXXXXXXXXXXXXXX","1307.76",,"1252309.02"
,"12/05/2025","8400/000 : FNB","49.00 SKRAPP.IO STA 4XX*5191 09 MAY XX3319 49.00 SKRAPP.IO STA 4XXXXX*5191 09 MAY XXXXXXXXXXXXXXXXXX","Account Payment","49.00 SKRAPP.IO STA 4XX*5191 09 MAY XX3319 49.00 SKRAPP.IO STA 4XXXXX*5191 09 MAY XXXXXXXXXXXXXXXXX","917.25",,"1253226.27"
,"12/05/2025","8400/000 : FNB","Digitalocean 47.84 DIGITALOCEAN. 4XXXXX*5191 09 MAY XXXXXXXXXXXXXXXXXXX1977 Digitalocean","Account Payment","Digitalocean 47.84 DIGITALOCEAN. 4XXXXX*5191 09 MAY XXXXXXXXXXXXXXXXXXX1977 Digitalocean","895.53",,"1254121.8"
,"12/05/2025","8400/000 : FNB","40.00 REPLIT, INC. 4XX*5191 09 MAY XX2533 40.00 REPLIT, INC. 4XXXXX*5191 09 MAY XXXXXXXXXXXXXXXXXXX2","Account Payment","40.00 REPLIT, INC. 4XX*5191 09 MAY XX2533 40.00 REPLIT, INC. 4XXXXX*5191 09 MAY XXXXXXXXXXXXXXXXXXX","748.77",,"1254870.57"
,"12/05/2025","8400/000 : FNB","Intuit 570.40 INTUIT *QBoo 4XXXXX*5225 09 MAY XXXXXXXXXXXXXXXXXXX9272 Intuit","Account Payment","Intuit 570.40 INTUIT *QBoo 4XXXXX*5225 09 MAY XXXXXXXXXXXXXXXXXXX9272 Intuit","570.4",,"1255440.97"
,"12/05/2025","8400/000 : FNB","30.00 ISHRAQ LLC 4XX*5191 09 MAY XX1483 30.00 ISHRAQ LLC 4XXXXX*5191 09 MAY XXXXXXXXXXXXXXXXXXX1483","Account Payment","30.00 ISHRAQ LLC 4XX*5191 09 MAY XX1483 30.00 ISHRAQ LLC 4XXXXX*5191 09 MAY XXXXXXXXXXXXXXXXXXX1483","561.58",,"1256002.55"
,"12/05/2025","8400/000 : FNB","30.00 XAI LLC 4XX*5191 09 MAY XX7532 30.00 XAI LLC 4XXXXX*5191 09 MAY XXXXXXXXXXXXXXXXXXX7532","Account Payment","30.00 XAI LLC 4XX*5191 09 MAY XX7532 30.00 XAI LLC 4XXXXX*5191 09 MAY XXXXXXXXXXXXXXXXXXX7532","561.58",,"1256564.13"
,"12/05/2025","8400/000 : FNB","25.00 BEECEPTOR 4XX*5191 09 MAY XX0040 25.00 BEECEPTOR 4XXXXX*5191 09 MAY XXXXXXXXXXXXXXXXXXX0040","Account Payment","25.00 BEECEPTOR 4XX*5191 09 MAY XX0040 25.00 BEECEPTOR 4XXXXX*5191 09 MAY XXXXXXXXXXXXXXXXXXX0040","467.98",,"1257032.11"
,"12/05/2025","8400/000 : FNB","25.00 BEECEPTOR 4XX*5191 09 MAY XX0096 25.00 BEECEPTOR 4XXXXX*5191 09 MAY XXXXXXXXXXXXXXXXXXX0096","Account Payment","25.00 BEECEPTOR 4XX*5191 09 MAY XX0096 25.00 BEECEPTOR 4XXXXX*5191 09 MAY XXXXXXXXXXXXXXXXXXX0096","467.98",,"1257500.09"
,"12/05/2025","8400/000 : FNB","Facebook 23.00 FACEBK *P4SNN 4XXXXX*5191 09 MAY XXXXXXXXXXXXXXXXXXX3027 Facebook","Account Payment","Facebook 23.00 FACEBK *P4SNN 4XXXXX*5191 09 MAY XXXXXXXXXXXXXXXXXXX3027 Facebook","430.54",,"1257930.63"
,"12/05/2025","8400/000 : FNB","20.00 VERCEL INC. 4XX*5191 09 MAY XX9944 20.00 VERCEL INC. 4XXXXX*5191 09 MAY XXXXXXXXXXXXXXXXXXX994","Account Payment","20.00 VERCEL INC. 4XX*5191 09 MAY XX9944 20.00 VERCEL INC. 4XXXXX*5191 09 MAY XXXXXXXXXXXXXXXXXXX99","374.38",,"1258305.01"
,"12/05/2025","8400/000 : FNB","Hightail 15.00 HIGHTAIL 4XXXXX*5191 09 MAY XXXXXXXXXXXXXXXXXXX3054 Hightail","Account Payment","Hightail 15.00 HIGHTAIL 4XXXXX*5191 09 MAY XXXXXXXXXXXXXXXXXXX3054 Hightail","280.79",,"1258585.8"
,"12/05/2025","8400/000 : FNB","Facebook 13.80 FACEBK *EBA7K 4XXXXX*5191 09 MAY XXXXXXXXXXXXXXXXXXX6095 Facebook","Account Payment","Facebook 13.80 FACEBK *EBA7K 4XXXXX*5191 09 MAY XXXXXXXXXXXXXXXXXXX6095 Facebook","258.33",,"1258844.13"
,"12/05/2025","8400/000 : FNB","7.00 CHATBASE 4XX*5191 10 MAY XX3978 7.00 CHATBASE 4XXXXX*5191 10 MAY XXXXXXXXXXXXXXXXXXX3978","Account Payment","7.00 CHATBASE 4XX*5191 10 MAY XX3978 7.00 CHATBASE 4XXXXX*5191 10 MAY XXXXXXXXXXXXXXXXXXX3978","130.77",,"1258974.9"
,"12/05/2025","8400/000 : FNB","Facebook 4.60 FACEBK *RVMWPQ 4XXXXX*5191 09 MAY XXXXXXXXXXXXXXXXXXX7055 Facebook","Account Payment","Facebook 4.60 FACEBK *RVMWPQ 4XXXXX*5191 09 MAY XXXXXXXXXXXXXXXXXXX7055 Facebook","86.11",,"1259061.01"
,"12/05/2025","8400/000 : FNB","1.50 LINODE . AKAMA 4XX*5191 09 MAY XX3922 1.50 LINODE . AKAMA 4XXXXX*5191 09 MAY XXXXXXXXXXXXXXXXXX","Account Payment","1.50 LINODE . AKAMA 4XX*5191 09 MAY XX3922 1.50 LINODE . AKAMA 4XXXXX*5191 09 MAY XXXXXXXXXXXXXXXXX","28.08",,"1259089.09"
,"13/05/2025","8400/000 : FNB","Shopify 3633.95 SHOPIFY* 36 4XXXXX*5225 10 MAY XXXXXXXXXXXXXXXXXXX4805 Shopify","Account Payment","Shopify 3633.95 SHOPIFY* 36 4XXXXX*5225 10 MAY XXXXXXXXXXXXXXXXXXX4805 Shopify","67890.59",,"1326979.68"
,"13/05/2025","8400/000 : FNB","500.00 KDZ LLC 4XX*5191 10 MAY XX7664 500.00 KDZ LLC 4XXXXX*5191 10 MAY XXXXXXXXXXXXXXXXXXX7664","Account Payment","500.00 KDZ LLC 4XX*5191 10 MAY XX7664 500.00 KDZ LLC 4XXXXX*5191 10 MAY XXXXXXXXXXXXXXXXXXX7664","9341.16",,"1336320.84"
,"13/05/2025","8400/000 : FNB","499.00 CASSIDYAI.CO 4XX*5191 09 MAY XX3102 499.00 CASSIDYAI.CO 4XXXXX*5191 09 MAY XXXXXXXXXXXXXXXXXX","Account Payment","499.00 CASSIDYAI.CO 4XX*5191 09 MAY XX3102 499.00 CASSIDYAI.CO 4XXXXX*5191 09 MAY XXXXXXXXXXXXXXXXX","9340.89",,"1345661.73"
,"13/05/2025","8400/000 : FNB","350.00 KODZ LLC 4XX*5191 10 MAY XX8016 350.00 KODZ LLC 4XXXXX*5191 10 MAY XXXXXXXXXXXXXXXXXXX8016","Account Payment","350.00 KODZ LLC 4XX*5191 10 MAY XX8016 350.00 KODZ LLC 4XXXXX*5191 10 MAY XXXXXXXXXXXXXXXXXXX8016","6538.81",,"1352200.54"
,"13/05/2025","8400/000 : FNB","249.00 EMBEDCHAIN 4XX*5191 10 MAY XX3045 249.00 EMBEDCHAIN 4XXXXX*5191 10 MAY XXXXXXXXXXXXXXXXXXX304","Account Payment","249.00 EMBEDCHAIN 4XX*5191 10 MAY XX3045 249.00 EMBEDCHAIN 4XXXXX*5191 10 MAY XXXXXXXXXXXXXXXXXXX30","4651.89",,"1356852.43"
,"13/05/2025","8400/000 : FNB","Github Inc. 210.00 GITHUB, INC. 4XXXXX*5225 11 MAY XXXXXXXXXXXXXXXXXXX4792 Github Inc.","Account Payment","Github Inc. 210.00 GITHUB, INC. 4XXXXX*5225 11 MAY XXXXXXXXXXXXXXXXXXX4792 Github Inc.","3923.29",,"1360775.72"
,"13/05/2025","8400/000 : FNB","99.00 PLAYFAB, INC. 4XX*5191 10 MAY XX2050 99.00 PLAYFAB, INC. 4XXXXX*5191 10 MAY XXXXXXXXXXXXXXXXXX","Account Payment","99.00 PLAYFAB, INC. 4XX*5191 10 MAY XX2050 99.00 PLAYFAB, INC. 4XXXXX*5191 10 MAY XXXXXXXXXXXXXXXXX","1849.55",,"1362625.27"
,"13/05/2025","8400/000 : FNB","99.00 DMNS.APP BUSI 4XX*5191 10 MAY XX8580 99.00 DMNS.APP BUSI 4XXXXX*5191 10 MAY XXXXXXXXXXXXXXXXXX","Account Payment","99.00 DMNS.APP BUSI 4XX*5191 10 MAY XX8580 99.00 DMNS.APP BUSI 4XXXXX*5191 10 MAY XXXXXXXXXXXXXXXXX","1849.55",,"1364474.82"
,"13/05/2025","8400/000 : FNB","99.00 DYNAMIC.XYZ 4XX*5191 11 MAY XX0826 99.00 DYNAMIC.XYZ 4XXXXX*5191 11 MAY XXXXXXXXXXXXXXXXXXX082","Account Payment","99.00 DYNAMIC.XYZ 4XX*5191 11 MAY XX0826 99.00 DYNAMIC.XYZ 4XXXXX*5191 11 MAY XXXXXXXXXXXXXXXXXXX08","1849.55",,"1366324.37"
,"13/05/2025","8400/000 : FNB","Shopify 74.75 SHOPIFY* 3642 4XXXXX*5225 10 MAY XXXXXXXXXXXXXXXXXXX9234 Shopify","Account Payment","Shopify 74.75 SHOPIFY* 3642 4XXXXX*5225 10 MAY XXXXXXXXXXXXXXXXXXX9234 Shopify","1396.5",,"1367720.87"
,"13/05/2025","8400/000 : FNB","Github Inc. 70.57 GITHUB, INC. 4XXXXX*5191 11 MAY XXXXXXXXXXXXXXXXXXX2963 Github Inc.","Account Payment","Github Inc. 70.57 GITHUB, INC. 4XXXXX*5191 11 MAY XXXXXXXXXXXXXXXXXXX2963 Github Inc.","1318.41",,"1369039.28"
,"13/05/2025","8400/000 : FNB","67.85 LEMSQZY* CHAT 4XX*5191 10 MAY XX0969 67.85 LEMSQZY* CHAT 4XXXXX*5191 10 MAY XXXXXXXXXXXXXXXXXX","Account Payment","67.85 LEMSQZY* CHAT 4XX*5191 10 MAY XX0969 67.85 LEMSQZY* CHAT 4XXXXX*5191 10 MAY XXXXXXXXXXXXXXXXX","1267.59",,"1370306.87"
,"13/05/2025","8400/000 : FNB","60.00 INSOMNIA TEAM 4XX*5191 11 MAY XX1829 60.00 INSOMNIA TEAM 4XXXXX*5191 11 MAY XXXXXXXXXXXXXXXXXX","Account Payment","60.00 INSOMNIA TEAM 4XX*5191 11 MAY XX1829 60.00 INSOMNIA TEAM 4XXXXX*5191 11 MAY XXXXXXXXXXXXXXXXX","1120.94",,"1371427.81"
,"13/05/2025","8400/000 : FNB","52.66 WINDSURF 4XX*5191 10 MAY XX3983 52.66 WINDSURF 4XXXXX*5191 10 MAY XXXXXXXXXXXXXXXXXXX3983","Account Payment","52.66 WINDSURF 4XX*5191 10 MAY XX3983 52.66 WINDSURF 4XXXXX*5191 10 MAY XXXXXXXXXXXXXXXXXXX3983","983.81",,"1372411.62"
,"13/05/2025","8400/000 : FNB","Github Inc. 42.00 GITHUB, INC. 4XXXXX*5191 11 MAY XXXXXXXXXXXXXXXXXXX8456 Github Inc.","Account Payment","Github Inc. 42.00 GITHUB, INC. 4XXXXX*5191 11 MAY XXXXXXXXXXXXXXXXXXX8456 Github Inc.","784.66",,"1373196.28"
,"13/05/2025","8400/000 : FNB","32.00 BUBBLE STARTE 4XX*5191 11 MAY XX4453 32.00 BUBBLE STARTE 4XXXXX*5191 11 MAY XXXXXXXXXXXXXXXXXX","Account Payment","32.00 BUBBLE STARTE 4XX*5191 11 MAY XX4453 32.00 BUBBLE STARTE 4XXXXX*5191 11 MAY XXXXXXXXXXXXXXXXX","597.83",,"1373794.11"
,"13/05/2025","8400/000 : FNB","Facebook 417.89 FACEBK *4SY3 4XXXXX*5191 11 MAY XXXXXXXXXXXXXXXXXXX3024 Facebook","Account Payment","Facebook 417.89 FACEBK *4SY3 4XXXXX*5191 11 MAY XXXXXXXXXXXXXXXXXXX3024 Facebook","417.89",,"1374212"
,"13/05/2025","8400/000 : FNB","21.56 SLACK T0740DV 4XX*5191 10 MAY XX9339 21.56 SLACK T0740DV 4XXXXX*5191 10 MAY XXXXXXXXXXXXXXXXXX","Account Payment","21.56 SLACK T0740DV 4XX*5191 10 MAY XX9339 21.56 SLACK T0740DV 4XXXXX*5191 10 MAY XXXXXXXXXXXXXXXXX","402.79",,"1374614.79"
,"13/05/2025","8400/000 : FNB","15.00 CAL.COM 4XX*5191 10 MAY XX7942 15.00 CAL.COM 4XXXXX*5191 10 MAY XXXXXXXXXXXXXXXXXXX7942","Account Payment","15.00 CAL.COM 4XX*5191 10 MAY XX7942 15.00 CAL.COM 4XXXXX*5191 10 MAY XXXXXXXXXXXXXXXXXXX7942","280.23",,"1374895.02"
,"13/05/2025","8400/000 : FNB","9.00 TWENTY.COM 4XX*5191 11 MAY XX2425 9.00 TWENTY.COM 4XXXXX*5191 11 MAY XXXXXXXXXXXXXXXXXXX2425","Account Payment","9.00 TWENTY.COM 4XX*5191 11 MAY XX2425 9.00 TWENTY.COM 4XXXXX*5191 11 MAY XXXXXXXXXXXXXXXXXXX2425","168.14",,"1375063.16"
,"14/05/2025","8400/000 : FNB","50.30 LINODE . AKAM 4XX*5191 12 MAY XX9059 50.30 LINODE . AKAM 4XXXXX*5191 12 MAY XXXXXXXXXXXXXXXXXX","Account Payment","50.30 LINODE . AKAM 4XX*5191 12 MAY XX9059 50.30 LINODE . AKAM 4XXXXX*5191 12 MAY XXXXXXXXXXXXXXXXX","939.72",,"1376002.88"
,"14/05/2025","8400/000 : FNB","15.00 TABNINE 4XX*5191 12 MAY XX3180 15.00 TABNINE 4XXXXX*5191 12 MAY XXXXXXXXXXXXXXXXXXX3180","Account Payment","15.00 TABNINE 4XX*5191 12 MAY XX3180 15.00 TABNINE 4XXXXX*5191 12 MAY XXXXXXXXXXXXXXXXXXX3180","280.23",,"1376283.11"
,"15/05/2025","8400/000 : FNB","180.00 AGENCYANALYT 4XX*5225 13 MAY XX4040 180.00 AGENCYANALYT 4XXXXX*5225 13 MAY XXXXXXXXXXXXXXXXXX","Account Payment","180.00 AGENCYANALYT 4XX*5225 13 MAY XX4040 180.00 AGENCYANALYT 4XXXXX*5225 13 MAY XXXXXXXXXXXXXXXXX","3369.05",,"1379652.16"
,"15/05/2025","8400/000 : FNB","57.33 PADDLE.NET* W 4XX*5191 14 MAY XX7489 57.33 PADDLE.NET* W 4XXXXX*5191 14 MAY XXXXXXXXXXXXXXXXXX","Account Payment","57.33 PADDLE.NET* W 4XX*5191 14 MAY XX7489 57.33 PADDLE.NET* W 4XXXXX*5191 14 MAY XXXXXXXXXXXXXXXXX","1080.95",,"1380733.11"
,"15/05/2025","8400/000 : FNB","29.12 RAILWAY 4XX*5191 13 MAY XX1847 29.12 RAILWAY 4XXXXX*5191 13 MAY XXXXXXXXXXXXXXXXXXX1847","Account Payment","29.12 RAILWAY 4XX*5191 13 MAY XX1847 29.12 RAILWAY 4XXXXX*5191 13 MAY XXXXXXXXXXXXXXXXXXX1847","545.04",,"1381278.15"
,"15/05/2025","8400/000 : FNB","5.00 WWW.FLUX.AI 4XX*5191 13 MAY XX0251 5.00 WWW.FLUX.AI 4XXXXX*5191 13 MAY XXXXXXXXXXXXXXXXXXX0251","Account Payment","5.00 WWW.FLUX.AI 4XX*5191 13 MAY XX0251 5.00 WWW.FLUX.AI 4XXXXX*5191 13 MAY XXXXXXXXXXXXXXXXXXX0251","93.59",,"1381371.74"
,"16/05/2025","8400/000 : FNB","Google Service Charges/Fees #INT PYMT FEE-34.99 Googl Google","Account Payment","Google Service Charges/Fees INT PYMT FEE-34.99 Googl Google","0.7",,"1381372.44"
,"16/05/2025","8400/000 : FNB","Google Service Charges/Fees #INT PYMT FEE-434.99 Goog Google","Account Payment","Google Service Charges/Fees INT PYMT FEE-434.99 Goog Google","8.7",,"1381381.14"
,"16/05/2025","8400/000 : FNB","Google Service Charges/Fees #INT PYMT FEE-224.99 Goog Google","Account Payment","Google Service Charges/Fees INT PYMT FEE-224.99 Goog Google","4.5",,"1381385.64"
,"16/05/2025","8400/000 : FNB","25.12 RAILWAY 4XX*5191 14 MAY XX1608 25.12 RAILWAY 4XXXXX*5191 14 MAY XXXXXXXXXXXXXXXXXXX1608","Account Payment","25.12 RAILWAY 4XX*5191 14 MAY XX1608 25.12 RAILWAY 4XXXXX*5191 14 MAY XXXXXXXXXXXXXXXXXXX1608","473.64",,"1381859.28"
,"16/05/2025","8400/000 : FNB","Github Inc. 14.00 GITHUB, INC. 4XXXXX*5225 14 MAY XXXXXXXXXXXXXXXXXXX4640 Github Inc.","Account Payment","Github Inc. 14.00 GITHUB, INC. 4XXXXX*5225 14 MAY XXXXXXXXXXXXXXXXXXX4640 Github Inc.","263.97",,"1382123.25"
,"16/05/2025","8400/000 : FNB","11.49 GOOGLE *Colab 4XX*5191 14 MAY XX9898 11.49 GOOGLE *Colab 4XXXXX*5191 14 MAY XXXXXXXXXXXXXXXXXX","Account Payment","11.49 GOOGLE *Colab 4XX*5191 14 MAY XX9898 11.49 GOOGLE *Colab 4XXXXX*5191 14 MAY XXXXXXXXXXXXXXXXX","216.64",,"1382339.89"
,"16/05/2025","8400/000 : FNB","280.00 WIZA.CO 4XX*5191 14 MAY XX6125 280.00 WIZA.CO 4XXXXX*5191 14 MAY XXXXXXXXXXXXXXXXXXX6125","Account Payment","280.00 WIZA.CO 4XX*5191 14 MAY XX6125 280.00 WIZA.CO 4XXXXX*5191 14 MAY XXXXXXXXXXXXXXXXXXX6125","5279.34",,"1387619.23"
,"16/05/2025","8400/000 : FNB","156.98 SLACK T0MN3D 4XX*5225 15 MAY XX1897 156.98 SLACK T0MN3D 4XXXXX*5225 15 MAY XXXXXXXXXXXXXXXXXX","Account Payment","156.98 SLACK T0MN3D 4XX*5225 15 MAY XX1897 156.98 SLACK T0MN3D 4XXXXX*5225 15 MAY XXXXXXXXXXXXXXXXX","2943.44",,"1390562.67"
,"16/05/2025","8400/000 : FNB","52.20 REPLIT, INC. 4XX*5191 14 MAY XX8688 52.20 REPLIT, INC. 4XXXXX*5191 14 MAY XXXXXXXXXXXXXXXXXXX8","Account Payment","52.20 REPLIT, INC. 4XX*5191 14 MAY XX8688 52.20 REPLIT, INC. 4XXXXX*5191 14 MAY XXXXXXXXXXXXXXXXXXX","984.22",,"1391546.89"
,"17/05/2025","8400/000 : FNB","376.40 HOLASPIRIT 4XX*5225 15 MAY XX4365 376.40 HOLASPIRIT 4XXXXX*5225 15 MAY XXXXXXXXXXXXXXXXXXX436","Account Payment","376.40 HOLASPIRIT 4XX*5225 15 MAY XX4365 376.40 HOLASPIRIT 4XXXXX*5225 15 MAY XXXXXXXXXXXXXXXXXXX43","7932.59",,"1399479.48"
,"17/05/2025","8400/000 : FNB","231.95 HOLASPIRIT 4XX*5225 15 MAY XX9575 231.95 HOLASPIRIT 4XXXXX*5225 15 MAY XXXXXXXXXXXXXXXXXXX957","Account Payment","231.95 HOLASPIRIT 4XX*5225 15 MAY XX9575 231.95 HOLASPIRIT 4XXXXX*5225 15 MAY XXXXXXXXXXXXXXXXXXX95","4888.32",,"1404367.8"
,"17/05/2025","8400/000 : FNB","350.00 FRAMER.COM 4XX*5191 16 MAY XX6981 350.00 FRAMER.COM 4XXXXX*5191 16 MAY XXXXXXXXXXXXXXXXXXX698","Account Payment","350.00 FRAMER.COM 4XX*5191 16 MAY XX6981 350.00 FRAMER.COM 4XXXXX*5191 16 MAY XXXXXXXXXXXXXXXXXXX69","350",,"1404717.8"
,"19/05/2025","8400/000 : FNB","20.00 VERCEL INC. 4XX*5191 16 MAY XX1268 20.00 VERCEL INC. 4XXXXX*5191 16 MAY XXXXXXXXXXXXXXXXXXX126","Account Payment","20.00 VERCEL INC. 4XX*5191 16 MAY XX1268 20.00 VERCEL INC. 4XXXXX*5191 16 MAY XXXXXXXXXXXXXXXXXXX12","373.52",,"1405091.32"
,"20/05/2025","8400/000 : FNB","Wix.com 579.60 WIX.COM 4XXXXX*5191 18 MAY XXXXXXXXXXXXXXXXXXX6952 Wix.com","Account Payment","Wix.com 579.60 WIX.COM 4XXXXX*5191 18 MAY XXXXXXXXXXXXXXXXXXX6952 Wix.com","10727.41",,"1415818.73"
,"21/05/2025","8400/000 : FNB","374.00 MANGOAPPS 4XX*5191 19 MAY XX5114 374.00 MANGOAPPS 4XXXXX*5191 19 MAY XXXXXXXXXXXXXXXXXXX5114","Account Payment","374.00 MANGOAPPS 4XX*5191 19 MAY XX5114 374.00 MANGOAPPS 4XXXXX*5191 19 MAY XXXXXXXXXXXXXXXXXXX5114","6922.11",,"1422740.84"
,"21/05/2025","8400/000 : FNB","59.00 GREENBACK.COM 4XX*5225 19 MAY XX9655 59.00 GREENBACK.COM 4XXXXX*5225 19 MAY XXXXXXXXXXXXXXXXXX","Account Payment","59.00 GREENBACK.COM 4XX*5225 19 MAY XX9655 59.00 GREENBACK.COM 4XXXXX*5225 19 MAY XXXXXXXXXXXXXXXXX","1091.99",,"1423832.83"
,"22/05/2025","8400/000 : FNB","74.00 PIPEDREAM, IN 4XX*5191 20 MAY XX9052 74.00 PIPEDREAM, IN 4XXXXX*5191 20 MAY XXXXXXXXXXXXXXXXXX","Account Payment","74.00 PIPEDREAM, IN 4XX*5191 20 MAY XX9052 74.00 PIPEDREAM, IN 4XXXXX*5191 20 MAY XXXXXXXXXXXXXXXXX","1367.02",,"1425199.85"
,"22/05/2025","8400/000 : FNB","54.00 AIRTABLE.COM/ 4XX*5191 21 MAY XX9771 54.00 AIRTABLE.COM/ 4XXXXX*5191 21 MAY XXXXXXXXXXXXXXXXXX","Account Payment","54.00 AIRTABLE.COM/ 4XX*5191 21 MAY XX9771 54.00 AIRTABLE.COM/ 4XXXXX*5191 21 MAY XXXXXXXXXXXXXXXXX","998.16",,"1426198.01"
,"27/05/2025","8400/000 : FNB","150.00 AUTH0.COM 4XX*5191 25 MAY XX4215 150.00 AUTH0.COM 4XXXXX*5191 25 MAY XXXXXXXXXXXXXXXXXXX4215","Account Payment","150.00 AUTH0.COM 4XX*5191 25 MAY XX4215 150.00 AUTH0.COM 4XXXXX*5191 25 MAY XXXXXXXXXXXXXXXXXXX4215","2759.57",,"1428957.58"
,"27/05/2025","8400/000 : FNB","399.99 POE.COM 4XX*5191 26 MAY XX8987 399.99 POE.COM 4XXXXX*5191 26 MAY XXXXXXXXXXXXXXXXXXX8987","Account Payment","399.99 POE.COM 4XX*5191 26 MAY XX8987 399.99 POE.COM 4XXXXX*5191 26 MAY XXXXXXXXXXXXXXXXXXX8987","399.99",,"1429357.57"
"3300/020 : Computer - Platforms","Closing Balance as at: 28/02/2026",,,,,"1429357.57",,
,"Movement for the period",,,,,"1429357.57",,