Account Description,Account Date,Bank / Customer / Supplier,Reference,Transaction Type,Description,Debit,Credit,Balance,Source File,Transaction ID,Year-Month,Is Duplicate,Category,Refined Category,Final Category
,2025-03-01,8400/000 : FNB,Shopify 3421.17 SHOPIFY* 33 4XXXXX*5191 27 FEB XXXXXXXXXXXXXXXXXXX6960 Shopify,Account Payment,Shopify 3421.17 SHOPIFY* 33 4XXXXX*5191 27 FEB XXXXXXXXXXXXXXXXXXX6960 Shopify,64465.0,,64465.0,AccountTransactionsReport.csv,1,2025-03,False,E-commerce Platforms,E-commerce Platforms,E-commerce Platforms
,2025-03-01,8400/000 : FNB,Intuit 570.40 INTUIT *QBoo 4XXXXX*5225 27 FEB XXXXXXXXXXXXXXXXXXX2756 Intuit,Account Payment,Intuit 570.40 INTUIT *QBoo 4XXXXX*5225 27 FEB XXXXXXXXXXXXXXXXXXX2756 Intuit,570.4,,65035.4,AccountTransactionsReport.csv,2,2025-03,False,Productivity Software,Productivity Software,Productivity Software
,2025-03-01,8400/000 : FNB,Intuit 570.40 INTUIT *QBoo 4XXXXX*5225 27 FEB XXXXXXXXXXXXXXXXXXX2814 Intuit,Account Payment,Intuit 570.40 INTUIT *QBoo 4XXXXX*5225 27 FEB XXXXXXXXXXXXXXXXXXX2814 Intuit,570.4,,65605.8,AccountTransactionsReport.csv,3,2025-03,False,Productivity Software,Productivity Software,Productivity Software
,2025-03-01,8400/000 : FNB,Intuit 546.25 INTUIT *QBoo 4XXXXX*5225 27 FEB XXXXXXXXXXXXXXXXXXX2509 Intuit,Account Payment,Intuit 546.25 INTUIT *QBoo 4XXXXX*5225 27 FEB XXXXXXXXXXXXXXXXXXX2509 Intuit,546.25,,66152.05,AccountTransactionsReport.csv,4,2025-03,False,Productivity Software,Productivity Software,Productivity Software
,2025-03-01,8400/000 : FNB,399.99 POE.COM 4XX*5191 27 FEB XX1001 399.99 POE.COM 4XXXXX*5191 27 FEB XXXXXXXXXXXXXXXXXXX1001,Account Payment,399.99 POE.COM 4XX*5191 27 FEB XX1001 399.99 POE.COM 4XXXXX*5191 27 FEB XXXXXXXXXXXXXXXXXXX1001,399.99,,66552.04,AccountTransactionsReport.csv,5,2025-03,False,Other Computer Services,Other Computer Services,Other Computer Services
,2025-03-03,8400/000 : FNB,67.85 LEMSQZY* CHAT 4XX*5191 01 MAR XX9146 67.85 LEMSQZY* CHAT 4XXXXX*5191 01 MAR XXXXXXXXXXXXXXXXXX,Account Payment,67.85 LEMSQZY* CHAT 4XX*5191 01 MAR XX9146 67.85 LEMSQZY* CHAT 4XXXXX*5191 01 MAR XXXXXXXXXXXXXXXXX,1297.65,,67849.69,AccountTransactionsReport.csv,6,2025-03,False,AI Services,AI Services,AI Services
,2025-03-03,8400/000 : FNB,50.12 FRAPPE CLOUD 4XX*5191 28 FEB XX0584 50.12 FRAPPE CLOUD 4XXXXX*5191 28 FEB XXXXXXXXXXXXXXXXXXX0,Account Payment,50.12 FRAPPE CLOUD 4XX*5191 28 FEB XX0584 50.12 FRAPPE CLOUD 4XXXXX*5191 28 FEB XXXXXXXXXXXXXXXXXXX,945.83,,68795.52,AccountTransactionsReport.csv,7,2025-03,False,Other Computer Services,Other Computer Services,Other Computer Services
,2025-03-03,8400/000 : FNB,Digitalocean 47.84 DIGITALOCEAN. 4XXXXX*5191 01 MAR XXXXXXXXXXXXXXXXXXX0133 Digitalocean,Account Payment,Digitalocean 47.84 DIGITALOCEAN. 4XXXXX*5191 01 MAR XXXXXXXXXXXXXXXXXXX0133 Digitalocean,914.95,,69710.47,AccountTransactionsReport.csv,8,2025-03,False,Cloud Services,Cloud Services,Cloud Services
,2025-03-03,8400/000 : FNB,29.99 BEENVERIFIED 4XX*5191 28 FEB XX6964 29.99 BEENVERIFIED 4XXXXX*5191 28 FEB XXXXXXXXXXXXXXXXXXX6,Account Payment,29.99 BEENVERIFIED 4XX*5191 28 FEB XX6964 29.99 BEENVERIFIED 4XXXXX*5191 28 FEB XXXXXXXXXXXXXXXXXXX,565.95,,70276.42,AccountTransactionsReport.csv,9,2025-03,False,Other Computer Services,Other Computer Services,Other Computer Services
,2025-03-03,8400/000 : FNB,430.00 Dlocal *Micr 4XX*5191 28 FEB XX0372 430.00 Dlocal *Micr 4XXXXX*5191 28 FEB XXXXXXXXXXXXXXXXXX,Account Payment,430.00 Dlocal *Micr 4XX*5191 28 FEB XX0372 430.00 Dlocal *Micr 4XXXXX*5191 28 FEB XXXXXXXXXXXXXXXXX,430.0,,70706.42,AccountTransactionsReport.csv,10,2025-03,False,Other Computer Services,Other Computer Services,Other Computer Services
,2025-03-03,8400/000 : FNB,21.37 LINODE . AKAM 4XX*5191 01 MAR XX7671 21.37 LINODE . AKAM 4XXXXX*5191 01 MAR XXXXXXXXXXXXXXXXXX,Account Payment,21.37 LINODE . AKAM 4XX*5191 01 MAR XX7671 21.37 LINODE . AKAM 4XXXXX*5191 01 MAR XXXXXXXXXXXXXXXXX,408.7,,71115.12,AccountTransactionsReport.csv,11,2025-03,False,Cloud Services,Cloud Services,Cloud Services
,2025-03-03,8400/000 : FNB,9.00 GITPOD.IO 4XX*5191 28 FEB XX4731 9.00 GITPOD.IO 4XXXXX*5191 28 FEB XXXXXXXXXXXXXXXXXXX4731,Account Payment,9.00 GITPOD.IO 4XX*5191 28 FEB XX4731 9.00 GITPOD.IO 4XXXXX*5191 28 FEB XXXXXXXXXXXXXXXXXXX4731,169.84,,71284.96,AccountTransactionsReport.csv,12,2025-03,False,Development Tools,Development Tools,Development Tools
,2025-03-03,8400/000 : FNB,5.00 COMPONENTS.STU 4XX*5191 28 FEB XX9447 5.00 COMPONENTS.STU 4XXXXX*5191 28 FEB XXXXXXXXXXXXXXXXXX,Account Payment,5.00 COMPONENTS.STU 4XX*5191 28 FEB XX9447 5.00 COMPONENTS.STU 4XXXXX*5191 28 FEB XXXXXXXXXXXXXXXXX,94.36,,71379.32,AccountTransactionsReport.csv,13,2025-03,False,Other Computer Services,Other Computer Services,Other Computer Services
,2025-03-03,8400/000 : FNB,5050.80 FRESHWORKS 4XX*5225 28 FEB XX6851 5050.80 FRESHWORKS 4XXXXX*5225 28 FEB XXXXXXXXXXXXXXXXXXX6,Account Payment,5050.80 FRESHWORKS 4XX*5225 28 FEB XX6851 5050.80 FRESHWORKS 4XXXXX*5225 28 FEB XXXXXXXXXXXXXXXXXXX,5050.8,,76430.12,AccountTransactionsReport.csv,14,2025-03,False,Productivity Software,Productivity Software,Productivity Software
,2025-03-04,8400/000 : FNB,1.00 VERCEL INC. 4XX*5225 01 MAR XX7108 1.00 VERCEL INC. 4XXXXX*5225 01 MAR XXXXXXXXXXXXXXXXXXX7108,Account Payment,1.00 VERCEL INC. 4XX*5225 01 MAR XX7108 1.00 VERCEL INC. 4XXXXX*5225 01 MAR XXXXXXXXXXXXXXXXXXX7108,19.13,,76449.25,AccountTransactionsReport.csv,15,2025-03,False,Cloud Services,Cloud Services,Cloud Services
,2025-03-04,8400/000 : FNB,1150.00 AUTH0.COM 4XX*5191 01 MAR XX9706 1150.00 AUTH0.COM 4XXXXX*5191 01 MAR XXXXXXXXXXXXXXXXXXX970,Account Payment,1150.00 AUTH0.COM 4XX*5191 01 MAR XX9706 1150.00 AUTH0.COM 4XXXXX*5191 01 MAR XXXXXXXXXXXXXXXXXXX97,21994.1,,98443.35,AccountTransactionsReport.csv,16,2025-03,False,Security Services,Security Services,Security Services
,2025-03-04,8400/000 : FNB,450.00 WAPPALYZER 4XX*5191 02 MAR XX0593 450.00 WAPPALYZER 4XXXXX*5191 02 MAR XXXXXXXXXXXXXXXXXXX059,Account Payment,450.00 WAPPALYZER 4XX*5191 02 MAR XX0593 450.00 WAPPALYZER 4XXXXX*5191 02 MAR XXXXXXXXXXXXXXXXXXX05,8606.38,,107049.73,AccountTransactionsReport.csv,17,2025-03,False,Other Computer Services,Other Computer Services,Other Computer Services
,2025-03-04,8400/000 : FNB,Google Store 365.04 Google GSUIT 4XXXXX*5225 01 MAR XXXXXXXXXXXXXXXXXXX0052 Google Store,Account Payment,Google Store 365.04 Google GSUIT 4XXXXX*5225 01 MAR XXXXXXXXXXXXXXXXXXX0052 Google Store,7255.77,,114305.5,AccountTransactionsReport.csv,18,2025-03,False,Other Computer Services,Analytics & Monitoring,Analytics & Monitoring
,2025-03-04,8400/000 : FNB,"Wix.com 182.85 Wix.Com, Inc 4XXXXX*5191 03 MAR XXXXXXXXXXXXXXXXXXX9071 Wix.com",Account Payment,"Wix.com 182.85 Wix.Com, Inc 4XXXXX*5191 03 MAR XXXXXXXXXXXXXXXXXXX9071 Wix.com",3450.62,,117756.12,AccountTransactionsReport.csv,19,2025-03,False,E-commerce Platforms,E-commerce Platforms,E-commerce Platforms
,2025-03-04,8400/000 : FNB,134.00 SINCH MAILGU 4XX*5191 01 MAR XX1232 134.00 SINCH MAILGU 4XXXXX*5191 01 MAR XXXXXXXXXXXXXXXXXX,Account Payment,134.00 SINCH MAILGU 4XX*5191 01 MAR XX1232 134.00 SINCH MAILGU 4XXXXX*5191 01 MAR XXXXXXXXXXXXXXXXX,2562.79,,120318.91,AccountTransactionsReport.csv,20,2025-03,False,Other Computer Services,Other Computer Services,Other Computer Services
,2025-03-04,8400/000 : FNB,44.13 GOOGLE*GSUITE 4XX*5225 01 MAR XX1686 44.13 GOOGLE*GSUITE 4XXXXX*5225 01 MAR XXXXXXXXXXXXXXXXXX,Account Payment,44.13 GOOGLE*GSUITE 4XX*5225 01 MAR XX1686 44.13 GOOGLE*GSUITE 4XXXXX*5225 01 MAR XXXXXXXXXXXXXXXXX,877.16,,121196.07,AccountTransactionsReport.csv,21,2025-03,False,Other Computer Services,Analytics & Monitoring,Analytics & Monitoring
,2025-03-04,8400/000 : FNB,Google Store 39.82 Google GSUITE 4XXXXX*5191 01 MAR XXXXXXXXXXXXXXXXXXX9050 Google Store,Account Payment,Google Store 39.82 Google GSUITE 4XXXXX*5191 01 MAR XXXXXXXXXXXXXXXXXXX9050 Google Store,791.49,,121987.56,AccountTransactionsReport.csv,22,2025-03,False,Other Computer Services,Analytics & Monitoring,Analytics & Monitoring
,2025-03-04,8400/000 : FNB,Facebook 651.14 FACEBK *9QFB 4XXXXX*5191 02 MAR XXXXXXXXXXXXXXXXXXX5350 Facebook,Account Payment,Facebook 651.14 FACEBK *9QFB 4XXXXX*5191 02 MAR XXXXXXXXXXXXXXXXXXX5350 Facebook,651.14,,122638.7,AccountTransactionsReport.csv,23,2025-03,False,Marketing Tools,Marketing Tools,Marketing Tools
,2025-03-04,8400/000 : FNB,Facebook 23.00 FACEBK *4KCYX 4XXXXX*5191 01 MAR XXXXXXXXXXXXXXXXXXX6040 Facebook,Account Payment,Facebook 23.00 FACEBK *4KCYX 4XXXXX*5191 01 MAR XXXXXXXXXXXXXXXXXXX6040 Facebook,439.89,,123078.59,AccountTransactionsReport.csv,24,2025-03,False,Marketing Tools,Marketing Tools,Marketing Tools
,2025-03-04,8400/000 : FNB,20.00 HUGGINGFACE 4XX*5191 01 MAR XX7397 20.00 HUGGINGFACE 4XXXXX*5191 01 MAR XXXXXXXXXXXXXXXXXXX739,Account Payment,20.00 HUGGINGFACE 4XX*5191 01 MAR XX7397 20.00 HUGGINGFACE 4XXXXX*5191 01 MAR XXXXXXXXXXXXXXXXXXX73,382.51,,123461.1,AccountTransactionsReport.csv,25,2025-03,False,AI Services,AI Services,AI Services
,2025-03-04,8400/000 : FNB,17.25 SLACK T06A3T4 4XX*5191 01 MAR XX2061 17.25 SLACK T06A3T4 4XXXXX*5191 01 MAR XXXXXXXXXXXXXXXXXX,Account Payment,17.25 SLACK T06A3T4 4XX*5191 01 MAR XX2061 17.25 SLACK T06A3T4 4XXXXX*5191 01 MAR XXXXXXXXXXXXXXXXX,329.91,,123791.01,AccountTransactionsReport.csv,26,2025-03,False,Communication,Communication,Communication
,2025-03-04,8400/000 : FNB,Facebook 13.80 FACEBK *5YVGC 4XXXXX*5191 01 MAR XXXXXXXXXXXXXXXXXXX0025 Facebook,Account Payment,Facebook 13.80 FACEBK *5YVGC 4XXXXX*5191 01 MAR XXXXXXXXXXXXXXXXXXX0025 Facebook,263.93,,124054.94,AccountTransactionsReport.csv,27,2025-03,False,Marketing Tools,Marketing Tools,Marketing Tools
,2025-03-04,8400/000 : FNB,Facebook 4.60 FACEBK *7GMZUL 4XXXXX*5191 01 MAR XXXXXXXXXXXXXXXXXXX1026 Facebook,Account Payment,Facebook 4.60 FACEBK *7GMZUL 4XXXXX*5191 01 MAR XXXXXXXXXXXXXXXXXXX1026 Facebook,87.98,,124142.92,AccountTransactionsReport.csv,28,2025-03,False,Marketing Tools,Marketing Tools,Marketing Tools
,2025-03-05,8400/000 : FNB,56.38 PADDLE.NET* W 4XX*5191 04 MAR XX1231 56.38 PADDLE.NET* W 4XXXXX*5191 04 MAR XXXXXXXXXXXXXXXXXX,Account Payment,56.38 PADDLE.NET* W 4XX*5191 04 MAR XX1231 56.38 PADDLE.NET* W 4XXXXX*5191 04 MAR XXXXXXXXXXXXXXXXX,1077.71,,125220.63,AccountTransactionsReport.csv,29,2025-03,False,Other Computer Services,Subscription Management,Subscription Management
,2025-03-05,8400/000 : FNB,60.00 INSOMNIA TEAM 4XX*5191 03 MAR XX4767 60.00 INSOMNIA TEAM 4XXXXX*5191 03 MAR XXXXXXXXXXXXXXXXXX,Account Payment,60.00 INSOMNIA TEAM 4XX*5191 03 MAR XX4767 60.00 INSOMNIA TEAM 4XXXXX*5191 03 MAR XXXXXXXXXXXXXXXXX,1146.91,,126367.54,AccountTransactionsReport.csv,30,2025-03,False,Other Computer Services,Other Computer Services,Other Computer Services
,2025-03-05,8400/000 : FNB,99.00 DMNS.APP BUSI 4XX*5191 04 MAR XX5178 99.00 DMNS.APP BUSI 4XXXXX*5191 04 MAR XXXXXXXXXXXXXXXXXX,Account Payment,99.00 DMNS.APP BUSI 4XX*5191 04 MAR XX5178 99.00 DMNS.APP BUSI 4XXXXX*5191 04 MAR XXXXXXXXXXXXXXXXX,1892.4,,128259.94,AccountTransactionsReport.csv,31,2025-03,False,Other Computer Services,Other Computer Services,Other Computer Services
,2025-03-05,8400/000 : FNB,179.00 MOZSEO:HELP@ 4XX*5191 03 MAR XX9244 179.00 MOZSEO:HELP@ 4XXXXX*5191 03 MAR XXXXXXXXXXXXXXXXXX,Account Payment,179.00 MOZSEO:HELP@ 4XX*5191 03 MAR XX9244 179.00 MOZSEO:HELP@ 4XXXXX*5191 03 MAR XXXXXXXXXXXXXXXXX,3423.43,,131683.37,AccountTransactionsReport.csv,32,2025-03,False,Other Computer Services,Other Computer Services,Other Computer Services
,2025-03-05,8400/000 : FNB,Stable 249.00 STABLE 4XXXXX*5191 04 MAR XXXXXXXXXXXXXXXXXXX6281 Stable,Account Payment,Stable 249.00 STABLE 4XXXXX*5191 04 MAR XXXXXXXXXXXXXXXXXXX6281 Stable,4759.66,,136443.03,AccountTransactionsReport.csv,33,2025-03,False,Other Computer Services,Other Computer Services,Other Computer Services
,2025-03-05,8400/000 : FNB,920.00 AUTH0.COM 4XX*5191 03 MAR XX3089 920.00 AUTH0.COM 4XXXXX*5191 03 MAR XXXXXXXXXXXXXXXXXXX3089,Account Payment,920.00 AUTH0.COM 4XX*5191 03 MAR XX3089 920.00 AUTH0.COM 4XXXXX*5191 03 MAR XXXXXXXXXXXXXXXXXXX3089,17595.28,,154038.31,AccountTransactionsReport.csv,34,2025-03,False,Security Services,Security Services,Security Services
,2025-03-05,8400/000 : FNB,1499.00 APPDIRECT 4XX*5225 04 MAR XX3188 1499.00 APPDIRECT 4XXXXX*5225 04 MAR XXXXXXXXXXXXXXXXXXX318,Account Payment,1499.00 APPDIRECT 4XX*5225 04 MAR XX3188 1499.00 APPDIRECT 4XXXXX*5225 04 MAR XXXXXXXXXXXXXXXXXXX31,28653.51,,182691.82,AccountTransactionsReport.csv,35,2025-03,False,Other Computer Services,Other Computer Services,Other Computer Services
,2025-03-06,8400/000 : FNB,19.00 CHATBASE 4XX*5191 05 MAR XX2845 19.00 CHATBASE 4XXXXX*5191 05 MAR XXXXXXXXXXXXXXXXXXX2845,Account Payment,19.00 CHATBASE 4XX*5191 05 MAR XX2845 19.00 CHATBASE 4XXXXX*5191 05 MAR XXXXXXXXXXXXXXXXXXX2845,362.06,,183053.88,AccountTransactionsReport.csv,36,2025-03,False,Other Computer Services,Other Computer Services,Other Computer Services
,2025-03-06,8400/000 : FNB,"Github Inc. 19.00 GITHUB, INC. 4XXXXX*5225 04 MAR XXXXXXXXXXXXXXXXXXX7103 Github Inc.",Account Payment,"Github Inc. 19.00 GITHUB, INC. 4XXXXX*5225 04 MAR XXXXXXXXXXXXXXXXXXX7103 Github Inc.",363.19,,183417.07,AccountTransactionsReport.csv,37,2025-03,False,Development Tools,Development Tools,Development Tools
,2025-03-06,8400/000 : FNB,"Github Inc. 54.74 GITHUB, INC. 4XXXXX*5225 04 MAR XXXXXXXXXXXXXXXXXXX1490 Github Inc.",Account Payment,"Github Inc. 54.74 GITHUB, INC. 4XXXXX*5225 04 MAR XXXXXXXXXXXXXXXXXXX1490 Github Inc.",1046.36,,184463.43,AccountTransactionsReport.csv,38,2025-03,False,Development Tools,Development Tools,Development Tools
,2025-03-06,8400/000 : FNB,99.99 JINA.AI 4XX*5191 04 MAR XX3658 99.99 JINA.AI 4XXXXX*5191 04 MAR XXXXXXXXXXXXXXXXXXX3658,Account Payment,99.99 JINA.AI 4XX*5191 04 MAR XX3658 99.99 JINA.AI 4XXXXX*5191 04 MAR XXXXXXXXXXXXXXXXXXX3658,1911.32,,186374.75,AccountTransactionsReport.csv,39,2025-03,False,Other Computer Services,Other Computer Services,Other Computer Services
,2025-03-06,8400/000 : FNB,ManageWP 120.75 MANAGEWP 4XXXXX*5225 05 MAR XXXXXXXXXXXXXXXXXXX7424 ManageWP,Account Payment,ManageWP 120.75 MANAGEWP 4XXXXX*5225 05 MAR XXXXXXXXXXXXXXXXXXX7424 ManageWP,2300.97,,188675.72,AccountTransactionsReport.csv,40,2025-03,False,Other Computer Services,Other Computer Services,Other Computer Services
,2025-03-06,8400/000 : FNB,ManageWP 120.75 MANAGEWP 4XXXXX*5225 05 MAR XXXXXXXXXXXXXXXXXXX1977 ManageWP,Account Payment,ManageWP 120.75 MANAGEWP 4XXXXX*5225 05 MAR XXXXXXXXXXXXXXXXXXX1977 ManageWP,2300.97,,190976.69,AccountTransactionsReport.csv,41,2025-03,False,Other Computer Services,Other Computer Services,Other Computer Services
,2025-03-06,8400/000 : FNB,Sage SAGE ACC 4XXXXX*5225 04 MAR XXXXXXXXXXXXXXXXXXX9975 Sage,Account Payment,Sage SAGE ACC 4XXXXX*5225 04 MAR XXXXXXXXXXXXXXXXXXX9975 Sage,3438.0,,194414.69,AccountTransactionsReport.csv,42,2025-03,False,Other Computer Services,Other Computer Services,Other Computer Services
,2025-03-06,8400/000 : FNB,599.00 TRIPLE WHALE 4XX*5191 04 MAR XX6482 599.00 TRIPLE WHALE 4XXXXX*5191 04 MAR XXXXXXXXXXXXXXXXXX,Account Payment,599.00 TRIPLE WHALE 4XX*5191 04 MAR XX6482 599.00 TRIPLE WHALE 4XXXXX*5191 04 MAR XXXXXXXXXXXXXXXXX,11449.94,,205864.63,AccountTransactionsReport.csv,43,2025-03,False,Other Computer Services,Other Computer Services,Other Computer Services
,2025-03-06,8400/000 : FNB,Shopify 2550.98 SHOPIFY* 33 4XXXXX*5191 04 MAR XXXXXXXXXXXXXXXXXXX7342 Shopify,Account Payment,Shopify 2550.98 SHOPIFY* 33 4XXXXX*5191 04 MAR XXXXXXXXXXXXXXXXXXX7342 Shopify,48762.2,,254626.83,AccountTransactionsReport.csv,44,2025-03,False,E-commerce Platforms,E-commerce Platforms,E-commerce Platforms
,2025-03-07,8400/000 : FNB,9.00 TWENTY.COM 4XX*5191 06 MAR XX0964 9.00 TWENTY.COM 4XXXXX*5191 06 MAR XXXXXXXXXXXXXXXXXXX0964,Account Payment,9.00 TWENTY.COM 4XX*5191 06 MAR XX0964 9.00 TWENTY.COM 4XXXXX*5191 06 MAR XXXXXXXXXXXXXXXXXXX0964,170.4,,254797.23,AccountTransactionsReport.csv,45,2025-03,False,Other Computer Services,Other Computer Services,Other Computer Services
,2025-03-07,8400/000 : FNB,Paddle 187.94 PADDLE.NET* 4XXXXX*5191 05 MAR XXXXXXXXXXXXXXXXXXX9070 Paddle,Account Payment,Paddle 187.94 PADDLE.NET* 4XXXXX*5191 05 MAR XXXXXXXXXXXXXXXXXXX9070 Paddle,187.94,,254985.17,AccountTransactionsReport.csv,46,2025-03,False,Other Computer Services,Subscription Management,Subscription Management
,2025-03-07,8400/000 : FNB,Hightail 15.00 HIGHTAIL 4XXXXX*5191 06 MAR XXXXXXXXXXXXXXXXXXX5594 Hightail,Account Payment,Hightail 15.00 HIGHTAIL 4XXXXX*5191 06 MAR XXXXXXXXXXXXXXXXXXX5594 Hightail,284.0,,255269.17,AccountTransactionsReport.csv,47,2025-03,False,Other Computer Services,Other Computer Services,Other Computer Services
,2025-03-07,8400/000 : FNB,50.00 ANACONDA INC. 4XX*5191 05 MAR XX7414 50.00 ANACONDA INC. 4XXXXX*5191 05 MAR XXXXXXXXXXXXXXXXXX,Account Payment,50.00 ANACONDA INC. 4XX*5191 05 MAR XX7414 50.00 ANACONDA INC. 4XXXXX*5191 05 MAR XXXXXXXXXXXXXXXXX,952.78,,256221.95,AccountTransactionsReport.csv,48,2025-03,False,Other Computer Services,Other Computer Services,Other Computer Services
,2025-03-07,8400/000 : FNB,99.00 CHATBASE 4XX*5191 05 MAR XX4802 99.00 CHATBASE 4XXXXX*5191 05 MAR XXXXXXXXXXXXXXXXXXX4802,Account Payment,99.00 CHATBASE 4XX*5191 05 MAR XX4802 99.00 CHATBASE 4XXXXX*5191 05 MAR XXXXXXXXXXXXXXXXXXX4802,1886.51,,258108.46,AccountTransactionsReport.csv,49,2025-03,False,Other Computer Services,Other Computer Services,Other Computer Services
,2025-03-07,8400/000 : FNB,115.08 OPENAI 4XX*5191 06 MAR XX4643 115.08 OPENAI 4XXXXX*5191 06 MAR XXXXXXXXXXXXXXXXXXX4643,Account Payment,115.08 OPENAI 4XX*5191 06 MAR XX4643 115.08 OPENAI 4XXXXX*5191 06 MAR XXXXXXXXXXXXXXXXXXX4643,2178.84,,260287.3,AccountTransactionsReport.csv,50,2025-03,False,AI Services,AI Services,AI Services
,2025-03-07,8400/000 : FNB,174.00 INTERCOM R&D 4XX*5191 06 MAR XX4593 174.00 INTERCOM R&D 4XXXXX*5191 06 MAR XXXXXXXXXXXXXXXXXX,Account Payment,174.00 INTERCOM R&D 4XX*5191 06 MAR XX4593 174.00 INTERCOM R&D 4XXXXX*5191 06 MAR XXXXXXXXXXXXXXXXX,3294.4,,263581.7,AccountTransactionsReport.csv,51,2025-03,False,Other Computer Services,Customer Support,Customer Support
,2025-03-08,8400/000 : FNB,3.60 GETADDRESS.IO 4XX*5225 07 MAR XX0922 3.60 GETADDRESS.IO 4XXXXX*5225 07 MAR XXXXXXXXXXXXXXXXXXX0,Account Payment,3.60 GETADDRESS.IO 4XX*5225 07 MAR XX0922 3.60 GETADDRESS.IO 4XXXXX*5225 07 MAR XXXXXXXXXXXXXXXXXXX,87.28,,263668.98,AccountTransactionsReport.csv,52,2025-03,False,Other Computer Services,Other Computer Services,Other Computer Services
,2025-03-08,8400/000 : FNB,"7.00 NPM, INC. 4XX*5191 07 MAR XX2762 7.00 NPM, INC. 4XXXXX*5191 07 MAR XXXXXXXXXXXXXXXXXXX2762",Account Payment,"7.00 NPM, INC. 4XX*5191 07 MAR XX2762 7.00 NPM, INC. 4XXXXX*5191 07 MAR XXXXXXXXXXXXXXXXXXX2762",131.31,,263800.29,AccountTransactionsReport.csv,53,2025-03,False,Other Computer Services,Other Computer Services,Other Computer Services
,2025-03-08,8400/000 : FNB,"7.00 NPM, INC. 4XX*5191 07 MAR XX9987 7.00 NPM, INC. 4XXXXX*5191 07 MAR XXXXXXXXXXXXXXXXXXX9987",Account Payment,"7.00 NPM, INC. 4XX*5191 07 MAR XX9987 7.00 NPM, INC. 4XXXXX*5191 07 MAR XXXXXXXXXXXXXXXXXXX9987",131.31,,263931.6,AccountTransactionsReport.csv,54,2025-03,False,Other Computer Services,Other Computer Services,Other Computer Services
,2025-03-08,8400/000 : FNB,"7.00 NPM, INC. 4XX*5191 07 MAR XX4649 7.00 NPM, INC. 4XXXXX*5191 07 MAR XXXXXXXXXXXXXXXXXXX4649",Account Payment,"7.00 NPM, INC. 4XX*5191 07 MAR XX4649 7.00 NPM, INC. 4XXXXX*5191 07 MAR XXXXXXXXXXXXXXXXXXX4649",131.31,,264062.91,AccountTransactionsReport.csv,55,2025-03,False,Other Computer Services,Other Computer Services,Other Computer Services
,2025-03-08,8400/000 : FNB,"7.00 NPM, INC. 4XX*5191 07 MAR XX5500 7.00 NPM, INC. 4XXXXX*5191 07 MAR XXXXXXXXXXXXXXXXXXX5500",Account Payment,"7.00 NPM, INC. 4XX*5191 07 MAR XX5500 7.00 NPM, INC. 4XXXXX*5191 07 MAR XXXXXXXXXXXXXXXXXXX5500",131.31,,264194.22,AccountTransactionsReport.csv,56,2025-03,False,Other Computer Services,Other Computer Services,Other Computer Services
,2025-03-08,8400/000 : FNB,224.99 Google Chara 4XX*5191 06 MAR XX3042 224.99 Google Chara 4XXXXX*5191 06 MAR XXXXXXXXXXXXXXXXXX,Account Payment,224.99 Google Chara 4XX*5191 06 MAR XX3042 224.99 Google Chara 4XXXXX*5191 06 MAR XXXXXXXXXXXXXXXXX,224.99,,264419.21,AccountTransactionsReport.csv,57,2025-03,False,Other Computer Services,Analytics & Monitoring,Analytics & Monitoring
,2025-03-08,8400/000 : FNB,Woocommerce 19.99 WOOCOMMERCE S 4XXXXX*5225 06 MAR XXXXXXXXXXXXXXXXXXX5333 Woocommerce,Account Payment,Woocommerce 19.99 WOOCOMMERCE S 4XXXXX*5225 06 MAR XXXXXXXXXXXXXXXXXXX5333 Woocommerce,378.48,,264797.69,AccountTransactionsReport.csv,58,2025-03,False,Other Computer Services,Other Computer Services,Other Computer Services
,2025-03-08,8400/000 : FNB,72.00 TERMIUS CORPO 4XX*5191 06 MAR XX6444 72.00 TERMIUS CORPO 4XXXXX*5191 06 MAR XXXXXXXXXXXXXXXXXX,Account Payment,72.00 TERMIUS CORPO 4XX*5191 06 MAR XX6444 72.00 TERMIUS CORPO 4XXXXX*5191 06 MAR XXXXXXXXXXXXXXXXX,1363.2,,266160.89,AccountTransactionsReport.csv,59,2025-03,False,Other Computer Services,Other Computer Services,Other Computer Services
,2025-03-10,8400/000 : FNB,12.00 CODESANDBOX 4XX*5191 07 MAR XX4426 12.00 CODESANDBOX 4XXXXX*5191 07 MAR XXXXXXXXXXXXXXXXXXX442,Account Payment,12.00 CODESANDBOX 4XX*5191 07 MAR XX4426 12.00 CODESANDBOX 4XXXXX*5191 07 MAR XXXXXXXXXXXXXXXXXXX44,225.1,,266385.99,AccountTransactionsReport.csv,60,2025-03,False,Other Computer Services,Other Computer Services,Other Computer Services
,2025-03-10,8400/000 : FNB,Intuit 570.40 INTUIT *QBoo 4XXXXX*5225 07 MAR XXXXXXXXXXXXXXXXXXX8537 Intuit,Account Payment,Intuit 570.40 INTUIT *QBoo 4XXXXX*5225 07 MAR XXXXXXXXXXXXXXXXXXX8537 Intuit,570.4,,266956.39,AccountTransactionsReport.csv,61,2025-03,False,Productivity Software,Productivity Software,Productivity Software
,2025-03-10,8400/000 : FNB,99.00 MIOSALON.COM( 4XX*5225 07 MAR XX2296 99.00 MIOSALON.COM( 4XXXXX*5225 07 MAR XXXXXXXXXXXXXXXXXX,Account Payment,99.00 MIOSALON.COM( 4XX*5225 07 MAR XX2296 99.00 MIOSALON.COM( 4XXXXX*5225 07 MAR XXXXXXXXXXXXXXXXX,1857.1,,268813.49,AccountTransactionsReport.csv,62,2025-03,False,Other Computer Services,Other Computer Services,Other Computer Services
,2025-03-10,8400/000 : FNB,99.00 MIOSALON.COM( 4XX*5225 07 MAR XX0163 99.00 MIOSALON.COM( 4XXXXX*5225 07 MAR XXXXXXXXXXXXXXXXXX,Account Payment,99.00 MIOSALON.COM( 4XX*5225 07 MAR XX0163 99.00 MIOSALON.COM( 4XXXXX*5225 07 MAR XXXXXXXXXXXXXXXXX,1857.1,,270670.59,AccountTransactionsReport.csv,63,2025-03,False,Other Computer Services,Other Computer Services,Other Computer Services
,2025-03-10,8400/000 : FNB,"105.00 NOTION LABS, 4XX*5191 07 MAR XX5876 105.00 NOTION LABS, 4XXXXX*5191 07 MAR XXXXXXXXXXXXXXXXXX",Account Payment,"105.00 NOTION LABS, 4XX*5191 07 MAR XX5876 105.00 NOTION LABS, 4XXXXX*5191 07 MAR XXXXXXXXXXXXXXXXX",1969.65,,272640.24,AccountTransactionsReport.csv,64,2025-03,False,Other Computer Services,Collaboration Tools,Collaboration Tools
,2025-03-10,8400/000 : FNB,Paddle 171.35 PADDLE.NET* 4XXXXX*5191 08 MAR XXXXXXXXXXXXXXXXXXX9314 Paddle,Account Payment,Paddle 171.35 PADDLE.NET* 4XXXXX*5191 08 MAR XXXXXXXXXXXXXXXXXXX9314 Paddle,3206.61,,275846.85,AccountTransactionsReport.csv,65,2025-03,False,Other Computer Services,Subscription Management,Subscription Management
,2025-03-11,8400/000 : FNB,Google Store 34.99 Google One 4XXXXX*5191 07 MAR XXXXXXXXXXXXXXXXXXX2023 Google Store,Account Payment,Google Store 34.99 Google One 4XXXXX*5191 07 MAR XXXXXXXXXXXXXXXXXXX2023 Google Store,34.99,,275881.84,AccountTransactionsReport.csv,66,2025-03,False,Other Computer Services,Analytics & Monitoring,Analytics & Monitoring
,2025-03-11,8400/000 : FNB,7.00 CHATBASE 4XX*5191 10 MAR XX1702 7.00 CHATBASE 4XXXXX*5191 10 MAR XXXXXXXXXXXXXXXXXXX1702,Account Payment,7.00 CHATBASE 4XX*5191 10 MAR XX1702 7.00 CHATBASE 4XXXXX*5191 10 MAR XXXXXXXXXXXXXXXXXXX1702,131.0,,276012.84,AccountTransactionsReport.csv,67,2025-03,False,Other Computer Services,Other Computer Services,Other Computer Services
,2025-03-11,8400/000 : FNB,"10.00 REPLIT, INC. 4XX*5191 10 MAR XX9715 10.00 REPLIT, INC. 4XXXXX*5191 10 MAR XXXXXXXXXXXXXXXXXXX9",Account Payment,"10.00 REPLIT, INC. 4XX*5191 10 MAR XX9715 10.00 REPLIT, INC. 4XXXXX*5191 10 MAR XXXXXXXXXXXXXXXXXXX",187.14,,276199.98,AccountTransactionsReport.csv,68,2025-03,False,Other Computer Services,Other Computer Services,Other Computer Services
,2025-03-11,8400/000 : FNB,20.00 VERCEL INC. 4XX*5191 09 MAR XX9112 20.00 VERCEL INC. 4XXXXX*5191 09 MAR XXXXXXXXXXXXXXXXXXX911,Account Payment,20.00 VERCEL INC. 4XX*5191 09 MAR XX9112 20.00 VERCEL INC. 4XXXXX*5191 09 MAR XXXXXXXXXXXXXXXXXXX91,374.28,,276574.26,AccountTransactionsReport.csv,69,2025-03,False,Cloud Services,Cloud Services,Cloud Services
,2025-03-11,8400/000 : FNB,20.00 VERCEL INC. 4XX*5225 08 MAR XX4526 20.00 VERCEL INC. 4XXXXX*5225 08 MAR XXXXXXXXXXXXXXXXXXX452,Account Payment,20.00 VERCEL INC. 4XX*5225 08 MAR XX4526 20.00 VERCEL INC. 4XXXXX*5225 08 MAR XXXXXXXXXXXXXXXXXXX45,374.28,,276948.54,AccountTransactionsReport.csv,70,2025-03,False,Cloud Services,Cloud Services,Cloud Services
,2025-03-11,8400/000 : FNB,21.56 SLACK T0740DV 4XX*5191 10 MAR XX2797 21.56 SLACK T0740DV 4XXXXX*5191 10 MAR XXXXXXXXXXXXXXXXXX,Account Payment,21.56 SLACK T0740DV 4XX*5191 10 MAR XX2797 21.56 SLACK T0740DV 4XXXXX*5191 10 MAR XXXXXXXXXXXXXXXXX,403.47,,277352.01,AccountTransactionsReport.csv,71,2025-03,False,Communication,Communication,Communication
,2025-03-11,8400/000 : FNB,Google Play 434.99 Google Perpl 4XXXXX*5191 08 MAR XXXXXXXXXXXXXXXXXXX7043 Google Play,Account Payment,Google Play 434.99 Google Perpl 4XXXXX*5191 08 MAR XXXXXXXXXXXXXXXXXXX7043 Google Play,434.99,,277787.0,AccountTransactionsReport.csv,72,2025-03,False,Other Computer Services,Analytics & Monitoring,Analytics & Monitoring
,2025-03-11,8400/000 : FNB,25.00 BEECEPTOR 4XX*5191 09 MAR XX0094 25.00 BEECEPTOR 4XXXXX*5191 09 MAR XXXXXXXXXXXXXXXXXXX0094,Account Payment,25.00 BEECEPTOR 4XX*5191 09 MAR XX0094 25.00 BEECEPTOR 4XXXXX*5191 09 MAR XXXXXXXXXXXXXXXXXXX0094,467.84,,278254.84,AccountTransactionsReport.csv,73,2025-03,False,Other Computer Services,Other Computer Services,Other Computer Services
,2025-03-11,8400/000 : FNB,25.00 BEECEPTOR 4XX*5191 09 MAR XX0054 25.00 BEECEPTOR 4XXXXX*5191 09 MAR XXXXXXXXXXXXXXXXXXX0054,Account Payment,25.00 BEECEPTOR 4XX*5191 09 MAR XX0054 25.00 BEECEPTOR 4XXXXX*5191 09 MAR XXXXXXXXXXXXXXXXXXX0054,467.84,,278722.68,AccountTransactionsReport.csv,74,2025-03,False,Other Computer Services,Other Computer Services,Other Computer Services
,2025-03-11,8400/000 : FNB,"25.00 NOTION LABS, 4XX*5191 08 MAR XX7381 25.00 NOTION LABS, 4XXXXX*5191 08 MAR XXXXXXXXXXXXXXXXXXX7",Account Payment,"25.00 NOTION LABS, 4XX*5191 08 MAR XX7381 25.00 NOTION LABS, 4XXXXX*5191 08 MAR XXXXXXXXXXXXXXXXXXX",467.84,,279190.52,AccountTransactionsReport.csv,75,2025-03,False,Other Computer Services,Collaboration Tools,Collaboration Tools
,2025-03-11,8400/000 : FNB,30.00 ISHRAQ LLC 4XX*5191 09 MAR XX3096 30.00 ISHRAQ LLC 4XXXXX*5191 09 MAR XXXXXXXXXXXXXXXXXXX3096,Account Payment,30.00 ISHRAQ LLC 4XX*5191 09 MAR XX3096 30.00 ISHRAQ LLC 4XXXXX*5191 09 MAR XXXXXXXXXXXXXXXXXXX3096,561.42,,279751.94,AccountTransactionsReport.csv,76,2025-03,False,Other Computer Services,Other Computer Services,Other Computer Services
,2025-03-11,8400/000 : FNB,Intuit 570.40 INTUIT *QBoo 4XXXXX*5225 09 MAR XXXXXXXXXXXXXXXXXXX7617 Intuit,Account Payment,Intuit 570.40 INTUIT *QBoo 4XXXXX*5225 09 MAR XXXXXXXXXXXXXXXXXXX7617 Intuit,570.4,,280322.34,AccountTransactionsReport.csv,77,2025-03,False,Productivity Software,Productivity Software,Productivity Software
,2025-03-11,8400/000 : FNB,"40.00 REPLIT, INC. 4XX*5191 09 MAR XX3571 40.00 REPLIT, INC. 4XXXXX*5191 09 MAR XXXXXXXXXXXXXXXXXXX3",Account Payment,"40.00 REPLIT, INC. 4XX*5191 09 MAR XX3571 40.00 REPLIT, INC. 4XXXXX*5191 09 MAR XXXXXXXXXXXXXXXXXXX",748.55,,281070.89,AccountTransactionsReport.csv,78,2025-03,False,Other Computer Services,Other Computer Services,Other Computer Services
,2025-03-11,8400/000 : FNB,40.00 VERCEL INC. 4XX*5225 08 MAR XX3613 40.00 VERCEL INC. 4XXXXX*5225 08 MAR XXXXXXXXXXXXXXXXXXX361,Account Payment,40.00 VERCEL INC. 4XX*5225 08 MAR XX3613 40.00 VERCEL INC. 4XXXXX*5225 08 MAR XXXXXXXXXXXXXXXXXXX36,748.55,,281819.44,AccountTransactionsReport.csv,79,2025-03,False,Cloud Services,Cloud Services,Cloud Services
,2025-03-11,8400/000 : FNB,49.00 SKRAPP.IO STA 4XX*5191 09 MAR XX6590 49.00 SKRAPP.IO STA 4XXXXX*5191 09 MAR XXXXXXXXXXXXXXXXXX,Account Payment,49.00 SKRAPP.IO STA 4XX*5191 09 MAR XX6590 49.00 SKRAPP.IO STA 4XXXXX*5191 09 MAR XXXXXXXXXXXXXXXXX,916.98,,282736.42,AccountTransactionsReport.csv,80,2025-03,False,Other Computer Services,Other Computer Services,Other Computer Services
,2025-03-11,8400/000 : FNB,69.00 OPENAI *CHATG 4XX*5191 09 MAR XX3181 69.00 OPENAI *CHATG 4XXXXX*5191 09 MAR XXXXXXXXXXXXXXXXXX,Account Payment,69.00 OPENAI *CHATG 4XX*5191 09 MAR XX3181 69.00 OPENAI *CHATG 4XXXXX*5191 09 MAR XXXXXXXXXXXXXXXXX,1291.25,,284027.67,AccountTransactionsReport.csv,81,2025-03,False,AI Services,AI Services,AI Services
,2025-03-11,8400/000 : FNB,"70.00 NOTION LABS, 4XX*5191 10 MAR XX6201 70.00 NOTION LABS, 4XXXXX*5191 10 MAR XXXXXXXXXXXXXXXXXXX6",Account Payment,"70.00 NOTION LABS, 4XX*5191 10 MAR XX6201 70.00 NOTION LABS, 4XXXXX*5191 10 MAR XXXXXXXXXXXXXXXXXXX",1309.97,,285337.64,AccountTransactionsReport.csv,82,2025-03,False,Other Computer Services,Collaboration Tools,Collaboration Tools
,2025-03-11,8400/000 : FNB,"Github Inc. 91.00 GITHUB, INC. 4XXXXX*5191 08 MAR XXXXXXXXXXXXXXXXXXX4888 Github Inc.",Account Payment,"Github Inc. 91.00 GITHUB, INC. 4XXXXX*5191 08 MAR XXXXXXXXXXXXXXXXXXX4888 Github Inc.",1702.96,,287040.6,AccountTransactionsReport.csv,83,2025-03,False,Development Tools,Development Tools,Development Tools
,2025-03-11,8400/000 : FNB,150.00 AUTH0.COM 4XX*5191 08 MAR XX9532 150.00 AUTH0.COM 4XXXXX*5191 08 MAR XXXXXXXXXXXXXXXXXXX9532,Account Payment,150.00 AUTH0.COM 4XX*5191 08 MAR XX9532 150.00 AUTH0.COM 4XXXXX*5191 08 MAR XXXXXXXXXXXXXXXXXXX9532,2807.07,,289847.67,AccountTransactionsReport.csv,84,2025-03,False,Security Services,Security Services,Security Services
,2025-03-11,8400/000 : FNB,499.00 CASSIDYAI.CO 4XX*5191 09 MAR XX6861 499.00 CASSIDYAI.CO 4XXXXX*5191 09 MAR XXXXXXXXXXXXXXXXXX,Account Payment,499.00 CASSIDYAI.CO 4XX*5191 09 MAR XX6861 499.00 CASSIDYAI.CO 4XXXXX*5191 09 MAR XXXXXXXXXXXXXXXXX,9338.19,,299185.86,AccountTransactionsReport.csv,85,2025-03,False,Other Computer Services,Other Computer Services,Other Computer Services
,2025-03-12,8400/000 : FNB,32.00 BUBBLE STARTE 4XX*5191 11 MAR XX7091 32.00 BUBBLE STARTE 4XXXXX*5191 11 MAR XXXXXXXXXXXXXXXXXX,Account Payment,32.00 BUBBLE STARTE 4XX*5191 11 MAR XX7091 32.00 BUBBLE STARTE 4XXXXX*5191 11 MAR XXXXXXXXXXXXXXXXX,600.59,,299786.45,AccountTransactionsReport.csv,86,2025-03,False,Other Computer Services,Other Computer Services,Other Computer Services
,2025-03-12,8400/000 : FNB,Shopify 3633.95 SHOPIFY* 33 4XXXXX*5225 10 MAR XXXXXXXXXXXXXXXXXXX5039 Shopify,Account Payment,Shopify 3633.95 SHOPIFY* 33 4XXXXX*5225 10 MAR XXXXXXXXXXXXXXXXXXX5039 Shopify,68005.05,,367791.5,AccountTransactionsReport.csv,87,2025-03,False,E-commerce Platforms,E-commerce Platforms,E-commerce Platforms
,2025-03-12,8400/000 : FNB,99.00 DYNAMIC.XYZ 4XX*5191 11 MAR XX0875 99.00 DYNAMIC.XYZ 4XXXXX*5191 11 MAR XXXXXXXXXXXXXXXXXXX087,Account Payment,99.00 DYNAMIC.XYZ 4XX*5191 11 MAR XX0875 99.00 DYNAMIC.XYZ 4XXXXX*5191 11 MAR XXXXXXXXXXXXXXXXXXX08,1858.06,,369649.56,AccountTransactionsReport.csv,88,2025-03,False,Other Computer Services,Other Computer Services,Other Computer Services
,2025-03-13,8400/000 : FNB,Intuit 570.40 INTUIT *QBoo 4XXXXX*5225 11 MAR XXXXXXXXXXXXXXXXXXX8146 Intuit,Account Payment,Intuit 570.40 INTUIT *QBoo 4XXXXX*5225 11 MAR XXXXXXXXXXXXXXXXXXX8146 Intuit,570.4,,370219.96,AccountTransactionsReport.csv,89,2025-03,False,Productivity Software,Productivity Software,Productivity Software
,2025-03-13,8400/000 : FNB,Intuit 570.40 INTUIT *QBoo 4XXXXX*5225 11 MAR XXXXXXXXXXXXXXXXXXX8112 Intuit,Account Payment,Intuit 570.40 INTUIT *QBoo 4XXXXX*5225 11 MAR XXXXXXXXXXXXXXXXXXX8112 Intuit,570.4,,370790.36,AccountTransactionsReport.csv,90,2025-03,False,Productivity Software,Productivity Software,Productivity Software
,2025-03-13,8400/000 : FNB,"Github Inc. 42.00 GITHUB, INC. 4XXXXX*5191 11 MAR XXXXXXXXXXXXXXXXXXX9230 Github Inc.",Account Payment,"Github Inc. 42.00 GITHUB, INC. 4XXXXX*5191 11 MAR XXXXXXXXXXXXXXXXXXX9230 Github Inc.",788.27,,371578.63,AccountTransactionsReport.csv,91,2025-03,False,Development Tools,Development Tools,Development Tools
,2025-03-13,8400/000 : FNB,"Github Inc. 65.85 GITHUB, INC. 4XXXXX*5191 11 MAR XXXXXXXXXXXXXXXXXXX1385 Github Inc.",Account Payment,"Github Inc. 65.85 GITHUB, INC. 4XXXXX*5191 11 MAR XXXXXXXXXXXXXXXXXXX1385 Github Inc.",1235.89,,372814.52,AccountTransactionsReport.csv,92,2025-03,False,Development Tools,Development Tools,Development Tools
,2025-03-13,8400/000 : FNB,Shopify 74.75 SHOPIFY* 3401 4XXXXX*5225 11 MAR XXXXXXXXXXXXXXXXXXX9481 Shopify,Account Payment,Shopify 74.75 SHOPIFY* 3401 4XXXXX*5225 11 MAR XXXXXXXXXXXXXXXXXXX9481 Shopify,1402.93,,374217.45,AccountTransactionsReport.csv,93,2025-03,False,E-commerce Platforms,E-commerce Platforms,E-commerce Platforms
,2025-03-13,8400/000 : FNB,"Github Inc. 210.00 GITHUB, INC. 4XXXXX*5225 11 MAR XXXXXXXXXXXXXXXXXXX8335 Github Inc.",Account Payment,"Github Inc. 210.00 GITHUB, INC. 4XXXXX*5225 11 MAR XXXXXXXXXXXXXXXXXXX8335 Github Inc.",3941.34,,378158.79,AccountTransactionsReport.csv,94,2025-03,False,Development Tools,Development Tools,Development Tools
,2025-03-14,8400/000 : FNB,15.00 TABNINE 4XX*5191 12 MAR XX1486 15.00 TABNINE 4XXXXX*5191 12 MAR XXXXXXXXXXXXXXXXXXX1486,Account Payment,15.00 TABNINE 4XX*5191 12 MAR XX1486 15.00 TABNINE 4XXXXX*5191 12 MAR XXXXXXXXXXXXXXXXXXX1486,281.74,,378440.53,AccountTransactionsReport.csv,95,2025-03,False,Other Computer Services,Other Computer Services,Other Computer Services
,2025-03-15,8400/000 : FNB,180.00 AGENCYANALYT 4XX*5225 13 MAR XX2929 180.00 AGENCYANALYT 4XXXXX*5225 13 MAR XXXXXXXXXXXXXXXXXX,Account Payment,180.00 AGENCYANALYT 4XX*5225 13 MAR XX2929 180.00 AGENCYANALYT 4XXXXX*5225 13 MAR XXXXXXXXXXXXXXXXX,3391.46,,381831.99,AccountTransactionsReport.csv,96,2025-03,False,Other Computer Services,Other Computer Services,Other Computer Services
,2025-03-15,8400/000 : FNB,11.49 GOOGLE *Colab 4XX*5191 14 MAR XX8368 11.49 GOOGLE *Colab 4XXXXX*5191 14 MAR XXXXXXXXXXXXXXXXXX,Account Payment,11.49 GOOGLE *Colab 4XX*5191 14 MAR XX8368 11.49 GOOGLE *Colab 4XXXXX*5191 14 MAR XXXXXXXXXXXXXXXXX,216.29,,382048.28,AccountTransactionsReport.csv,97,2025-03,False,Other Computer Services,Analytics & Monitoring,Analytics & Monitoring
,2025-03-15,8400/000 : FNB,27.55 RAILWAY 4XX*5191 13 MAR XX4684 27.55 RAILWAY 4XXXXX*5191 13 MAR XXXXXXXXXXXXXXXXXXX4684,Account Payment,27.55 RAILWAY 4XX*5191 13 MAR XX4684 27.55 RAILWAY 4XXXXX*5191 13 MAR XXXXXXXXXXXXXXXXXXX4684,519.08,,382567.36,AccountTransactionsReport.csv,98,2025-03,False,Other Computer Services,Other Computer Services,Other Computer Services
,2025-03-15,8400/000 : FNB,5.00 WWW.FLUX.AI 4XX*5191 13 MAR XX5103 5.00 WWW.FLUX.AI 4XXXXX*5191 13 MAR XXXXXXXXXXXXXXXXXXX5103,Account Payment,5.00 WWW.FLUX.AI 4XX*5191 13 MAR XX5103 5.00 WWW.FLUX.AI 4XXXXX*5191 13 MAR XXXXXXXXXXXXXXXXXXX5103,94.21,,382661.57,AccountTransactionsReport.csv,99,2025-03,False,Other Computer Services,Other Computer Services,Other Computer Services
,2025-03-15,8400/000 : FNB,113.85 DNH*GODADDY# 4XX*5191 12 MAR XX7948 113.85 DNH*GODADDY# 4XXXXX*5191 12 MAR XXXXXXXXXXXXXXXXXX,Account Payment,113.85 DNH*GODADDY 4XX*5191 12 MAR XX7948 113.85 DNH*GODADDY 4XXXXX*5191 12 MAR XXXXXXXXXXXXXXXXX,113.85,,382775.42,AccountTransactionsReport.csv,100,2025-03,False,Domain & Hosting,Domain & Hosting,Domain & Hosting
,2025-03-17,8400/000 : FNB,1.00 VERCEL INC. 4XXXXX*5225 13 MAR XXXXXXXXXXXXXXXXXXX7346 1.00 VERCEL INC. 4XXXXX*5225 13 MAR XXXX,Account Receipt,1.00 VERCEL INC. 4XXXXX*5225 13 MAR XXXXXXXXXXXXXXXXXXX7346 1.00 VERCEL INC. 4XXXXX*5225 13 MAR XXX,,17.76,382757.66,AccountTransactionsReport.csv,101,2025-03,False,Cloud Services,Cloud Services,Cloud Services
,2025-03-17,8400/000 : FNB,"Github Inc. 14.00 GITHUB, INC. 4XXXXX*5225 14 MAR XXXXXXXXXXXXXXXXXXX8781 Github Inc.",Account Payment,"Github Inc. 14.00 GITHUB, INC. 4XXXXX*5225 14 MAR XXXXXXXXXXXXXXXXXXX8781 Github Inc.",263.54,,383021.2,AccountTransactionsReport.csv,102,2025-03,False,Development Tools,Development Tools,Development Tools
,2025-03-17,8400/000 : FNB,Intuit 570.40 INTUIT *QBoo 4XXXXX*5225 14 MAR XXXXXXXXXXXXXXXXXXX8698 Intuit,Account Payment,Intuit 570.40 INTUIT *QBoo 4XXXXX*5225 14 MAR XXXXXXXXXXXXXXXXXXX8698 Intuit,570.4,,383591.6,AccountTransactionsReport.csv,103,2025-03,False,Productivity Software,Productivity Software,Productivity Software
,2025-03-17,8400/000 : FNB,"41.86 REPLIT, INC. 4XX*5191 14 MAR XX2877 41.86 REPLIT, INC. 4XXXXX*5191 14 MAR XXXXXXXXXXXXXXXXXXX2",Account Payment,"41.86 REPLIT, INC. 4XX*5191 14 MAR XX2877 41.86 REPLIT, INC. 4XXXXX*5191 14 MAR XXXXXXXXXXXXXXXXXXX",787.97,,384379.57,AccountTransactionsReport.csv,104,2025-03,False,Other Computer Services,Other Computer Services,Other Computer Services
,2025-03-17,8400/000 : FNB,55.52 RAILWAY 4XX*5191 14 MAR XX1139 55.52 RAILWAY 4XXXXX*5191 14 MAR XXXXXXXXXXXXXXXXXXX1139,Account Payment,55.52 RAILWAY 4XX*5191 14 MAR XX1139 55.52 RAILWAY 4XXXXX*5191 14 MAR XXXXXXXXXXXXXXXXXXX1139,1045.1,,385424.67,AccountTransactionsReport.csv,105,2025-03,False,Other Computer Services,Other Computer Services,Other Computer Services
,2025-03-17,8400/000 : FNB,172.50 OPENAI *CHAT 4XX*5191 14 MAR XX7850 172.50 OPENAI *CHAT 4XXXXX*5191 14 MAR XXXXXXXXXXXXXXXXXX,Account Payment,172.50 OPENAI *CHAT 4XX*5191 14 MAR XX7850 172.50 OPENAI *CHAT 4XXXXX*5191 14 MAR XXXXXXXXXXXXXXXXX,3247.12,,388671.79,AccountTransactionsReport.csv,106,2025-03,False,AI Services,AI Services,AI Services
,2025-03-18,8400/000 : FNB,227.70 DNH*GODADDY# 4XX*5191 14 MAR XX9865 227.70 DNH*GODADDY# 4XXXXX*5191 14 MAR XXXXXXXXXXXXXXXXXX,Account Payment,227.70 DNH*GODADDY 4XX*5191 14 MAR XX9865 227.70 DNH*GODADDY 4XXXXX*5191 14 MAR XXXXXXXXXXXXXXXXX,227.7,,388899.49,AccountTransactionsReport.csv,107,2025-03,False,Domain & Hosting,Domain & Hosting,Domain & Hosting
,2025-03-18,8400/000 : FNB,139.24 SLACK T0MN3D 4XX*5225 15 MAR XX6829 139.24 SLACK T0MN3D 4XXXXX*5225 15 MAR XXXXXXXXXXXXXXXXXX,Account Payment,139.24 SLACK T0MN3D 4XX*5225 15 MAR XX6829 139.24 SLACK T0MN3D 4XXXXX*5225 15 MAR XXXXXXXXXXXXXXXXX,2610.88,,391510.37,AccountTransactionsReport.csv,108,2025-03,False,Communication,Communication,Communication
,2025-03-18,8400/000 : FNB,231.95 HOLASPIRIT 4XX*5225 15 MAR XX5392 231.95 HOLASPIRIT 4XXXXX*5225 15 MAR XXXXXXXXXXXXXXXXXXX539,Account Payment,231.95 HOLASPIRIT 4XX*5225 15 MAR XX5392 231.95 HOLASPIRIT 4XXXXX*5225 15 MAR XXXXXXXXXXXXXXXXXXX53,4710.77,,396221.14,AccountTransactionsReport.csv,109,2025-03,False,Other Computer Services,Other Computer Services,Other Computer Services
,2025-03-18,8400/000 : FNB,280.00 WIZA.CO 4XX*5191 14 MAR XX1430 280.00 WIZA.CO 4XXXXX*5191 14 MAR XXXXXXXXXXXXXXXXXXX1430,Account Payment,280.00 WIZA.CO 4XX*5191 14 MAR XX1430 280.00 WIZA.CO 4XXXXX*5191 14 MAR XXXXXXXXXXXXXXXXXXX1430,5270.69,,401491.83,AccountTransactionsReport.csv,110,2025-03,False,Other Computer Services,Other Computer Services,Other Computer Services
,2025-03-18,8400/000 : FNB,376.40 HOLASPIRIT 4XX*5225 15 MAR XX4648 376.40 HOLASPIRIT 4XXXXX*5225 15 MAR XXXXXXXXXXXXXXXXXXX464,Account Payment,376.40 HOLASPIRIT 4XX*5225 15 MAR XX4648 376.40 HOLASPIRIT 4XXXXX*5225 15 MAR XXXXXXXXXXXXXXXXXXX46,7644.46,,409136.29,AccountTransactionsReport.csv,111,2025-03,False,Other Computer Services,Other Computer Services,Other Computer Services
,2025-03-19,8400/000 : FNB,"10.08 REPLIT, INC. 4XX*5191 17 MAR XX2665 10.08 REPLIT, INC. 4XXXXX*5191 17 MAR XXXXXXXXXXXXXXXXXXX2",Account Payment,"10.08 REPLIT, INC. 4XX*5191 17 MAR XX2665 10.08 REPLIT, INC. 4XXXXX*5191 17 MAR XXXXXXXXXXXXXXXXXXX",189.01,,409325.3,AccountTransactionsReport.csv,112,2025-03,False,Other Computer Services,Other Computer Services,Other Computer Services
,2025-03-19,8400/000 : FNB,20.00 HUGGINGFACE 4XX*5191 18 MAR XX4194 20.00 HUGGINGFACE 4XXXXX*5191 18 MAR XXXXXXXXXXXXXXXXXXX419,Account Payment,20.00 HUGGINGFACE 4XX*5191 18 MAR XX4194 20.00 HUGGINGFACE 4XXXXX*5191 18 MAR XXXXXXXXXXXXXXXXXXX41,372.77,,409698.07,AccountTransactionsReport.csv,113,2025-03,False,AI Services,AI Services,AI Services
,2025-03-19,8400/000 : FNB,50.16 LINODE . AKAM 4XX*5191 18 MAR XX6276 50.16 LINODE . AKAM 4XXXXX*5191 18 MAR XXXXXXXXXXXXXXXXXX,Account Payment,50.16 LINODE . AKAM 4XX*5191 18 MAR XX6276 50.16 LINODE . AKAM 4XXXXX*5191 18 MAR XXXXXXXXXXXXXXXXX,934.91,,410632.98,AccountTransactionsReport.csv,114,2025-03,False,Cloud Services,Cloud Services,Cloud Services
,2025-03-19,8400/000 : FNB,Google Service Charges/Fees #INT PYMT FEE-434.99 Goog Google,Account Payment,Google Service Charges/Fees INT PYMT FEE-434.99 Goog Google,8.7,,410641.68,AccountTransactionsReport.csv,115,2025-03,False,Other Computer Services,Analytics & Monitoring,Analytics & Monitoring
,2025-03-19,8400/000 : FNB,Google Service Charges/Fees #INT PYMT FEE-34.99 Googl Google,Account Payment,Google Service Charges/Fees INT PYMT FEE-34.99 Googl Google,0.7,,410642.38,AccountTransactionsReport.csv,116,2025-03,False,Other Computer Services,Analytics & Monitoring,Analytics & Monitoring
,2025-03-20,8400/000 : FNB,"4.98 REPLIT, INC. 4XX*5191 19 MAR XX3377 4.98 REPLIT, INC. 4XXXXX*5191 19 MAR XXXXXXXXXXXXXXXXXXX337",Account Payment,"4.98 REPLIT, INC. 4XX*5191 19 MAR XX3377 4.98 REPLIT, INC. 4XXXXX*5191 19 MAR XXXXXXXXXXXXXXXXXXX33",92.36,,410734.74,AccountTransactionsReport.csv,117,2025-03,False,Other Computer Services,Other Computer Services,Other Computer Services
,2025-03-20,8400/000 : FNB,350.00 FRAMER.COM 4XX*5191 18 MAR XX0754 350.00 FRAMER.COM 4XXXXX*5191 18 MAR XXXXXXXXXXXXXXXXXXX075,Account Payment,350.00 FRAMER.COM 4XX*5191 18 MAR XX0754 350.00 FRAMER.COM 4XXXXX*5191 18 MAR XXXXXXXXXXXXXXXXXXX07,350.0,,411084.74,AccountTransactionsReport.csv,118,2025-03,False,Other Computer Services,Design Tools,Design Tools
,2025-03-20,8400/000 : FNB,20.00 VERCEL INC. 4XX*5191 18 MAR XX3704 20.00 VERCEL INC. 4XXXXX*5191 18 MAR XXXXXXXXXXXXXXXXXXX370,Account Payment,20.00 VERCEL INC. 4XX*5191 18 MAR XX3704 20.00 VERCEL INC. 4XXXXX*5191 18 MAR XXXXXXXXXXXXXXXXXXX37,372.77,,411457.51,AccountTransactionsReport.csv,119,2025-03,False,Cloud Services,Cloud Services,Cloud Services
,2025-03-22,8400/000 : FNB,"9.90 REPLIT, INC. 4XX*5191 20 MAR XX5597 9.90 REPLIT, INC. 4XXXXX*5191 20 MAR XXXXXXXXXXXXXXXXXXX559",Account Payment,"9.90 REPLIT, INC. 4XX*5191 20 MAR XX5597 9.90 REPLIT, INC. 4XXXXX*5191 20 MAR XXXXXXXXXXXXXXXXXXX55",184.76,,411642.27,AccountTransactionsReport.csv,120,2025-03,False,Other Computer Services,Other Computer Services,Other Computer Services
,2025-03-22,8400/000 : FNB,"10.03 REPLIT, INC. 4XX*5191 19 MAR XX0791 10.03 REPLIT, INC. 4XXXXX*5191 19 MAR XXXXXXXXXXXXXXXXXXX0",Account Payment,"10.03 REPLIT, INC. 4XX*5191 19 MAR XX0791 10.03 REPLIT, INC. 4XXXXX*5191 19 MAR XXXXXXXXXXXXXXXXXXX",186.02,,411828.29,AccountTransactionsReport.csv,121,2025-03,False,Other Computer Services,Other Computer Services,Other Computer Services
,2025-03-22,8400/000 : FNB,54.00 AIRTABLE.COM/ 4XX*5191 21 MAR XX5485 54.00 AIRTABLE.COM/ 4XXXXX*5191 21 MAR XXXXXXXXXXXXXXXXXX,Account Payment,54.00 AIRTABLE.COM/ 4XX*5191 21 MAR XX5485 54.00 AIRTABLE.COM/ 4XXXXX*5191 21 MAR XXXXXXXXXXXXXXXXX,1006.08,,412834.37,AccountTransactionsReport.csv,122,2025-03,False,Other Computer Services,Collaboration Tools,Collaboration Tools
,2025-03-22,8400/000 : FNB,59.00 GREENBACK.COM 4XX*5225 19 MAR XX7950 59.00 GREENBACK.COM 4XXXXX*5225 19 MAR XXXXXXXXXXXXXXXXXX,Account Payment,59.00 GREENBACK.COM 4XX*5225 19 MAR XX7950 59.00 GREENBACK.COM 4XXXXX*5225 19 MAR XXXXXXXXXXXXXXXXX,1094.19,,413928.56,AccountTransactionsReport.csv,123,2025-03,False,Other Computer Services,Other Computer Services,Other Computer Services
,2025-03-22,8400/000 : FNB,1265.00 FACEBK *WPX 4XX*5191 20 MAR XX7070 1265.00 FACEBK *WPX 4XXXXX*5191 20 MAR XXXXXXXXXXXXXXXXXX,Account Payment,1265.00 FACEBK *WPX 4XX*5191 20 MAR XX7070 1265.00 FACEBK *WPX 4XXXXX*5191 20 MAR XXXXXXXXXXXXXXXXX,1265.0,,415193.56,AccountTransactionsReport.csv,124,2025-03,False,Other Computer Services,Other Computer Services,Other Computer Services
,2025-03-22,8400/000 : FNB,"74.00 PIPEDREAM, IN 4XX*5191 20 MAR XX4703 74.00 PIPEDREAM, IN 4XXXXX*5191 20 MAR XXXXXXXXXXXXXXXXXX",Account Payment,"74.00 PIPEDREAM, IN 4XX*5191 20 MAR XX4703 74.00 PIPEDREAM, IN 4XXXXX*5191 20 MAR XXXXXXXXXXXXXXXXX",1381.09,,416574.65,AccountTransactionsReport.csv,125,2025-03,False,Other Computer Services,Other Computer Services,Other Computer Services
,2025-03-22,8400/000 : FNB,103.64 OPENAI 4XX*5191 20 MAR XX9574 103.64 OPENAI 4XXXXX*5191 20 MAR XXXXXXXXXXXXXXXXXXX9574,Account Payment,103.64 OPENAI 4XX*5191 20 MAR XX9574 103.64 OPENAI 4XXXXX*5191 20 MAR XXXXXXXXXXXXXXXXXXX9574,1934.27,,418508.92,AccountTransactionsReport.csv,126,2025-03,False,AI Services,AI Services,AI Services
,2025-03-22,8400/000 : FNB,103.85 OPENAI 4XX*5191 20 MAR XX5742 103.85 OPENAI 4XXXXX*5191 20 MAR XXXXXXXXXXXXXXXXXXX5742,Account Payment,103.85 OPENAI 4XX*5191 20 MAR XX5742 103.85 OPENAI 4XXXXX*5191 20 MAR XXXXXXXXXXXXXXXXXXX5742,1934.84,,420443.76,AccountTransactionsReport.csv,127,2025-03,False,AI Services,AI Services,AI Services
,2025-03-22,8400/000 : FNB,103.81 OPENAI 4XX*5191 20 MAR XX1230 103.81 OPENAI 4XXXXX*5191 20 MAR XXXXXXXXXXXXXXXXXXX1230,Account Payment,103.81 OPENAI 4XX*5191 20 MAR XX1230 103.81 OPENAI 4XXXXX*5191 20 MAR XXXXXXXXXXXXXXXXXXX1230,1937.44,,422381.2,AccountTransactionsReport.csv,128,2025-03,False,AI Services,AI Services,AI Services
,2025-03-22,8400/000 : FNB,104.13 OPENAI 4XX*5191 20 MAR XX6719 104.13 OPENAI 4XXXXX*5191 20 MAR XXXXXXXXXXXXXXXXXXX6719,Account Payment,104.13 OPENAI 4XX*5191 20 MAR XX6719 104.13 OPENAI 4XXXXX*5191 20 MAR XXXXXXXXXXXXXXXXXXX6719,1943.42,,424324.62,AccountTransactionsReport.csv,129,2025-03,False,AI Services,AI Services,AI Services
,2025-03-22,8400/000 : FNB,104.32 OPENAI 4XX*5191 21 MAR XX9252 104.32 OPENAI 4XXXXX*5191 21 MAR XXXXXXXXXXXXXXXXXXX9252,Account Payment,104.32 OPENAI 4XX*5191 21 MAR XX9252 104.32 OPENAI 4XXXXX*5191 21 MAR XXXXXXXXXXXXXXXXXXX9252,1943.6,,426268.22,AccountTransactionsReport.csv,130,2025-03,False,AI Services,AI Services,AI Services
,2025-03-22,8400/000 : FNB,106.02 OPENAI 4XX*5191 21 MAR XX6542 106.02 OPENAI 4XXXXX*5191 21 MAR XXXXXXXXXXXXXXXXXXX6542,Account Payment,106.02 OPENAI 4XX*5191 21 MAR XX6542 106.02 OPENAI 4XXXXX*5191 21 MAR XXXXXXXXXXXXXXXXXXX6542,1975.27,,428243.49,AccountTransactionsReport.csv,131,2025-03,False,AI Services,AI Services,AI Services
,2025-03-22,8400/000 : FNB,115.00 OPENAI 4XX*5191 19 MAR XX2236 115.00 OPENAI 4XXXXX*5191 19 MAR XXXXXXXXXXXXXXXXXXX2236,Account Payment,115.00 OPENAI 4XX*5191 19 MAR XX2236 115.00 OPENAI 4XXXXX*5191 19 MAR XXXXXXXXXXXXXXXXXXX2236,2132.76,,430376.25,AccountTransactionsReport.csv,132,2025-03,False,AI Services,AI Services,AI Services
,2025-03-22,8400/000 : FNB,3085.00 FRAMER.COM 4XX*5191 20 MAR XX2632 3085.00 FRAMER.COM 4XXXXX*5191 20 MAR XXXXXXXXXXXXXXXXXXX2,Account Payment,3085.00 FRAMER.COM 4XX*5191 20 MAR XX2632 3085.00 FRAMER.COM 4XXXXX*5191 20 MAR XXXXXXXXXXXXXXXXXXX,3085.0,,433461.25,AccountTransactionsReport.csv,133,2025-03,False,Other Computer Services,Design Tools,Design Tools
,2025-03-22,8400/000 : FNB,374.00 MANGOAPPS 4XX*5191 19 MAR XX7618 374.00 MANGOAPPS 4XXXXX*5191 19 MAR XXXXXXXXXXXXXXXXXXX7618,Account Payment,374.00 MANGOAPPS 4XX*5191 19 MAR XX7618 374.00 MANGOAPPS 4XXXXX*5191 19 MAR XXXXXXXXXXXXXXXXXXX7618,6936.1,,440397.35,AccountTransactionsReport.csv,134,2025-03,False,Other Computer Services,Other Computer Services,Other Computer Services
,2025-03-22,8400/000 : FNB,"456.00 ANIMA APP, I 4XX*5191 20 MAR XX6065 456.00 ANIMA APP, I 4XXXXX*5191 20 MAR XXXXXXXXXXXXXXXXXX",Account Payment,"456.00 ANIMA APP, I 4XX*5191 20 MAR XX6065 456.00 ANIMA APP, I 4XXXXX*5191 20 MAR XXXXXXXXXXXXXXXXX",8510.48,,448907.83,AccountTransactionsReport.csv,135,2025-03,False,Other Computer Services,Other Computer Services,Other Computer Services
,2025-03-22,8400/000 : FNB,"456.00 ANIMA APP, I 4XX*5191 20 MAR XX0583 456.00 ANIMA APP, I 4XXXXX*5191 20 MAR XXXXXXXXXXXXXXXXXX",Account Payment,"456.00 ANIMA APP, I 4XX*5191 20 MAR XX0583 456.00 ANIMA APP, I 4XXXXX*5191 20 MAR XXXXXXXXXXXXXXXXX",8510.48,,457418.31,AccountTransactionsReport.csv,136,2025-03,False,Other Computer Services,Other Computer Services,Other Computer Services
,2025-03-24,8400/000 : FNB,103.68 OPENAI 4XX*5191 21 MAR XX0574 103.68 OPENAI 4XXXXX*5191 21 MAR XXXXXXXXXXXXXXXXXXX0574,Account Payment,103.68 OPENAI 4XX*5191 21 MAR XX0574 103.68 OPENAI 4XXXXX*5191 21 MAR XXXXXXXXXXXXXXXXXXX0574,1931.68,,459349.99,AccountTransactionsReport.csv,137,2025-03,False,AI Services,AI Services,AI Services
,2025-03-24,8400/000 : FNB,103.66 OPENAI 4XX*5191 21 MAR XX9278 103.66 OPENAI 4XXXXX*5191 21 MAR XXXXXXXXXXXXXXXXXXX9278,Account Payment,103.66 OPENAI 4XX*5191 21 MAR XX9278 103.66 OPENAI 4XXXXX*5191 21 MAR XXXXXXXXXXXXXXXXXXX9278,1932.03,,461282.02,AccountTransactionsReport.csv,138,2025-03,False,AI Services,AI Services,AI Services
,2025-03-24,8400/000 : FNB,103.74 OPENAI 4XX*5191 22 MAR XX4295 103.74 OPENAI 4XXXXX*5191 22 MAR XXXXXXXXXXXXXXXXXXX4295,Account Payment,103.74 OPENAI 4XX*5191 22 MAR XX4295 103.74 OPENAI 4XXXXX*5191 22 MAR XXXXXXXXXXXXXXXXXXX4295,1933.52,,463215.54,AccountTransactionsReport.csv,139,2025-03,False,AI Services,AI Services,AI Services
,2025-03-24,8400/000 : FNB,104.02 OPENAI 4XX*5191 21 MAR XX3447 104.02 OPENAI 4XXXXX*5191 21 MAR XXXXXXXXXXXXXXXXXXX3447,Account Payment,104.02 OPENAI 4XX*5191 21 MAR XX3447 104.02 OPENAI 4XXXXX*5191 21 MAR XXXXXXXXXXXXXXXXXXX3447,1938.01,,465153.55,AccountTransactionsReport.csv,140,2025-03,False,AI Services,AI Services,AI Services
,2025-03-24,8400/000 : FNB,104.10 OPENAI 4XX*5191 22 MAR XX4974 104.10 OPENAI 4XXXXX*5191 22 MAR XXXXXXXXXXXXXXXXXXX4974,Account Payment,104.10 OPENAI 4XX*5191 22 MAR XX4974 104.10 OPENAI 4XXXXX*5191 22 MAR XXXXXXXXXXXXXXXXXXX4974,1940.23,,467093.78,AccountTransactionsReport.csv,141,2025-03,False,AI Services,AI Services,AI Services
,2025-03-24,8400/000 : FNB,105.04 OPENAI 4XX*5191 21 MAR XX5004 105.04 OPENAI 4XXXXX*5191 21 MAR XXXXXXXXXXXXXXXXXXX5004,Account Payment,105.04 OPENAI 4XX*5191 21 MAR XX5004 105.04 OPENAI 4XXXXX*5191 21 MAR XXXXXXXXXXXXXXXXXXX5004,1957.01,,469050.79,AccountTransactionsReport.csv,142,2025-03,False,AI Services,AI Services,AI Services
,2025-03-24,8400/000 : FNB,105.66 OPENAI 4XX*5191 21 MAR XX6438 105.66 OPENAI 4XXXXX*5191 21 MAR XXXXXXXXXXXXXXXXXXX6438,Account Payment,105.66 OPENAI 4XX*5191 21 MAR XX6438 105.66 OPENAI 4XXXXX*5191 21 MAR XXXXXXXXXXXXXXXXXXX6438,1968.56,,471019.35,AccountTransactionsReport.csv,143,2025-03,False,AI Services,AI Services,AI Services
,2025-03-24,8400/000 : FNB,105.88 OPENAI 4XX*5191 21 MAR XX3405 105.88 OPENAI 4XXXXX*5191 21 MAR XXXXXXXXXXXXXXXXXXX3405,Account Payment,105.88 OPENAI 4XX*5191 21 MAR XX3405 105.88 OPENAI 4XXXXX*5191 21 MAR XXXXXXXXXXXXXXXXXXX3405,1972.66,,472992.01,AccountTransactionsReport.csv,144,2025-03,False,AI Services,AI Services,AI Services
,2025-03-25,8400/000 : FNB,"6.00 DOCKER, INC. 4XX*5191 24 MAR XX1623 6.00 DOCKER, INC. 4XXXXX*5191 24 MAR XXXXXXXXXXXXXXXXXXX162",Account Payment,"6.00 DOCKER, INC. 4XX*5191 24 MAR XX1623 6.00 DOCKER, INC. 4XXXXX*5191 24 MAR XXXXXXXXXXXXXXXXXXX16",111.83,,473103.84,AccountTransactionsReport.csv,145,2025-03,False,Other Computer Services,Other Computer Services,Other Computer Services
,2025-03-25,8400/000 : FNB,30.00 HASURA 4XX*5191 23 MAR XX8567 30.00 HASURA 4XXXXX*5191 23 MAR XXXXXXXXXXXXXXXXXXX8567,Account Payment,30.00 HASURA 4XX*5191 23 MAR XX8567 30.00 HASURA 4XXXXX*5191 23 MAR XXXXXXXXXXXXXXXXXXX8567,559.14,,473662.98,AccountTransactionsReport.csv,146,2025-03,False,Other Computer Services,Other Computer Services,Other Computer Services
,2025-03-25,8400/000 : FNB,89.00 SENTRY 4XX*5191 24 MAR XX9774 89.00 SENTRY 4XXXXX*5191 24 MAR XXXXXXXXXXXXXXXXXXX9774,Account Payment,89.00 SENTRY 4XX*5191 24 MAR XX9774 89.00 SENTRY 4XXXXX*5191 24 MAR XXXXXXXXXXXXXXXXXXX9774,1658.8,,475321.78,AccountTransactionsReport.csv,147,2025-03,False,Other Computer Services,Analytics & Monitoring,Analytics & Monitoring
,2025-03-25,8400/000 : FNB,103.65 OPENAI 4XX*5191 23 MAR XX9251 103.65 OPENAI 4XXXXX*5191 23 MAR XXXXXXXXXXXXXXXXXXX9251,Account Payment,103.65 OPENAI 4XX*5191 23 MAR XX9251 103.65 OPENAI 4XXXXX*5191 23 MAR XXXXXXXXXXXXXXXXXXX9251,1931.84,,477253.62,AccountTransactionsReport.csv,148,2025-03,False,AI Services,AI Services,AI Services
,2025-03-25,8400/000 : FNB,103.66 OPENAI 4XX*5191 22 MAR XX9090 103.66 OPENAI 4XXXXX*5191 22 MAR XXXXXXXXXXXXXXXXXXX9090,Account Payment,103.66 OPENAI 4XX*5191 22 MAR XX9090 103.66 OPENAI 4XXXXX*5191 22 MAR XXXXXXXXXXXXXXXXXXX9090,1932.03,,479185.65,AccountTransactionsReport.csv,149,2025-03,False,AI Services,AI Services,AI Services
,2025-03-25,8400/000 : FNB,103.97 OPENAI 4XX*5191 23 MAR XX2958 103.97 OPENAI 4XXXXX*5191 23 MAR XXXXXXXXXXXXXXXXXXX2958,Account Payment,103.97 OPENAI 4XX*5191 23 MAR XX2958 103.97 OPENAI 4XXXXX*5191 23 MAR XXXXXXXXXXXXXXXXXXX2958,1937.81,,481123.46,AccountTransactionsReport.csv,150,2025-03,False,AI Services,AI Services,AI Services
,2025-03-25,8400/000 : FNB,103.97 OPENAI 4XX*5191 23 MAR XX3880 103.97 OPENAI 4XXXXX*5191 23 MAR XXXXXXXXXXXXXXXXXXX3880,Account Payment,103.97 OPENAI 4XX*5191 23 MAR XX3880 103.97 OPENAI 4XXXXX*5191 23 MAR XXXXXXXXXXXXXXXXXXX3880,1937.81,,483061.27,AccountTransactionsReport.csv,151,2025-03,False,AI Services,AI Services,AI Services
,2025-03-25,8400/000 : FNB,104.01 OPENAI 4XX*5191 24 MAR XX0502 104.01 OPENAI 4XXXXX*5191 24 MAR XXXXXXXXXXXXXXXXXXX0502,Account Payment,104.01 OPENAI 4XX*5191 24 MAR XX0502 104.01 OPENAI 4XXXXX*5191 24 MAR XXXXXXXXXXXXXXXXXXX0502,1938.55,,484999.82,AccountTransactionsReport.csv,152,2025-03,False,AI Services,AI Services,AI Services
,2025-03-25,8400/000 : FNB,104.13 OPENAI 4XX*5191 22 MAR XX3241 104.13 OPENAI 4XXXXX*5191 22 MAR XXXXXXXXXXXXXXXXXXX3241,Account Payment,104.13 OPENAI 4XX*5191 22 MAR XX3241 104.13 OPENAI 4XXXXX*5191 22 MAR XXXXXXXXXXXXXXXXXXX3241,1940.78,,486940.6,AccountTransactionsReport.csv,153,2025-03,False,AI Services,AI Services,AI Services
,2025-03-25,8400/000 : FNB,104.27 OPENAI 4XX*5191 23 MAR XX4863 104.27 OPENAI 4XXXXX*5191 23 MAR XXXXXXXXXXXXXXXXXXX4863,Account Payment,104.27 OPENAI 4XX*5191 23 MAR XX4863 104.27 OPENAI 4XXXXX*5191 23 MAR XXXXXXXXXXXXXXXXXXX4863,1943.4,,488884.0,AccountTransactionsReport.csv,154,2025-03,False,AI Services,AI Services,AI Services
,2025-03-25,8400/000 : FNB,104.33 OPENAI 4XX*5191 23 MAR XX7841 104.33 OPENAI 4XXXXX*5191 23 MAR XXXXXXXXXXXXXXXXXXX7841,Account Payment,104.33 OPENAI 4XX*5191 23 MAR XX7841 104.33 OPENAI 4XXXXX*5191 23 MAR XXXXXXXXXXXXXXXXXXX7841,1944.52,,490828.52,AccountTransactionsReport.csv,155,2025-03,False,AI Services,AI Services,AI Services
,2025-03-25,8400/000 : FNB,104.33 OPENAI 4XX*5191 23 MAR XX2618 104.33 OPENAI 4XXXXX*5191 23 MAR XXXXXXXXXXXXXXXXXXX2618,Account Payment,104.33 OPENAI 4XX*5191 23 MAR XX2618 104.33 OPENAI 4XXXXX*5191 23 MAR XXXXXXXXXXXXXXXXXXX2618,1944.52,,492773.04,AccountTransactionsReport.csv,156,2025-03,False,AI Services,AI Services,AI Services
,2025-03-25,8400/000 : FNB,104.62 OPENAI 4XX*5191 23 MAR XX3592 104.62 OPENAI 4XXXXX*5191 23 MAR XXXXXXXXXXXXXXXXXXX3592,Account Payment,104.62 OPENAI 4XX*5191 23 MAR XX3592 104.62 OPENAI 4XXXXX*5191 23 MAR XXXXXXXXXXXXXXXXXXX3592,1949.92,,494722.96,AccountTransactionsReport.csv,157,2025-03,False,AI Services,AI Services,AI Services
,2025-03-25,8400/000 : FNB,104.68 OPENAI 4XX*5191 24 MAR XX4651 104.68 OPENAI 4XXXXX*5191 24 MAR XXXXXXXXXXXXXXXXXXX4651,Account Payment,104.68 OPENAI 4XX*5191 24 MAR XX4651 104.68 OPENAI 4XXXXX*5191 24 MAR XXXXXXXXXXXXXXXXXXX4651,1951.04,,496674.0,AccountTransactionsReport.csv,158,2025-03,False,AI Services,AI Services,AI Services
,2025-03-25,8400/000 : FNB,104.91 OPENAI 4XX*5191 22 MAR XX7585 104.91 OPENAI 4XXXXX*5191 22 MAR XXXXXXXXXXXXXXXXXXX7585,Account Payment,104.91 OPENAI 4XX*5191 22 MAR XX7585 104.91 OPENAI 4XXXXX*5191 22 MAR XXXXXXXXXXXXXXXXXXX7585,1955.33,,498629.33,AccountTransactionsReport.csv,159,2025-03,False,AI Services,AI Services,AI Services
,2025-03-25,8400/000 : FNB,104.95 OPENAI 4XX*5191 23 MAR XX2690 104.95 OPENAI 4XXXXX*5191 23 MAR XXXXXXXXXXXXXXXXXXX2690,Account Payment,104.95 OPENAI 4XX*5191 23 MAR XX2690 104.95 OPENAI 4XXXXX*5191 23 MAR XXXXXXXXXXXXXXXXXXX2690,1956.07,,500585.4,AccountTransactionsReport.csv,160,2025-03,False,AI Services,AI Services,AI Services
,2025-03-25,8400/000 : FNB,105.11 OPENAI 4XX*5191 23 MAR XX1046 105.11 OPENAI 4XXXXX*5191 23 MAR XXXXXXXXXXXXXXXXXXX1046,Account Payment,105.11 OPENAI 4XX*5191 23 MAR XX1046 105.11 OPENAI 4XXXXX*5191 23 MAR XXXXXXXXXXXXXXXXXXX1046,1959.05,,502544.45,AccountTransactionsReport.csv,161,2025-03,False,AI Services,AI Services,AI Services
,2025-03-25,8400/000 : FNB,106.00 OPENAI 4XX*5191 23 MAR XX6236 106.00 OPENAI 4XXXXX*5191 23 MAR XXXXXXXXXXXXXXXXXXX6236,Account Payment,106.00 OPENAI 4XX*5191 23 MAR XX6236 106.00 OPENAI 4XXXXX*5191 23 MAR XXXXXXXXXXXXXXXXXXX6236,1975.64,,504520.09,AccountTransactionsReport.csv,162,2025-03,False,AI Services,AI Services,AI Services
,2025-03-25,8400/000 : FNB,106.43 OPENAI 4XX*5191 23 MAR XX4883 106.43 OPENAI 4XXXXX*5191 23 MAR XXXXXXXXXXXXXXXXXXX4883,Account Payment,106.43 OPENAI 4XX*5191 23 MAR XX4883 106.43 OPENAI 4XXXXX*5191 23 MAR XXXXXXXXXXXXXXXXXXX4883,1983.66,,506503.75,AccountTransactionsReport.csv,163,2025-03,False,AI Services,AI Services,AI Services
,2025-03-25,8400/000 : FNB,106.46 OPENAI 4XX*5191 22 MAR XX6085 106.46 OPENAI 4XXXXX*5191 22 MAR XXXXXXXXXXXXXXXXXXX6085,Account Payment,106.46 OPENAI 4XX*5191 22 MAR XX6085 106.46 OPENAI 4XXXXX*5191 22 MAR XXXXXXXXXXXXXXXXXXX6085,1984.22,,508487.97,AccountTransactionsReport.csv,164,2025-03,False,AI Services,AI Services,AI Services
,2025-03-25,8400/000 : FNB,106.54 OPENAI 4XX*5191 23 MAR XX5802 106.54 OPENAI 4XXXXX*5191 23 MAR XXXXXXXXXXXXXXXXXXX5802,Account Payment,106.54 OPENAI 4XX*5191 23 MAR XX5802 106.54 OPENAI 4XXXXX*5191 23 MAR XXXXXXXXXXXXXXXXXXX5802,1985.71,,510473.68,AccountTransactionsReport.csv,165,2025-03,False,AI Services,AI Services,AI Services
,2025-03-25,8400/000 : FNB,106.86 OPENAI 4XX*5191 24 MAR XX1897 106.86 OPENAI 4XXXXX*5191 24 MAR XXXXXXXXXXXXXXXXXXX1897,Account Payment,106.86 OPENAI 4XX*5191 24 MAR XX1897 106.86 OPENAI 4XXXXX*5191 24 MAR XXXXXXXXXXXXXXXXXXX1897,1991.67,,512465.35,AccountTransactionsReport.csv,166,2025-03,False,AI Services,AI Services,AI Services
,2025-03-25,8400/000 : FNB,107.10 OPENAI 4XX*5191 24 MAR XX7744 107.10 OPENAI 4XXXXX*5191 24 MAR XXXXXXXXXXXXXXXXXXX7744,Account Payment,107.10 OPENAI 4XX*5191 24 MAR XX7744 107.10 OPENAI 4XXXXX*5191 24 MAR XXXXXXXXXXXXXXXXXXX7744,1996.14,,514461.49,AccountTransactionsReport.csv,167,2025-03,False,AI Services,AI Services,AI Services
,2025-03-25,8400/000 : FNB,107.35 OPENAI 4XX*5191 24 MAR XX5461 107.35 OPENAI 4XXXXX*5191 24 MAR XXXXXXXXXXXXXXXXXXX5461,Account Payment,107.35 OPENAI 4XX*5191 24 MAR XX5461 107.35 OPENAI 4XXXXX*5191 24 MAR XXXXXXXXXXXXXXXXXXX5461,2000.8,,516462.29,AccountTransactionsReport.csv,168,2025-03,False,AI Services,AI Services,AI Services
,2025-03-25,8400/000 : FNB,108.63 OPENAI 4XX*5191 24 MAR XX6389 108.63 OPENAI 4XXXXX*5191 24 MAR XXXXXXXXXXXXXXXXXXX6389,Account Payment,108.63 OPENAI 4XX*5191 24 MAR XX6389 108.63 OPENAI 4XXXXX*5191 24 MAR XXXXXXXXXXXXXXXXXXX6389,2024.66,,518486.95,AccountTransactionsReport.csv,169,2025-03,False,AI Services,AI Services,AI Services
,2025-03-25,8400/000 : FNB,299.00 ORG CHART 4XX*5191 22 MAR XX6885 299.00 ORG CHART 4XXXXX*5191 22 MAR XXXXXXXXXXXXXXXXXXX6885,Account Payment,299.00 ORG CHART 4XX*5191 22 MAR XX6885 299.00 ORG CHART 4XXXXX*5191 22 MAR XXXXXXXXXXXXXXXXXXX6885,5572.8,,524059.75,AccountTransactionsReport.csv,170,2025-03,False,Other Computer Services,Other Computer Services,Other Computer Services
,2025-03-26,8400/000 : FNB,108.46 OPENAI 4XX*5191 25 MAR XX0638 108.46 OPENAI 4XXXXX*5191 25 MAR XXXXXXXXXXXXXXXXXXX0638,Account Payment,108.46 OPENAI 4XX*5191 25 MAR XX0638 108.46 OPENAI 4XXXXX*5191 25 MAR XXXXXXXXXXXXXXXXXXX0638,2021.32,,526081.07,AccountTransactionsReport.csv,171,2025-03,False,AI Services,AI Services,AI Services
,2025-03-26,8400/000 : FNB,108.04 OPENAI 4XX*5191 24 MAR XX2821 108.04 OPENAI 4XXXXX*5191 24 MAR XXXXXXXXXXXXXXXXXXX2821,Account Payment,108.04 OPENAI 4XX*5191 24 MAR XX2821 108.04 OPENAI 4XXXXX*5191 24 MAR XXXXXXXXXXXXXXXXXXX2821,2013.66,,528094.73,AccountTransactionsReport.csv,172,2025-03,False,AI Services,AI Services,AI Services
,2025-03-26,8400/000 : FNB,107.46 OPENAI 4XX*5191 25 MAR XX3161 107.46 OPENAI 4XXXXX*5191 25 MAR XXXXXXXXXXXXXXXXXXX3161,Account Payment,107.46 OPENAI 4XX*5191 25 MAR XX3161 107.46 OPENAI 4XXXXX*5191 25 MAR XXXXXXXXXXXXXXXXXXX3161,2002.69,,530097.42,AccountTransactionsReport.csv,173,2025-03,False,AI Services,AI Services,AI Services
,2025-03-26,8400/000 : FNB,107.17 OPENAI 4XX*5191 24 MAR XX6665 107.17 OPENAI 4XXXXX*5191 24 MAR XXXXXXXXXXXXXXXXXXX6665,Account Payment,107.17 OPENAI 4XX*5191 24 MAR XX6665 107.17 OPENAI 4XXXXX*5191 24 MAR XXXXXXXXXXXXXXXXXXX6665,1997.45,,532094.87,AccountTransactionsReport.csv,174,2025-03,False,AI Services,AI Services,AI Services
,2025-03-26,8400/000 : FNB,107.08 OPENAI 4XX*5191 24 MAR XX0012 107.08 OPENAI 4XXXXX*5191 24 MAR XXXXXXXXXXXXXXXXXXX0012,Account Payment,107.08 OPENAI 4XX*5191 24 MAR XX0012 107.08 OPENAI 4XXXXX*5191 24 MAR XXXXXXXXXXXXXXXXXXX0012,1995.77,,534090.64,AccountTransactionsReport.csv,175,2025-03,False,AI Services,AI Services,AI Services
,2025-03-26,8400/000 : FNB,107.00 OPENAI 4XX*5191 24 MAR XX1221 107.00 OPENAI 4XXXXX*5191 24 MAR XXXXXXXXXXXXXXXXXXX1221,Account Payment,107.00 OPENAI 4XX*5191 24 MAR XX1221 107.00 OPENAI 4XXXXX*5191 24 MAR XXXXXXXXXXXXXXXXXXX1221,1994.28,,536084.92,AccountTransactionsReport.csv,176,2025-03,False,AI Services,AI Services,AI Services
,2025-03-26,8400/000 : FNB,106.98 OPENAI 4XX*5191 24 MAR XX1851 106.98 OPENAI 4XXXXX*5191 24 MAR XXXXXXXXXXXXXXXXXXX1851,Account Payment,106.98 OPENAI 4XX*5191 24 MAR XX1851 106.98 OPENAI 4XXXXX*5191 24 MAR XXXXXXXXXXXXXXXXXXX1851,1993.91,,538078.83,AccountTransactionsReport.csv,177,2025-03,False,AI Services,AI Services,AI Services
,2025-03-26,8400/000 : FNB,106.43 OPENAI 4XX*5191 25 MAR XX7191 106.43 OPENAI 4XXXXX*5191 25 MAR XXXXXXXXXXXXXXXXXXX7191,Account Payment,106.43 OPENAI 4XX*5191 25 MAR XX7191 106.43 OPENAI 4XXXXX*5191 25 MAR XXXXXXXXXXXXXXXXXXX7191,1983.49,,540062.32,AccountTransactionsReport.csv,178,2025-03,False,AI Services,AI Services,AI Services
,2025-03-26,8400/000 : FNB,106.15 OPENAI 4XX*5191 25 MAR XX7891 106.15 OPENAI 4XXXXX*5191 25 MAR XXXXXXXXXXXXXXXXXXX7891,Account Payment,106.15 OPENAI 4XX*5191 25 MAR XX7891 106.15 OPENAI 4XXXXX*5191 25 MAR XXXXXXXXXXXXXXXXXXX7891,1978.28,,542040.6,AccountTransactionsReport.csv,179,2025-03,False,AI Services,AI Services,AI Services
,2025-03-26,8400/000 : FNB,106.13 OPENAI 4XX*5191 24 MAR XX2989 106.13 OPENAI 4XXXXX*5191 24 MAR XXXXXXXXXXXXXXXXXXX2989,Account Payment,106.13 OPENAI 4XX*5191 24 MAR XX2989 106.13 OPENAI 4XXXXX*5191 24 MAR XXXXXXXXXXXXXXXXXXX2989,1978.07,,544018.67,AccountTransactionsReport.csv,180,2025-03,False,AI Services,AI Services,AI Services
,2025-03-26,8400/000 : FNB,105.63 OPENAI 4XX*5191 24 MAR XX8765 105.63 OPENAI 4XXXXX*5191 24 MAR XXXXXXXXXXXXXXXXXXX8765,Account Payment,105.63 OPENAI 4XX*5191 24 MAR XX8765 105.63 OPENAI 4XXXXX*5191 24 MAR XXXXXXXXXXXXXXXXXXX8765,1968.58,,545987.25,AccountTransactionsReport.csv,181,2025-03,False,AI Services,AI Services,AI Services
,2025-03-26,8400/000 : FNB,105.08 OPENAI 4XX*5191 25 MAR XX0314 105.08 OPENAI 4XXXXX*5191 25 MAR XXXXXXXXXXXXXXXXXXX0314,Account Payment,105.08 OPENAI 4XX*5191 25 MAR XX0314 105.08 OPENAI 4XXXXX*5191 25 MAR XXXXXXXXXXXXXXXXXXX0314,1958.34,,547945.59,AccountTransactionsReport.csv,182,2025-03,False,AI Services,AI Services,AI Services
,2025-03-26,8400/000 : FNB,104.87 OPENAI 4XX*5191 24 MAR XX9661 104.87 OPENAI 4XXXXX*5191 24 MAR XXXXXXXXXXXXXXXXXXX9661,Account Payment,104.87 OPENAI 4XX*5191 24 MAR XX9661 104.87 OPENAI 4XXXXX*5191 24 MAR XXXXXXXXXXXXXXXXXXX9661,1954.59,,549900.18,AccountTransactionsReport.csv,183,2025-03,False,AI Services,AI Services,AI Services
,2025-03-26,8400/000 : FNB,104.47 OPENAI 4XX*5191 25 MAR XX4738 104.47 OPENAI 4XXXXX*5191 25 MAR XXXXXXXXXXXXXXXXXXX4738,Account Payment,104.47 OPENAI 4XX*5191 25 MAR XX4738 104.47 OPENAI 4XXXXX*5191 25 MAR XXXXXXXXXXXXXXXXXXX4738,1946.97,,551847.15,AccountTransactionsReport.csv,184,2025-03,False,AI Services,AI Services,AI Services
,2025-03-26,8400/000 : FNB,104.19 OPENAI 4XX*5191 24 MAR XX2173 104.19 OPENAI 4XXXXX*5191 24 MAR XXXXXXXXXXXXXXXXXXX2173,Account Payment,104.19 OPENAI 4XX*5191 24 MAR XX2173 104.19 OPENAI 4XXXXX*5191 24 MAR XXXXXXXXXXXXXXXXXXX2173,1941.91,,553789.06,AccountTransactionsReport.csv,185,2025-03,False,AI Services,AI Services,AI Services
,2025-03-26,8400/000 : FNB,103.76 OPENAI 4XX*5191 25 MAR XX3290 103.76 OPENAI 4XXXXX*5191 25 MAR XXXXXXXXXXXXXXXXXXX3290,Account Payment,103.76 OPENAI 4XX*5191 25 MAR XX3290 103.76 OPENAI 4XXXXX*5191 25 MAR XXXXXXXXXXXXXXXXXXX3290,1933.74,,555722.8,AccountTransactionsReport.csv,186,2025-03,False,AI Services,AI Services,AI Services
,2025-03-26,8400/000 : FNB,10.00 MATTERMOST 4XX*5191 24 MAR XX9398 10.00 MATTERMOST 4XXXXX*5191 24 MAR XXXXXXXXXXXXXXXXXXX9398,Account Payment,10.00 MATTERMOST 4XX*5191 24 MAR XX9398 10.00 MATTERMOST 4XXXXX*5191 24 MAR XXXXXXXXXXXXXXXXXXX9398,186.36,,555909.16,AccountTransactionsReport.csv,187,2025-03,False,Other Computer Services,Other Computer Services,Other Computer Services
,2025-03-27,8400/000 : FNB,150.00 AUTH0.COM 4XX*5191 25 MAR XX9784 150.00 AUTH0.COM 4XXXXX*5191 25 MAR XXXXXXXXXXXXXXXXXXX9784,Account Payment,150.00 AUTH0.COM 4XX*5191 25 MAR XX9784 150.00 AUTH0.COM 4XXXXX*5191 25 MAR XXXXXXXXXXXXXXXXXXX9784,2798.68,,558707.84,AccountTransactionsReport.csv,188,2025-03,False,Security Services,Security Services,Security Services
,2025-03-27,8400/000 : FNB,107.10 OPENAI 4XX*5191 25 MAR XX6604 107.10 OPENAI 4XXXXX*5191 25 MAR XXXXXXXXXXXXXXXXXXX6604,Account Payment,107.10 OPENAI 4XX*5191 25 MAR XX6604 107.10 OPENAI 4XXXXX*5191 25 MAR XXXXXXXXXXXXXXXXXXX6604,1995.98,,560703.82,AccountTransactionsReport.csv,189,2025-03,False,AI Services,AI Services,AI Services
,2025-03-27,8400/000 : FNB,104.64 OPENAI 4XX*5191 25 MAR XX0251 104.64 OPENAI 4XXXXX*5191 25 MAR XXXXXXXXXXXXXXXXXXX0251,Account Payment,104.64 OPENAI 4XX*5191 25 MAR XX0251 104.64 OPENAI 4XXXXX*5191 25 MAR XXXXXXXXXXXXXXXXXXX0251,1950.14,,562653.96,AccountTransactionsReport.csv,190,2025-03,False,AI Services,AI Services,AI Services
,2025-03-27,8400/000 : FNB,103.81 OPENAI 4XX*5191 25 MAR XX3740 103.81 OPENAI 4XXXXX*5191 25 MAR XXXXXXXXXXXXXXXXXXX3740,Account Payment,103.81 OPENAI 4XX*5191 25 MAR XX3740 103.81 OPENAI 4XXXXX*5191 25 MAR XXXXXXXXXXXXXXXXXXX3740,1934.66,,564588.62,AccountTransactionsReport.csv,191,2025-03,False,AI Services,AI Services,AI Services
,2025-04-01,8400/000 : FNB,5050.80 FRESHWORKS 4XX*5225 29 MAR XX0267 5050.80 FRESHWORKS 4XXXXX*5225 29 MAR XXXXXXXXXXXXXXXXXXX0,Account Payment,5050.80 FRESHWORKS 4XX*5225 29 MAR XX0267 5050.80 FRESHWORKS 4XXXXX*5225 29 MAR XXXXXXXXXXXXXXXXXXX,5050.8,,569639.42,AccountTransactionsReport.csv,192,2025-04,False,Productivity Software,Productivity Software,Productivity Software
,2025-04-01,8400/000 : FNB,Facebook 346.90 FACEBK *YEG2 4XXXXX*5191 30 MAR XXXXXXXXXXXXXXXXXXX3172 Facebook,Account Payment,Facebook 346.90 FACEBK *YEG2 4XXXXX*5191 30 MAR XXXXXXXXXXXXXXXXXXX3172 Facebook,346.9,,569986.32,AccountTransactionsReport.csv,193,2025-04,False,Marketing Tools,Marketing Tools,Marketing Tools
,2025-04-01,8400/000 : FNB,1150.00 AUTH0.COM 4XX*5191 30 MAR XX1523 1150.00 AUTH0.COM 4XXXXX*5191 30 MAR XXXXXXXXXXXXXXXXXXX152,Account Payment,1150.00 AUTH0.COM 4XX*5191 30 MAR XX1523 1150.00 AUTH0.COM 4XXXXX*5191 30 MAR XXXXXXXXXXXXXXXXXXX15,21695.19,,591681.51,AccountTransactionsReport.csv,194,2025-04,False,Security Services,Security Services,Security Services
,2025-04-01,8400/000 : FNB,50.00 OBSIDIAN.MD 4XX*5191 30 MAR XX5048 50.00 OBSIDIAN.MD 4XXXXX*5191 30 MAR XXXXXXXXXXXXXXXXXXX504,Account Payment,50.00 OBSIDIAN.MD 4XX*5191 30 MAR XX5048 50.00 OBSIDIAN.MD 4XXXXX*5191 30 MAR XXXXXXXXXXXXXXXXXXX50,943.27,,592624.78,AccountTransactionsReport.csv,195,2025-04,False,Other Computer Services,Other Computer Services,Other Computer Services
,2025-04-02,8400/000 : FNB,Shopify 3421.17 SHOPIFY* 34 4XXXXX*5191 31 MAR XXXXXXXXXXXXXXXXXXX1409 Shopify,Account Payment,Shopify 3421.17 SHOPIFY* 34 4XXXXX*5191 31 MAR XXXXXXXXXXXXXXXXXXX1409 Shopify,64541.66,,657166.44,AccountTransactionsReport.csv,196,2025-04,False,E-commerce Platforms,E-commerce Platforms,E-commerce Platforms
,2025-04-02,8400/000 : FNB,Wix.com 182.85 WIX.COM 4XXXXX*5191 01 APR XXXXXXXXXXXXXXXXXXX6957 Wix.com,Account Payment,Wix.com 182.85 WIX.COM 4XXXXX*5191 01 APR XXXXXXXXXXXXXXXXXXX6957 Wix.com,3440.11,,660606.55,AccountTransactionsReport.csv,197,2025-04,False,E-commerce Platforms,E-commerce Platforms,E-commerce Platforms
,2025-04-02,8400/000 : FNB,Digitalocean 47.84 DIGITALOCEAN. 4XXXXX*5191 01 APR XXXXXXXXXXXXXXXXXXX2879 Digitalocean,Account Payment,Digitalocean 47.84 DIGITALOCEAN. 4XXXXX*5191 01 APR XXXXXXXXXXXXXXXXXXX2879 Digitalocean,900.06,,661506.61,AccountTransactionsReport.csv,198,2025-04,False,Cloud Services,Cloud Services,Cloud Services
,2025-04-02,8400/000 : FNB,31.84 LINODE . AKAM 4XX*5191 01 APR XX3030 31.84 LINODE . AKAM 4XXXXX*5191 01 APR XXXXXXXXXXXXXXXXXX,Account Payment,31.84 LINODE . AKAM 4XX*5191 01 APR XX3030 31.84 LINODE . AKAM 4XXXXX*5191 01 APR XXXXXXXXXXXXXXXXX,599.04,,662105.65,AccountTransactionsReport.csv,199,2025-04,False,Cloud Services,Cloud Services,Cloud Services
,2025-04-03,8400/000 : FNB,1.00 VERCEL INC. 4XX*5225 01 APR XX5234 1.00 VERCEL INC. 4XXXXX*5225 01 APR XXXXXXXXXXXXXXXXXXX5234,Account Payment,1.00 VERCEL INC. 4XX*5225 01 APR XX5234 1.00 VERCEL INC. 4XXXXX*5225 01 APR XXXXXXXXXXXXXXXXXXX5234,18.81,,662124.46,AccountTransactionsReport.csv,200,2025-04,False,Cloud Services,Cloud Services,Cloud Services
,2025-04-03,8400/000 : FNB,Facebook 23.00 FACEBK *98CT8 4XXXXX*5191 01 APR XXXXXXXXXXXXXXXXXXX2090 Facebook,Account Payment,Facebook 23.00 FACEBK *98CT8 4XXXXX*5191 01 APR XXXXXXXXXXXXXXXXXXX2090 Facebook,432.71,,662557.17,AccountTransactionsReport.csv,201,2025-04,False,Marketing Tools,Marketing Tools,Marketing Tools
,2025-04-03,8400/000 : FNB,17.25 SLACK T06A3T4 4XX*5191 01 APR XX1018 17.25 SLACK T06A3T4 4XXXXX*5191 01 APR XXXXXXXXXXXXXXXXXX,Account Payment,17.25 SLACK T06A3T4 4XX*5191 01 APR XX1018 17.25 SLACK T06A3T4 4XXXXX*5191 01 APR XXXXXXXXXXXXXXXXX,324.54,,662881.71,AccountTransactionsReport.csv,202,2025-04,False,Communication,Communication,Communication
,2025-04-03,8400/000 : FNB,Facebook 13.80 FACEBK *QZB2S 4XXXXX*5191 01 APR XXXXXXXXXXXXXXXXXXX5098 Facebook,Account Payment,Facebook 13.80 FACEBK *QZB2S 4XXXXX*5191 01 APR XXXXXXXXXXXXXXXXXXX5098 Facebook,259.63,,663141.34,AccountTransactionsReport.csv,203,2025-04,False,Marketing Tools,Marketing Tools,Marketing Tools
,2025-04-03,8400/000 : FNB,Facebook 4.60 FACEBK *U8ZVWK 4XXXXX*5191 01 APR XXXXXXXXXXXXXXXXXXX5070 Facebook,Account Payment,Facebook 4.60 FACEBK *U8ZVWK 4XXXXX*5191 01 APR XXXXXXXXXXXXXXXXXXX5070 Facebook,86.55,,663227.89,AccountTransactionsReport.csv,204,2025-04,False,Marketing Tools,Marketing Tools,Marketing Tools
,2025-04-03,8400/000 : FNB,134.00 SINCH MAILGU 4XX*5191 01 APR XX3060 134.00 SINCH MAILGU 4XXXXX*5191 01 APR XXXXXXXXXXXXXXXXXX,Account Payment,134.00 SINCH MAILGU 4XX*5191 01 APR XX3060 134.00 SINCH MAILGU 4XXXXX*5191 01 APR XXXXXXXXXXXXXXXXX,2521.06,,665748.95,AccountTransactionsReport.csv,205,2025-04,False,Other Computer Services,Other Computer Services,Other Computer Services
,2025-04-03,8400/000 : FNB,50.00 ANACONDA INC. 4XX*5191 01 APR XX6959 50.00 ANACONDA INC. 4XXXXX*5191 01 APR XXXXXXXXXXXXXXXXXX,Account Payment,50.00 ANACONDA INC. 4XX*5191 01 APR XX6959 50.00 ANACONDA INC. 4XXXXX*5191 01 APR XXXXXXXXXXXXXXXXX,940.7,,666689.65,AccountTransactionsReport.csv,206,2025-04,False,Other Computer Services,Other Computer Services,Other Computer Services
,2025-04-04,8400/000 : FNB,450.00 WAPPALYZER 4XX*5191 02 APR XX3036 450.00 WAPPALYZER 4XXXXX*5191 02 APR XXXXXXXXXXXXXXXXXXX303,Account Payment,450.00 WAPPALYZER 4XX*5191 02 APR XX3036 450.00 WAPPALYZER 4XXXXX*5191 02 APR XXXXXXXXXXXXXXXXXXX30,8504.11,,675193.76,AccountTransactionsReport.csv,207,2025-04,False,Other Computer Services,Other Computer Services,Other Computer Services
,2025-04-07,8400/000 : FNB,"Github Inc. 16.56 GITHUB, INC. 4XXXXX*5225 04 APR XXXXXXXXXXXXXXXXXXX6188 Github Inc.",Account Payment,"Github Inc. 16.56 GITHUB, INC. 4XXXXX*5225 04 APR XXXXXXXXXXXXXXXXXXX6188 Github Inc.",321.46,,675515.22,AccountTransactionsReport.csv,208,2025-04,False,Development Tools,Development Tools,Development Tools
,2025-04-07,8400/000 : FNB,1499.00 APPDIRECT 4XX*5225 04 APR XX5248 1499.00 APPDIRECT 4XXXXX*5225 04 APR XXXXXXXXXXXXXXXXXXX524,Account Payment,1499.00 APPDIRECT 4XX*5225 04 APR XX5248 1499.00 APPDIRECT 4XXXXX*5225 04 APR XXXXXXXXXXXXXXXXXXX52,29098.33,,704613.55,AccountTransactionsReport.csv,209,2025-04,False,Other Computer Services,Other Computer Services,Other Computer Services
,2025-04-07,8400/000 : FNB,"Github Inc. 48.90 GITHUB, INC. 4XXXXX*5225 04 APR XXXXXXXXXXXXXXXXXXX0239 Github Inc.",Account Payment,"Github Inc. 48.90 GITHUB, INC. 4XXXXX*5225 04 APR XXXXXXXXXXXXXXXXXXX0239 Github Inc.",949.24,,705562.79,AccountTransactionsReport.csv,210,2025-04,False,Development Tools,Development Tools,Development Tools
,2025-04-08,8400/000 : FNB,3.60 GETADDRESS.IO 4XX*5225 07 APR XX0033 3.60 GETADDRESS.IO 4XXXXX*5225 07 APR XXXXXXXXXXXXXXXXXXX0,Account Payment,3.60 GETADDRESS.IO 4XX*5225 07 APR XX0033 3.60 GETADDRESS.IO 4XXXXX*5225 07 APR XXXXXXXXXXXXXXXXXXX,91.65,,705654.44,AccountTransactionsReport.csv,211,2025-04,False,Other Computer Services,Other Computer Services,Other Computer Services
,2025-04-08,8400/000 : FNB,Shopify 2558.98 SHOPIFY* 35 4XXXXX*5191 06 APR XXXXXXXXXXXXXXXXXXX1790 Shopify,Account Payment,Shopify 2558.98 SHOPIFY* 35 4XXXXX*5191 06 APR XXXXXXXXXXXXXXXXXXX1790 Shopify,50087.98,,755742.42,AccountTransactionsReport.csv,212,2025-04,False,E-commerce Platforms,E-commerce Platforms,E-commerce Platforms
,2025-04-08,8400/000 : FNB,40.00 VERCEL INC. 4XX*5225 06 APR XX1664 40.00 VERCEL INC. 4XXXXX*5225 06 APR XXXXXXXXXXXXXXXXXXX166,Account Payment,40.00 VERCEL INC. 4XX*5225 06 APR XX1664 40.00 VERCEL INC. 4XXXXX*5225 06 APR XXXXXXXXXXXXXXXXXXX16,782.93,,756525.35,AccountTransactionsReport.csv,213,2025-04,False,Cloud Services,Cloud Services,Cloud Services
,2025-04-08,8400/000 : FNB,20.00 VERCEL INC. 4XX*5225 06 APR XX3971 20.00 VERCEL INC. 4XXXXX*5225 06 APR XXXXXXXXXXXXXXXXXXX397,Account Payment,20.00 VERCEL INC. 4XX*5225 06 APR XX3971 20.00 VERCEL INC. 4XXXXX*5225 06 APR XXXXXXXXXXXXXXXXXXX39,391.47,,756916.82,AccountTransactionsReport.csv,214,2025-04,False,Cloud Services,Cloud Services,Cloud Services
,2025-04-08,8400/000 : FNB,Woocommerce 19.99 WOOCOMMERCE S 4XXXXX*5225 06 APR XXXXXXXXXXXXXXXXXXX1039 Woocommerce,Account Payment,Woocommerce 19.99 WOOCOMMERCE S 4XXXXX*5225 06 APR XXXXXXXXXXXXXXXXXXX1039 Woocommerce,391.27,,757308.09,AccountTransactionsReport.csv,215,2025-04,False,Other Computer Services,Other Computer Services,Other Computer Services
,2025-04-09,8400/000 : FNB,"105.00 NOTION LABS, 4XX*5225 07 APR XX1970 105.00 NOTION LABS, 4XXXXX*5225 07 APR XXXXXXXXXXXXXXXXXX",Account Payment,"105.00 NOTION LABS, 4XX*5225 07 APR XX1970 105.00 NOTION LABS, 4XXXXX*5225 07 APR XXXXXXXXXXXXXXXXX",2055.21,,759363.3,AccountTransactionsReport.csv,216,2025-04,False,Other Computer Services,Collaboration Tools,Collaboration Tools
,2025-04-10,8400/000 : FNB,399.99 POE.COM 4XX*5191 09 APR XX6712 399.99 POE.COM 4XXXXX*5191 09 APR XXXXXXXXXXXXXXXXXXX6712,Account Payment,399.99 POE.COM 4XX*5191 09 APR XX6712 399.99 POE.COM 4XXXXX*5191 09 APR XXXXXXXXXXXXXXXXXXX6712,399.99,,759763.29,AccountTransactionsReport.csv,217,2025-04,False,Other Computer Services,Other Computer Services,Other Computer Services
,2025-04-10,8400/000 : FNB,"25.00 NOTION LABS, 4XX*5225 08 APR XX3159 25.00 NOTION LABS, 4XXXXX*5225 08 APR XXXXXXXXXXXXXXXXXXX3",Account Payment,"25.00 NOTION LABS, 4XX*5225 08 APR XX3159 25.00 NOTION LABS, 4XXXXX*5225 08 APR XXXXXXXXXXXXXXXXXXX",500.93,,760264.22,AccountTransactionsReport.csv,218,2025-04,False,Other Computer Services,Collaboration Tools,Collaboration Tools
,2025-04-10,8400/000 : FNB,99.00 CHATBASE 4XX*5191 09 APR XX1631 99.00 CHATBASE 4XXXXX*5191 09 APR XXXXXXXXXXXXXXXXXXX1631,Account Payment,99.00 CHATBASE 4XX*5191 09 APR XX1631 99.00 CHATBASE 4XXXXX*5191 09 APR XXXXXXXXXXXXXXXXXXX1631,1998.95,,762263.17,AccountTransactionsReport.csv,219,2025-04,False,Other Computer Services,Other Computer Services,Other Computer Services
,2025-04-10,8400/000 : FNB,Paddle 171.35 PADDLE.NET* 4XXXXX*5191 09 APR XXXXXXXXXXXXXXXXXXX5772 Paddle,Account Payment,Paddle 171.35 PADDLE.NET* 4XXXXX*5191 09 APR XXXXXXXXXXXXXXXXXXX5772 Paddle,3459.79,,765722.96,AccountTransactionsReport.csv,220,2025-04,False,Other Computer Services,Subscription Management,Subscription Management
,2025-04-10,8400/000 : FNB,599.00 TRIPLE WHALE 4XX*5191 09 APR XX0816 599.00 TRIPLE WHALE 4XXXXX*5191 09 APR XXXXXXXXXXXXXXXXXX,Account Payment,599.00 TRIPLE WHALE 4XX*5191 09 APR XX0816 599.00 TRIPLE WHALE 4XXXXX*5191 09 APR XXXXXXXXXXXXXXXXX,12094.61,,777817.57,AccountTransactionsReport.csv,221,2025-04,False,Other Computer Services,Other Computer Services,Other Computer Services
,2025-04-11,8400/000 : FNB,920.00 AUTH0.COM 4XX*5191 09 APR XX0119 920.00 AUTH0.COM 4XXXXX*5191 09 APR XXXXXXXXXXXXXXXXXXX0119,Account Payment,920.00 AUTH0.COM 4XX*5191 09 APR XX0119 920.00 AUTH0.COM 4XXXXX*5191 09 APR XXXXXXXXXXXXXXXXXXX0119,18576.04,,796393.61,AccountTransactionsReport.csv,222,2025-04,False,Security Services,Security Services,Security Services
,2025-04-11,8400/000 : FNB,499.00 CASSIDYAI.CO 4XX*5191 09 APR XX6408 499.00 CASSIDYAI.CO 4XXXXX*5191 09 APR XXXXXXXXXXXXXXXXXX,Account Payment,499.00 CASSIDYAI.CO 4XX*5191 09 APR XX6408 499.00 CASSIDYAI.CO 4XXXXX*5191 09 APR XXXXXXXXXXXXXXXXX,10075.48,,806469.09,AccountTransactionsReport.csv,223,2025-04,False,Other Computer Services,Other Computer Services,Other Computer Services
,2025-04-11,8400/000 : FNB,Stable 249.00 STABLE 4XXXXX*5191 09 APR XXXXXXXXXXXXXXXXXXX0035 Stable,Account Payment,Stable 249.00 STABLE 4XXXXX*5191 09 APR XXXXXXXXXXXXXXXXXXX0035 Stable,5027.64,,811496.73,AccountTransactionsReport.csv,224,2025-04,False,Other Computer Services,Other Computer Services,Other Computer Services
,2025-04-11,8400/000 : FNB,ManageWP 120.75 MANAGEWP 4XXXXX*5225 05 APR XXXXXXXXXXXXXXXXXXX2108 ManageWP,Account Payment,ManageWP 120.75 MANAGEWP 4XXXXX*5225 05 APR XXXXXXXXXXXXXXXXXXX2108 ManageWP,2363.49,,813860.22,AccountTransactionsReport.csv,225,2025-04,False,Other Computer Services,Other Computer Services,Other Computer Services
,2025-04-11,8400/000 : FNB,ManageWP 120.75 MANAGEWP 4XXXXX*5225 05 APR XXXXXXXXXXXXXXXXXXX6131 ManageWP,Account Payment,ManageWP 120.75 MANAGEWP 4XXXXX*5225 05 APR XXXXXXXXXXXXXXXXXXX6131 ManageWP,2363.49,,816223.71,AccountTransactionsReport.csv,226,2025-04,False,Other Computer Services,Other Computer Services,Other Computer Services
,2025-04-11,8400/000 : FNB,"70.00 NOTION LABS, 4XX*5191 10 APR XX9065 70.00 NOTION LABS, 4XXXXX*5191 10 APR XXXXXXXXXXXXXXXXXXX9",Account Payment,"70.00 NOTION LABS, 4XX*5191 10 APR XX9065 70.00 NOTION LABS, 4XXXXX*5191 10 APR XXXXXXXXXXXXXXXXXXX",1415.12,,817638.83,AccountTransactionsReport.csv,227,2025-04,False,Other Computer Services,Collaboration Tools,Collaboration Tools
,2025-04-11,8400/000 : FNB,60.00 INSOMNIA TEAM 4XX*5191 09 APR XX6479 60.00 INSOMNIA TEAM 4XXXXX*5191 09 APR XXXXXXXXXXXXXXXXXX,Account Payment,60.00 INSOMNIA TEAM 4XX*5191 09 APR XX6479 60.00 INSOMNIA TEAM 4XXXXX*5191 09 APR XXXXXXXXXXXXXXXXX,1212.95,,818851.78,AccountTransactionsReport.csv,228,2025-04,False,Other Computer Services,Other Computer Services,Other Computer Services
,2025-04-11,8400/000 : FNB,49.00 SKRAPP.IO STA 4XX*5191 09 APR XX3718 49.00 SKRAPP.IO STA 4XXXXX*5191 09 APR XXXXXXXXXXXXXXXXXX,Account Payment,49.00 SKRAPP.IO STA 4XX*5191 09 APR XX3718 49.00 SKRAPP.IO STA 4XXXXX*5191 09 APR XXXXXXXXXXXXXXXXX,989.38,,819841.16,AccountTransactionsReport.csv,229,2025-04,False,Other Computer Services,Other Computer Services,Other Computer Services
,2025-04-11,8400/000 : FNB,"46.67 REPLIT, INC. 4XX*5191 09 APR XX2115 46.67 REPLIT, INC. 4XXXXX*5191 09 APR XXXXXXXXXXXXXXXXXXX2",Account Payment,"46.67 REPLIT, INC. 4XX*5191 09 APR XX2115 46.67 REPLIT, INC. 4XXXXX*5191 09 APR XXXXXXXXXXXXXXXXXXX",942.33,,820783.49,AccountTransactionsReport.csv,230,2025-04,False,Other Computer Services,Other Computer Services,Other Computer Services
,2025-04-11,8400/000 : FNB,"40.00 REPLIT, INC. 4XX*5191 09 APR XX9314 40.00 REPLIT, INC. 4XXXXX*5191 09 APR XXXXXXXXXXXXXXXXXXX9",Account Payment,"40.00 REPLIT, INC. 4XX*5191 09 APR XX9314 40.00 REPLIT, INC. 4XXXXX*5191 09 APR XXXXXXXXXXXXXXXXXXX",807.66,,821591.15,AccountTransactionsReport.csv,231,2025-04,False,Other Computer Services,Other Computer Services,Other Computer Services
,2025-04-11,8400/000 : FNB,30.00 ISHRAQ LLC 4XX*5191 09 APR XX2578 30.00 ISHRAQ LLC 4XXXXX*5191 09 APR XXXXXXXXXXXXXXXXXXX2578,Account Payment,30.00 ISHRAQ LLC 4XX*5191 09 APR XX2578 30.00 ISHRAQ LLC 4XXXXX*5191 09 APR XXXXXXXXXXXXXXXXXXX2578,605.74,,822196.89,AccountTransactionsReport.csv,232,2025-04,False,Other Computer Services,Other Computer Services,Other Computer Services
,2025-04-11,8400/000 : FNB,12.00 CODESANDBOX 4XX*5191 10 APR XX9018 12.00 CODESANDBOX 4XXXXX*5191 10 APR XXXXXXXXXXXXXXXXXXX901,Account Payment,12.00 CODESANDBOX 4XX*5191 10 APR XX9018 12.00 CODESANDBOX 4XXXXX*5191 10 APR XXXXXXXXXXXXXXXXXXX90,242.59,,822439.48,AccountTransactionsReport.csv,233,2025-04,False,Other Computer Services,Other Computer Services,Other Computer Services
,2025-04-11,8400/000 : FNB,Paddle 187.94 PADDLE.NET* 4XXXXX*5191 05 APR XXXXXXXXXXXXXXXXXXX2072 Paddle,Account Payment,Paddle 187.94 PADDLE.NET* 4XXXXX*5191 05 APR XXXXXXXXXXXXXXXXXXX2072 Paddle,187.94,,822627.42,AccountTransactionsReport.csv,234,2025-04,False,Other Computer Services,Subscription Management,Subscription Management
,2025-04-11,8400/000 : FNB,7.00 CHATBASE 4XX*5191 10 APR XX5320 7.00 CHATBASE 4XXXXX*5191 10 APR XXXXXXXXXXXXXXXXXXX5320,Account Payment,7.00 CHATBASE 4XX*5191 10 APR XX5320 7.00 CHATBASE 4XXXXX*5191 10 APR XXXXXXXXXXXXXXXXXXX5320,141.51,,822768.93,AccountTransactionsReport.csv,235,2025-04,False,Other Computer Services,Other Computer Services,Other Computer Services
,2025-04-11,8400/000 : FNB,Google 34.99 Google One 4XXXXX*5191 09 APR XXXXXXXXXXXXXXXXXXX2068 Google,Account Payment,Google 34.99 Google One 4XXXXX*5191 09 APR XXXXXXXXXXXXXXXXXXX2068 Google,34.99,,822803.92,AccountTransactionsReport.csv,236,2025-04,False,Other Computer Services,Analytics & Monitoring,Analytics & Monitoring
,2025-04-11,8400/000 : FNB,25.00 BEECEPTOR 4XX*5191 09 APR XX0012 25.00 BEECEPTOR 4XXXXX*5191 09 APR XXXXXXXXXXXXXXXXXXX0012,Account Payment,25.00 BEECEPTOR 4XX*5191 09 APR XX0012 25.00 BEECEPTOR 4XXXXX*5191 09 APR XXXXXXXXXXXXXXXXXXX0012,504.79,,823308.71,AccountTransactionsReport.csv,237,2025-04,False,Other Computer Services,Other Computer Services,Other Computer Services
,2025-04-11,8400/000 : FNB,25.00 BEECEPTOR 4XX*5191 09 APR XX0024 25.00 BEECEPTOR 4XXXXX*5191 09 APR XXXXXXXXXXXXXXXXXXX0024,Account Payment,25.00 BEECEPTOR 4XX*5191 09 APR XX0024 25.00 BEECEPTOR 4XXXXX*5191 09 APR XXXXXXXXXXXXXXXXXXX0024,504.79,,823813.5,AccountTransactionsReport.csv,238,2025-04,False,Other Computer Services,Other Computer Services,Other Computer Services
,2025-04-11,8400/000 : FNB,21.56 SLACK T0740DV 4XX*5191 10 APR XX8597 21.56 SLACK T0740DV 4XXXXX*5191 10 APR XXXXXXXXXXXXXXXXXX,Account Payment,21.56 SLACK T0740DV 4XX*5191 10 APR XX8597 21.56 SLACK T0740DV 4XXXXX*5191 10 APR XXXXXXXXXXXXXXXXX,435.86,,824249.36,AccountTransactionsReport.csv,239,2025-04,False,Communication,Communication,Communication
,2025-04-11,8400/000 : FNB,Google Play 434.99 Google Perpl 4XXXXX*5191 10 APR XXXXXXXXXXXXXXXXXXX0049 Google Play,Account Payment,Google Play 434.99 Google Perpl 4XXXXX*5191 10 APR XXXXXXXXXXXXXXXXXXX0049 Google Play,434.99,,824684.35,AccountTransactionsReport.csv,240,2025-04,False,Other Computer Services,Analytics & Monitoring,Analytics & Monitoring
,2025-04-11,8400/000 : FNB,20.00 VERCEL INC. 4XX*5191 09 APR XX2884 20.00 VERCEL INC. 4XXXXX*5191 09 APR XXXXXXXXXXXXXXXXXXX288,Account Payment,20.00 VERCEL INC. 4XX*5191 09 APR XX2884 20.00 VERCEL INC. 4XXXXX*5191 09 APR XXXXXXXXXXXXXXXXXXX28,403.83,,825088.18,AccountTransactionsReport.csv,241,2025-04,False,Cloud Services,Cloud Services,Cloud Services
,2025-04-12,8400/000 : FNB,99.00 DYNAMIC.XYZ 4XX*5191 11 APR XX7007 99.00 DYNAMIC.XYZ 4XXXXX*5191 11 APR XXXXXXXXXXXXXXXXXXX700,Account Payment,99.00 DYNAMIC.XYZ 4XX*5191 11 APR XX7007 99.00 DYNAMIC.XYZ 4XXXXX*5191 11 APR XXXXXXXXXXXXXXXXXXX70,1981.67,,827069.85,AccountTransactionsReport.csv,242,2025-04,False,Other Computer Services,Other Computer Services,Other Computer Services
,2025-04-12,8400/000 : FNB,99.00 DMNS.APP BUSI 4XX*5191 11 APR XX7265 99.00 DMNS.APP BUSI 4XXXXX*5191 11 APR XXXXXXXXXXXXXXXXXX,Account Payment,99.00 DMNS.APP BUSI 4XX*5191 11 APR XX7265 99.00 DMNS.APP BUSI 4XXXXX*5191 11 APR XXXXXXXXXXXXXXXXX,1981.67,,829051.52,AccountTransactionsReport.csv,243,2025-04,False,Other Computer Services,Other Computer Services,Other Computer Services
,2025-04-12,8400/000 : FNB,Shopify 74.75 SHOPIFY* 3522 4XXXXX*5225 10 APR XXXXXXXXXXXXXXXXXXX0590 Shopify,Account Payment,Shopify 74.75 SHOPIFY* 3522 4XXXXX*5225 10 APR XXXXXXXXXXXXXXXXXXX0590 Shopify,1511.14,,830562.66,AccountTransactionsReport.csv,244,2025-04,False,E-commerce Platforms,E-commerce Platforms,E-commerce Platforms
,2025-04-12,8400/000 : FNB,72.00 TERMIUS CORPO 4XX*5191 10 APR XX7687 72.00 TERMIUS CORPO 4XXXXX*5191 10 APR XXXXXXXXXXXXXXXXXX,Account Payment,72.00 TERMIUS CORPO 4XX*5191 10 APR XX7687 72.00 TERMIUS CORPO 4XXXXX*5191 10 APR XXXXXXXXXXXXXXXXX,1455.55,,832018.21,AccountTransactionsReport.csv,245,2025-04,False,Other Computer Services,Other Computer Services,Other Computer Services
,2025-04-12,8400/000 : FNB,49.91 FRAPPE CLOUD 4XX*5191 11 APR XX0011 49.91 FRAPPE CLOUD 4XXXXX*5191 11 APR XXXXXXXXXXXXXXXXXXX0,Account Payment,49.91 FRAPPE CLOUD 4XX*5191 11 APR XX0011 49.91 FRAPPE CLOUD 4XXXXX*5191 11 APR XXXXXXXXXXXXXXXXXXX,999.04,,833017.25,AccountTransactionsReport.csv,246,2025-04,False,Other Computer Services,Other Computer Services,Other Computer Services
,2025-04-12,8400/000 : FNB,32.00 BUBBLE STARTE 4XX*5191 11 APR XX7313 32.00 BUBBLE STARTE 4XXXXX*5191 11 APR XXXXXXXXXXXXXXXXXX,Account Payment,32.00 BUBBLE STARTE 4XX*5191 11 APR XX7313 32.00 BUBBLE STARTE 4XXXXX*5191 11 APR XXXXXXXXXXXXXXXXX,640.54,,833657.79,AccountTransactionsReport.csv,247,2025-04,False,Other Computer Services,Other Computer Services,Other Computer Services
,2025-04-12,8400/000 : FNB,224.99 Google Chara 4XX*5191 10 APR XX3020 224.99 Google Chara 4XXXXX*5191 10 APR XXXXXXXXXXXXXXXXXX,Account Payment,224.99 Google Chara 4XX*5191 10 APR XX3020 224.99 Google Chara 4XXXXX*5191 10 APR XXXXXXXXXXXXXXXXX,224.99,,833882.78,AccountTransactionsReport.csv,248,2025-04,False,Other Computer Services,Analytics & Monitoring,Analytics & Monitoring
,2025-04-12,8400/000 : FNB,"7.00 NPM, INC. 4XX*5191 11 APR XX6938 7.00 NPM, INC. 4XXXXX*5191 11 APR XXXXXXXXXXXXXXXXXXX6938",Account Payment,"7.00 NPM, INC. 4XX*5191 11 APR XX6938 7.00 NPM, INC. 4XXXXX*5191 11 APR XXXXXXXXXXXXXXXXXXX6938",140.12,,834022.9,AccountTransactionsReport.csv,249,2025-04,False,Other Computer Services,Other Computer Services,Other Computer Services
,2025-04-12,8400/000 : FNB,"7.00 NPM, INC. 4XX*5191 11 APR XX9574 7.00 NPM, INC. 4XXXXX*5191 11 APR XXXXXXXXXXXXXXXXXXX9574",Account Payment,"7.00 NPM, INC. 4XX*5191 11 APR XX9574 7.00 NPM, INC. 4XXXXX*5191 11 APR XXXXXXXXXXXXXXXXXXX9574",140.12,,834163.02,AccountTransactionsReport.csv,250,2025-04,False,Other Computer Services,Other Computer Services,Other Computer Services
,2025-04-12,8400/000 : FNB,"7.00 NPM, INC. 4XX*5191 11 APR XX6750 7.00 NPM, INC. 4XXXXX*5191 11 APR XXXXXXXXXXXXXXXXXXX6750",Account Payment,"7.00 NPM, INC. 4XX*5191 11 APR XX6750 7.00 NPM, INC. 4XXXXX*5191 11 APR XXXXXXXXXXXXXXXXXXX6750",140.12,,834303.14,AccountTransactionsReport.csv,251,2025-04,False,Other Computer Services,Other Computer Services,Other Computer Services
,2025-04-12,8400/000 : FNB,"7.00 NPM, INC. 4XX*5191 11 APR XX4575 7.00 NPM, INC. 4XXXXX*5191 11 APR XXXXXXXXXXXXXXXXXXX4575",Account Payment,"7.00 NPM, INC. 4XX*5191 11 APR XX4575 7.00 NPM, INC. 4XXXXX*5191 11 APR XXXXXXXXXXXXXXXXXXX4575",140.12,,834443.26,AccountTransactionsReport.csv,252,2025-04,False,Other Computer Services,Other Computer Services,Other Computer Services
,2025-04-12,8400/000 : FNB,Shopify 3633.95 SHOPIFY* 35 4XXXXX*5225 10 APR XXXXXXXXXXXXXXXXXXX4740 Shopify,Account Payment,Shopify 3633.95 SHOPIFY* 35 4XXXXX*5225 10 APR XXXXXXXXXXXXXXXXXXX4740 Shopify,73463.77,,907907.03,AccountTransactionsReport.csv,253,2025-04,False,E-commerce Platforms,E-commerce Platforms,E-commerce Platforms
,2025-04-12,8400/000 : FNB,179.00 MOZSEO:HELP@ 4XX*5191 10 APR XX6069 179.00 MOZSEO:HELP@ 4XXXXX*5191 10 APR XXXXXXXXXXXXXXXXXX,Account Payment,179.00 MOZSEO:HELP@ 4XX*5191 10 APR XX6069 179.00 MOZSEO:HELP@ 4XXXXX*5191 10 APR XXXXXXXXXXXXXXXXX,3618.65,,911525.68,AccountTransactionsReport.csv,254,2025-04,False,Other Computer Services,Other Computer Services,Other Computer Services
,2025-04-12,8400/000 : FNB,150.00 AUTH0.COM 4XX*5191 10 APR XX9515 150.00 AUTH0.COM 4XXXXX*5191 10 APR XXXXXXXXXXXXXXXXXXX9515,Account Payment,150.00 AUTH0.COM 4XX*5191 10 APR XX9515 150.00 AUTH0.COM 4XXXXX*5191 10 APR XXXXXXXXXXXXXXXXXXX9515,3032.39,,914558.07,AccountTransactionsReport.csv,255,2025-04,False,Security Services,Security Services,Security Services
,2025-04-12,8400/000 : FNB,99.99 JINA.AI 4XX*5191 11 APR XX9360 99.99 JINA.AI 4XXXXX*5191 11 APR XXXXXXXXXXXXXXXXXXX9360,Account Payment,99.99 JINA.AI 4XX*5191 11 APR XX9360 99.99 JINA.AI 4XXXXX*5191 11 APR XXXXXXXXXXXXXXXXXXX9360,2001.48,,916559.55,AccountTransactionsReport.csv,256,2025-04,False,Other Computer Services,Other Computer Services,Other Computer Services
,2025-04-14,8400/000 : FNB,1104.00 SQSP* INV17 4XX*5191 11 APR XX3470 1104.00 SQSP* INV17 4XXXXX*5191 11 APR XXXXXXXXXXXXXXXXXX,Account Payment,1104.00 SQSP* INV17 4XX*5191 11 APR XX3470 1104.00 SQSP* INV17 4XXXXX*5191 11 APR XXXXXXXXXXXXXXXXX,1104.0,,917663.55,AccountTransactionsReport.csv,257,2025-04,False,Other Computer Services,Other Computer Services,Other Computer Services
,2025-04-14,8400/000 : FNB,430.00 Dlocal *Micr 4XX*5191 11 APR XX5528 430.00 Dlocal *Micr 4XXXXX*5191 11 APR XXXXXXXXXXXXXXXXXX,Account Payment,430.00 Dlocal *Micr 4XX*5191 11 APR XX5528 430.00 Dlocal *Micr 4XXXXX*5191 11 APR XXXXXXXXXXXXXXXXX,430.0,,918093.55,AccountTransactionsReport.csv,258,2025-04,False,Other Computer Services,Other Computer Services,Other Computer Services
,2025-04-14,8400/000 : FNB,9.00 TWENTY.COM 4XX*5191 11 APR XX4060 9.00 TWENTY.COM 4XXXXX*5191 11 APR XXXXXXXXXXXXXXXXXXX4060,Account Payment,9.00 TWENTY.COM 4XX*5191 11 APR XX4060 9.00 TWENTY.COM 4XXXXX*5191 11 APR XXXXXXXXXXXXXXXXXXX4060,180.15,,918273.7,AccountTransactionsReport.csv,259,2025-04,False,Other Computer Services,Other Computer Services,Other Computer Services
,2025-04-14,8400/000 : FNB,"Github Inc. 210.00 GITHUB, INC. 4XXXXX*5225 11 APR XXXXXXXXXXXXXXXXXXX7308 Github Inc.",Account Payment,"Github Inc. 210.00 GITHUB, INC. 4XXXXX*5225 11 APR XXXXXXXXXXXXXXXXXXX7308 Github Inc.",4203.54,,922477.24,AccountTransactionsReport.csv,260,2025-04,False,Development Tools,Development Tools,Development Tools
,2025-04-14,8400/000 : FNB,"Github Inc. 67.18 GITHUB, INC. 4XXXXX*5191 11 APR XXXXXXXXXXXXXXXXXXX2885 Github Inc.",Account Payment,"Github Inc. 67.18 GITHUB, INC. 4XXXXX*5191 11 APR XXXXXXXXXXXXXXXXXXX2885 Github Inc.",1344.74,,923821.98,AccountTransactionsReport.csv,261,2025-04,False,Development Tools,Development Tools,Development Tools
,2025-04-14,8400/000 : FNB,"Github Inc. 42.00 GITHUB, INC. 4XXXXX*5191 11 APR XXXXXXXXXXXXXXXXXXX7698 Github Inc.",Account Payment,"Github Inc. 42.00 GITHUB, INC. 4XXXXX*5191 11 APR XXXXXXXXXXXXXXXXXXX7698 Github Inc.",840.7,,924662.68,AccountTransactionsReport.csv,262,2025-04,False,Development Tools,Development Tools,Development Tools
,2025-04-15,8400/000 : FNB,9.00 GITPOD.IO 4XX*5191 12 APR XX8368 9.00 GITPOD.IO 4XXXXX*5191 12 APR XXXXXXXXXXXXXXXXXXX8368,Account Payment,9.00 GITPOD.IO 4XX*5191 12 APR XX8368 9.00 GITPOD.IO 4XXXXX*5191 12 APR XXXXXXXXXXXXXXXXXXX8368,179.31,,924841.99,AccountTransactionsReport.csv,263,2025-04,False,Development Tools,Development Tools,Development Tools
,2025-04-15,8400/000 : FNB,11.49 GOOGLE *Colab 4XX*5191 14 APR XX8863 11.49 GOOGLE *Colab 4XXXXX*5191 14 APR XXXXXXXXXXXXXXXXXX,Account Payment,11.49 GOOGLE *Colab 4XX*5191 14 APR XX8863 11.49 GOOGLE *Colab 4XXXXX*5191 14 APR XXXXXXXXXXXXXXXXX,228.92,,925070.91,AccountTransactionsReport.csv,264,2025-04,False,Other Computer Services,Analytics & Monitoring,Analytics & Monitoring
,2025-04-15,8400/000 : FNB,15.00 TABNINE 4XX*5191 12 APR XX2448 15.00 TABNINE 4XXXXX*5191 12 APR XXXXXXXXXXXXXXXXXXX2448,Account Payment,15.00 TABNINE 4XX*5191 12 APR XX2448 15.00 TABNINE 4XXXXX*5191 12 APR XXXXXXXXXXXXXXXXXXX2448,298.85,,925369.76,AccountTransactionsReport.csv,265,2025-04,False,Other Computer Services,Other Computer Services,Other Computer Services
,2025-04-15,8400/000 : FNB,Hightail 15.00 HIGHTAIL 4XXXXX*5191 13 APR XXXXXXXXXXXXXXXXXXX0413 Hightail,Account Payment,Hightail 15.00 HIGHTAIL 4XXXXX*5191 13 APR XXXXXXXXXXXXXXXXXXX0413 Hightail,298.85,,925668.61,AccountTransactionsReport.csv,266,2025-04,False,Other Computer Services,Other Computer Services,Other Computer Services
,2025-04-15,8400/000 : FNB,20.00 HUGGINGFACE 4XX*5191 12 APR XX1733 20.00 HUGGINGFACE 4XXXXX*5191 12 APR XXXXXXXXXXXXXXXXXXX173,Account Payment,20.00 HUGGINGFACE 4XX*5191 12 APR XX1733 20.00 HUGGINGFACE 4XXXXX*5191 12 APR XXXXXXXXXXXXXXXXXXX17,398.46,,926067.07,AccountTransactionsReport.csv,267,2025-04,False,AI Services,AI Services,AI Services
,2025-04-15,8400/000 : FNB,29.09 RAILWAY 4XX*5191 13 APR XX7403 29.09 RAILWAY 4XXXXX*5191 13 APR XXXXXXXXXXXXXXXXXXX7403,Account Payment,29.09 RAILWAY 4XX*5191 13 APR XX7403 29.09 RAILWAY 4XXXXX*5191 13 APR XXXXXXXXXXXXXXXXXXX7403,579.56,,926646.63,AccountTransactionsReport.csv,268,2025-04,False,Other Computer Services,Other Computer Services,Other Computer Services
,2025-04-15,8400/000 : FNB,54.98 PADDLE.NET* W 4XX*5191 14 APR XX1459 54.98 PADDLE.NET* W 4XXXXX*5191 14 APR XXXXXXXXXXXXXXXXXX,Account Payment,54.98 PADDLE.NET* W 4XX*5191 14 APR XX1459 54.98 PADDLE.NET* W 4XXXXX*5191 14 APR XXXXXXXXXXXXXXXXX,1095.38,,927742.01,AccountTransactionsReport.csv,269,2025-04,False,Other Computer Services,Subscription Management,Subscription Management
,2025-04-15,8400/000 : FNB,67.85 LEMSQZY* CHAT 4XX*5191 13 APR XX0136 67.85 LEMSQZY* CHAT 4XXXXX*5191 13 APR XXXXXXXXXXXXXXXXXX,Account Payment,67.85 LEMSQZY* CHAT 4XX*5191 13 APR XX0136 67.85 LEMSQZY* CHAT 4XXXXX*5191 13 APR XXXXXXXXXXXXXXXXX,1351.79,,929093.8,AccountTransactionsReport.csv,270,2025-04,False,AI Services,AI Services,AI Services
,2025-04-15,8400/000 : FNB,174.00 INTERCOM R&D 4XX*5191 13 APR XX3868 174.00 INTERCOM R&D 4XXXXX*5191 13 APR XXXXXXXXXXXXXXXXXX,Account Payment,174.00 INTERCOM R&D 4XX*5191 13 APR XX3868 174.00 INTERCOM R&D 4XXXXX*5191 13 APR XXXXXXXXXXXXXXXXX,3466.63,,932560.43,AccountTransactionsReport.csv,271,2025-04,False,Other Computer Services,Customer Support,Customer Support
,2025-04-15,8400/000 : FNB,180.00 AGENCYANALYT 4XX*5225 13 APR XX6689 180.00 AGENCYANALYT 4XXXXX*5225 13 APR XXXXXXXXXXXXXXXXXX,Account Payment,180.00 AGENCYANALYT 4XX*5225 13 APR XX6689 180.00 AGENCYANALYT 4XXXXX*5225 13 APR XXXXXXXXXXXXXXXXX,3586.17,,936146.6,AccountTransactionsReport.csv,272,2025-04,False,Other Computer Services,Other Computer Services,Other Computer Services
,2025-04-15,8400/000 : FNB,5.00 WWW.FLUX.AI 4XX*5191 13 APR XX9483 5.00 WWW.FLUX.AI 4XXXXX*5191 13 APR XXXXXXXXXXXXXXXXXXX9483,Account Payment,5.00 WWW.FLUX.AI 4XX*5191 13 APR XX9483 5.00 WWW.FLUX.AI 4XXXXX*5191 13 APR XXXXXXXXXXXXXXXXXXX9483,99.61,,936246.21,AccountTransactionsReport.csv,273,2025-04,False,Other Computer Services,Other Computer Services,Other Computer Services
,2025-04-16,8400/000 : FNB,"47.45 REPLIT, INC. 4XX*5191 14 APR XX9172 47.45 REPLIT, INC. 4XXXXX*5191 14 APR XXXXXXXXXXXXXXXXXXX9",Account Payment,"47.45 REPLIT, INC. 4XX*5191 14 APR XX9172 47.45 REPLIT, INC. 4XXXXX*5191 14 APR XXXXXXXXXXXXXXXXXXX",945.36,,937191.57,AccountTransactionsReport.csv,274,2025-04,False,Other Computer Services,Other Computer Services,Other Computer Services
,2025-04-16,8400/000 : FNB,151.35 SLACK T0MN3D 4XX*5225 15 APR XX3502 151.35 SLACK T0MN3D 4XXXXX*5225 15 APR XXXXXXXXXXXXXXXXXX,Account Payment,151.35 SLACK T0MN3D 4XX*5225 15 APR XX3502 151.35 SLACK T0MN3D 4XXXXX*5225 15 APR XXXXXXXXXXXXXXXXX,2955.84,,940147.41,AccountTransactionsReport.csv,275,2025-04,False,Communication,Communication,Communication
,2025-04-16,8400/000 : FNB,280.00 WIZA.CO 4XX*5191 14 APR XX3347 280.00 WIZA.CO 4XXXXX*5191 14 APR XXXXXXXXXXXXXXXXXXX3347,Account Payment,280.00 WIZA.CO 4XX*5191 14 APR XX3347 280.00 WIZA.CO 4XXXXX*5191 14 APR XXXXXXXXXXXXXXXXXXX3347,5578.48,,945725.89,AccountTransactionsReport.csv,276,2025-04,False,Other Computer Services,Other Computer Services,Other Computer Services
,2025-04-16,8400/000 : FNB,"Github Inc. 14.00 GITHUB, INC. 4XXXXX*5225 14 APR XXXXXXXXXXXXXXXXXXX3015 Github Inc.",Account Payment,"Github Inc. 14.00 GITHUB, INC. 4XXXXX*5225 14 APR XXXXXXXXXXXXXXXXXXX3015 Github Inc.",278.93,,946004.82,AccountTransactionsReport.csv,277,2025-04,False,Development Tools,Development Tools,Development Tools
,2025-04-16,8400/000 : FNB,33.27 RAILWAY 4XX*5191 14 APR XX6376 33.27 RAILWAY 4XXXXX*5191 14 APR XXXXXXXXXXXXXXXXXXX6376,Account Payment,33.27 RAILWAY 4XX*5191 14 APR XX6376 33.27 RAILWAY 4XXXXX*5191 14 APR XXXXXXXXXXXXXXXXXXX6376,662.85,,946667.67,AccountTransactionsReport.csv,278,2025-04,False,Other Computer Services,Other Computer Services,Other Computer Services
,2025-04-17,8400/000 : FNB,Google 199.99 Google AppDa 4XXXXX*5191 15 APR XXXXXXXXXXXXXXXXXXX7031 Google,Account Payment,Google 199.99 Google AppDa 4XXXXX*5191 15 APR XXXXXXXXXXXXXXXXXXX7031 Google,199.99,,946867.66,AccountTransactionsReport.csv,279,2025-04,False,Other Computer Services,Analytics & Monitoring,Analytics & Monitoring
,2025-04-17,8400/000 : FNB,350.00 FRAMER.COM 4XX*5191 16 APR XX4544 350.00 FRAMER.COM 4XXXXX*5191 16 APR XXXXXXXXXXXXXXXXXXX454,Account Payment,350.00 FRAMER.COM 4XX*5191 16 APR XX4544 350.00 FRAMER.COM 4XXXXX*5191 16 APR XXXXXXXXXXXXXXXXXXX45,350.0,,947217.66,AccountTransactionsReport.csv,280,2025-04,False,Other Computer Services,Design Tools,Design Tools
,2025-04-17,8400/000 : FNB,"Github Inc. 91.00 GITHUB, INC. 4XXXXX*5191 15 APR XXXXXXXXXXXXXXXXXXX1721 Github Inc.",Account Payment,"Github Inc. 91.00 GITHUB, INC. 4XXXXX*5191 15 APR XXXXXXXXXXXXXXXXXXX1721 Github Inc.",1777.22,,948994.88,AccountTransactionsReport.csv,281,2025-04,False,Development Tools,Development Tools,Development Tools
,2025-04-17,8400/000 : FNB,231.95 HOLASPIRIT 4XX*5225 15 APR XX9286 231.95 HOLASPIRIT 4XXXXX*5225 15 APR XXXXXXXXXXXXXXXXXXX928,Account Payment,231.95 HOLASPIRIT 4XX*5225 15 APR XX9286 231.95 HOLASPIRIT 4XXXXX*5225 15 APR XXXXXXXXXXXXXXXXXXX92,5152.32,,954147.2,AccountTransactionsReport.csv,282,2025-04,False,Other Computer Services,Other Computer Services,Other Computer Services
,2025-04-17,8400/000 : FNB,376.40 HOLASPIRIT 4XX*5225 15 APR XX3826 376.40 HOLASPIRIT 4XXXXX*5225 15 APR XXXXXXXXXXXXXXXXXXX382,Account Payment,376.40 HOLASPIRIT 4XX*5225 15 APR XX3826 376.40 HOLASPIRIT 4XXXXX*5225 15 APR XXXXXXXXXXXXXXXXXXX38,8360.98,,962508.18,AccountTransactionsReport.csv,283,2025-04,False,Other Computer Services,Other Computer Services,Other Computer Services
,2025-04-19,8400/000 : FNB,20.00 VERCEL INC. 4XX*5191 16 APR XX1645 20.00 VERCEL INC. 4XXXXX*5191 16 APR XXXXXXXXXXXXXXXXXXX164,Account Payment,20.00 VERCEL INC. 4XX*5191 16 APR XX1645 20.00 VERCEL INC. 4XXXXX*5191 16 APR XXXXXXXXXXXXXXXXXXX16,389.76,,962897.94,AccountTransactionsReport.csv,284,2025-04,False,Cloud Services,Cloud Services,Cloud Services
,2025-04-19,8400/000 : FNB,Facebook 1265.00 FACEBK *36H 4XXXXX*5191 17 APR XXXXXXXXXXXXXXXXXXX3072 Facebook,Account Payment,Facebook 1265.00 FACEBK *36H 4XXXXX*5191 17 APR XXXXXXXXXXXXXXXXXXX3072 Facebook,1265.0,,964162.94,AccountTransactionsReport.csv,285,2025-04,False,Marketing Tools,Marketing Tools,Marketing Tools
,2025-04-22,8400/000 : FNB,374.00 MANGOAPPS 4XX*5191 20 APR XX7388 374.00 MANGOAPPS 4XXXXX*5191 20 APR XXXXXXXXXXXXXXXXXXX7388,Account Payment,374.00 MANGOAPPS 4XX*5191 20 APR XX7388 374.00 MANGOAPPS 4XXXXX*5191 20 APR XXXXXXXXXXXXXXXXXXX7388,7211.49,,971374.43,AccountTransactionsReport.csv,286,2025-04,False,Other Computer Services,Other Computer Services,Other Computer Services
,2025-04-22,8400/000 : FNB,20.00 HUGGINGFACE 4XX*5191 20 APR XX8924 20.00 HUGGINGFACE 4XXXXX*5191 20 APR XXXXXXXXXXXXXXXXXXX892,Account Payment,20.00 HUGGINGFACE 4XX*5191 20 APR XX8924 20.00 HUGGINGFACE 4XXXXX*5191 20 APR XXXXXXXXXXXXXXXXXXX89,385.64,,971760.07,AccountTransactionsReport.csv,287,2025-04,False,AI Services,AI Services,AI Services
,2025-04-22,8400/000 : FNB,"50.01 REPLIT, INC. 4XX*5191 19 APR XX6133 50.01 REPLIT, INC. 4XXXXX*5191 19 APR XXXXXXXXXXXXXXXXXXX6",Account Payment,"50.01 REPLIT, INC. 4XX*5191 19 APR XX6133 50.01 REPLIT, INC. 4XXXXX*5191 19 APR XXXXXXXXXXXXXXXXXXX",964.3,,972724.37,AccountTransactionsReport.csv,288,2025-04,False,Other Computer Services,Other Computer Services,Other Computer Services
,2025-04-22,8400/000 : FNB,50.15 LINODE . AKAM 4XX*5191 20 APR XX2060 50.15 LINODE . AKAM 4XXXXX*5191 20 APR XXXXXXXXXXXXXXXXXX,Account Payment,50.15 LINODE . AKAM 4XX*5191 20 APR XX2060 50.15 LINODE . AKAM 4XXXXX*5191 20 APR XXXXXXXXXXXXXXXXX,966.99,,973691.36,AccountTransactionsReport.csv,289,2025-04,False,Cloud Services,Cloud Services,Cloud Services
,2025-04-22,8400/000 : FNB,54.00 AIRTABLE.COM/ 4XX*5191 21 APR XX7919 54.00 AIRTABLE.COM/ 4XXXXX*5191 21 APR XXXXXXXXXXXXXXXXXX,Account Payment,54.00 AIRTABLE.COM/ 4XX*5191 21 APR XX7919 54.00 AIRTABLE.COM/ 4XXXXX*5191 21 APR XXXXXXXXXXXXXXXXX,1041.24,,974732.6,AccountTransactionsReport.csv,290,2025-04,False,Other Computer Services,Collaboration Tools,Collaboration Tools
,2025-04-22,8400/000 : FNB,59.00 GREENBACK.COM 4XX*5225 19 APR XX2616 59.00 GREENBACK.COM 4XXXXX*5225 19 APR XXXXXXXXXXXXXXXXXX,Account Payment,59.00 GREENBACK.COM 4XX*5225 19 APR XX2616 59.00 GREENBACK.COM 4XXXXX*5225 19 APR XXXXXXXXXXXXXXXXX,1137.65,,975870.25,AccountTransactionsReport.csv,291,2025-04,False,Other Computer Services,Other Computer Services,Other Computer Services
,2025-04-22,8400/000 : FNB,"74.00 PIPEDREAM, IN 4XX*5191 20 APR XX2751 74.00 PIPEDREAM, IN 4XXXXX*5191 20 APR XXXXXXXXXXXXXXXXXX",Account Payment,"74.00 PIPEDREAM, IN 4XX*5191 20 APR XX2751 74.00 PIPEDREAM, IN 4XXXXX*5191 20 APR XXXXXXXXXXXXXXXXX",1426.87,,977297.12,AccountTransactionsReport.csv,292,2025-04,False,Other Computer Services,Other Computer Services,Other Computer Services
,2025-04-24,8400/000 : FNB,299.00 ORG CHART 4XX*5191 22 APR XX4935 299.00 ORG CHART 4XXXXX*5191 22 APR XXXXXXXXXXXXXXXXXXX4935,Account Payment,299.00 ORG CHART 4XX*5191 22 APR XX4935 299.00 ORG CHART 4XXXXX*5191 22 APR XXXXXXXXXXXXXXXXXXX4935,5751.77,,983048.89,AccountTransactionsReport.csv,293,2025-04,False,Other Computer Services,Other Computer Services,Other Computer Services
,2025-04-24,8400/000 : FNB,Google Service Charges/Fees #INT PYMT FEE-199.99 Goog Google,Account Payment,Google Service Charges/Fees INT PYMT FEE-199.99 Goog Google,4.0,,983052.89,AccountTransactionsReport.csv,294,2025-04,False,Other Computer Services,Analytics & Monitoring,Analytics & Monitoring
,2025-04-24,8400/000 : FNB,#INT PYMT FEE-570.40 INTU #INT PYMT FEE-570.40 INTU,Account Payment,INT PYMT FEE-570.40 INTU INT PYMT FEE-570.40 INTU,11.41,,983064.3,AccountTransactionsReport.csv,295,2025-04,False,Other Computer Services,Other Computer Services,Other Computer Services
,2025-04-25,8400/000 : FNB,"6.00 DOCKER, INC. 4XX*5191 24 APR XX9103 6.00 DOCKER, INC. 4XXXXX*5191 24 APR XXXXXXXXXXXXXXXXXXX910",Account Payment,"6.00 DOCKER, INC. 4XX*5191 24 APR XX9103 6.00 DOCKER, INC. 4XXXXX*5191 24 APR XXXXXXXXXXXXXXXXXXX91",114.57,,983178.87,AccountTransactionsReport.csv,296,2025-04,False,Other Computer Services,Other Computer Services,Other Computer Services
,2025-04-25,8400/000 : FNB,30.00 HASURA 4XX*5191 23 APR XX9485 30.00 HASURA 4XXXXX*5191 23 APR XXXXXXXXXXXXXXXXXXX9485,Account Payment,30.00 HASURA 4XX*5191 23 APR XX9485 30.00 HASURA 4XXXXX*5191 23 APR XXXXXXXXXXXXXXXXXXX9485,572.81,,983751.68,AccountTransactionsReport.csv,297,2025-04,False,Other Computer Services,Other Computer Services,Other Computer Services
,2025-04-25,8400/000 : FNB,89.00 SENTRY 4XX*5191 24 APR XX7038 89.00 SENTRY 4XXXXX*5191 24 APR XXXXXXXXXXXXXXXXXXX7038,Account Payment,89.00 SENTRY 4XX*5191 24 APR XX7038 89.00 SENTRY 4XXXXX*5191 24 APR XXXXXXXXXXXXXXXXXXX7038,1699.35,,985451.03,AccountTransactionsReport.csv,298,2025-04,False,Other Computer Services,Analytics & Monitoring,Analytics & Monitoring
,2025-04-26,8400/000 : FNB,10.00 MATTERMOST 4XX*5191 24 APR XX2646 10.00 MATTERMOST 4XXXXX*5191 24 APR XXXXXXXXXXXXXXXXXXX2646,Account Payment,10.00 MATTERMOST 4XX*5191 24 APR XX2646 10.00 MATTERMOST 4XXXXX*5191 24 APR XXXXXXXXXXXXXXXXXXX2646,190.93,,985641.96,AccountTransactionsReport.csv,299,2025-04,False,Other Computer Services,Other Computer Services,Other Computer Services
,2025-04-26,8400/000 : FNB,15.00 WINDSURF 4XX*5191 24 APR XX1008 15.00 WINDSURF 4XXXXX*5191 24 APR XXXXXXXXXXXXXXXXXXX1008,Account Payment,15.00 WINDSURF 4XX*5191 24 APR XX1008 15.00 WINDSURF 4XXXXX*5191 24 APR XXXXXXXXXXXXXXXXXXX1008,288.55,,985930.51,AccountTransactionsReport.csv,300,2025-04,False,Other Computer Services,Other Computer Services,Other Computer Services
,2025-04-26,8400/000 : FNB,Dropbox 18.38 DROPBOX*W7M5N 4XXXXX*5191 24 APR XXXXXXXXXXXXXXXXXXX0200 Dropbox,Account Payment,Dropbox 18.38 DROPBOX*W7M5N 4XXXXX*5191 24 APR XXXXXXXXXXXXXXXXXXX0200 Dropbox,350.94,,986281.45,AccountTransactionsReport.csv,301,2025-04,False,Other Computer Services,Other Computer Services,Other Computer Services
,2025-04-29,8400/000 : FNB,499.00 CBA*CCLEANER 4XX*5191 28 APR XX8946 499.00 CBA*CCLEANER 4XXXXX*5191 28 APR XXXXXXXXXXXXXXXXXX,Account Payment,499.00 CBA*CCLEANER 4XX*5191 28 APR XX8946 499.00 CBA*CCLEANER 4XXXXX*5191 28 APR XXXXXXXXXXXXXXXXX,499.0,,986780.45,AccountTransactionsReport.csv,302,2025-04,False,Other Computer Services,Other Computer Services,Other Computer Services
,2025-04-29,8400/000 : FNB,399.99 POE.COM 4XX*5191 26 APR XX2349 399.99 POE.COM 4XXXXX*5191 26 APR XXXXXXXXXXXXXXXXXXX2349,Account Payment,399.99 POE.COM 4XX*5191 26 APR XX2349 399.99 POE.COM 4XXXXX*5191 26 APR XXXXXXXXXXXXXXXXXXX2349,399.99,,987180.44,AccountTransactionsReport.csv,303,2025-04,False,Other Computer Services,Other Computer Services,Other Computer Services
,2025-04-29,8400/000 : FNB,Facebook 585.90 FACEBK *4PQK 4XXXXX*5191 26 APR XXXXXXXXXXXXXXXXXXX2020 Facebook,Account Payment,Facebook 585.90 FACEBK *4PQK 4XXXXX*5191 26 APR XXXXXXXXXXXXXXXXXXX2020 Facebook,585.9,,987766.34,AccountTransactionsReport.csv,304,2025-04,False,Marketing Tools,Marketing Tools,Marketing Tools
,2025-04-29,8400/000 : FNB,50.00 ANACONDA INC. 4XX*5191 26 APR XX9561 50.00 ANACONDA INC. 4XXXXX*5191 26 APR XXXXXXXXXXXXXXXXXX,Account Payment,50.00 ANACONDA INC. 4XX*5191 26 APR XX9561 50.00 ANACONDA INC. 4XXXXX*5191 26 APR XXXXXXXXXXXXXXXXX,965.76,,988732.1,AccountTransactionsReport.csv,305,2025-04,False,Other Computer Services,Other Computer Services,Other Computer Services
,2025-04-29,8400/000 : FNB,150.00 AUTH0.COM 4XX*5191 25 APR XX4454 150.00 AUTH0.COM 4XXXXX*5191 25 APR XXXXXXXXXXXXXXXXXXX4454,Account Payment,150.00 AUTH0.COM 4XX*5191 25 APR XX4454 150.00 AUTH0.COM 4XXXXX*5191 25 APR XXXXXXXXXXXXXXXXXXX4454,2897.27,,991629.37,AccountTransactionsReport.csv,306,2025-04,False,Security Services,Security Services,Security Services
,2025-04-29,8400/000 : FNB,Wix.com 182.85 WIX.COM 4XXXXX*5191 28 APR XXXXXXXXXXXXXXXXXXX3969 Wix.com,Account Payment,Wix.com 182.85 WIX.COM 4XXXXX*5191 28 APR XXXXXXXXXXXXXXXXXXX3969 Wix.com,3531.77,,995161.14,AccountTransactionsReport.csv,307,2025-04,False,E-commerce Platforms,E-commerce Platforms,E-commerce Platforms
,2025-04-29,8400/000 : FNB,1150.00 AUTH0.COM 4XX*5191 26 APR XX1473 1150.00 AUTH0.COM 4XXXXX*5191 26 APR XXXXXXXXXXXXXXXXXXX147,Account Payment,1150.00 AUTH0.COM 4XX*5191 26 APR XX1473 1150.00 AUTH0.COM 4XXXXX*5191 26 APR XXXXXXXXXXXXXXXXXXX14,22212.38,,1017373.52,AccountTransactionsReport.csv,308,2025-04,False,Security Services,Security Services,Security Services
,2025-04-29,8400/000 : FNB,Shopify 3421.17 SHOPIFY* 35 4XXXXX*5191 27 APR XXXXXXXXXXXXXXXXXXX5362 Shopify,Account Payment,Shopify 3421.17 SHOPIFY* 35 4XXXXX*5191 27 APR XXXXXXXXXXXXXXXXXXX5362 Shopify,66080.27,,1083453.79,AccountTransactionsReport.csv,309,2025-04,False,E-commerce Platforms,E-commerce Platforms,E-commerce Platforms
,2025-04-30,8400/000 : FNB,9.00 GITPOD.IO 4XX*5191 28 APR XX3654 9.00 GITPOD.IO 4XXXXX*5191 28 APR XXXXXXXXXXXXXXXXXXX3654,Account Payment,9.00 GITPOD.IO 4XX*5191 28 APR XX3654 9.00 GITPOD.IO 4XXXXX*5191 28 APR XXXXXXXXXXXXXXXXXXX3654,173.84,,1083627.63,AccountTransactionsReport.csv,310,2025-04,False,Development Tools,Development Tools,Development Tools
,2025-05-02,8400/000 : FNB,5.00 COMPONENTS.STU 4XX*5191 29 APR XX6888 5.00 COMPONENTS.STU 4XXXXX*5191 29 APR XXXXXXXXXXXXXXXXXX,Account Payment,5.00 COMPONENTS.STU 4XX*5191 29 APR XX6888 5.00 COMPONENTS.STU 4XXXXX*5191 29 APR XXXXXXXXXXXXXXXXX,95.83,,1083723.46,AccountTransactionsReport.csv,311,2025-05,False,Other Computer Services,Other Computer Services,Other Computer Services
,2025-05-02,8400/000 : FNB,50.10 FRAPPE CLOUD 4XX*5191 30 APR XX0635 50.10 FRAPPE CLOUD 4XXXXX*5191 30 APR XXXXXXXXXXXXXXXXXXX0,Account Payment,50.10 FRAPPE CLOUD 4XX*5191 30 APR XX0635 50.10 FRAPPE CLOUD 4XXXXX*5191 30 APR XXXXXXXXXXXXXXXXXXX,951.04,,1084674.5,AccountTransactionsReport.csv,312,2025-05,False,Other Computer Services,Other Computer Services,Other Computer Services
,2025-05-02,8400/000 : FNB,50.16 LINODE . AKAM 4XX*5191 30 APR XX4891 50.16 LINODE . AKAM 4XXXXX*5191 30 APR XXXXXXXXXXXXXXXXXX,Account Payment,50.16 LINODE . AKAM 4XX*5191 30 APR XX4891 50.16 LINODE . AKAM 4XXXXX*5191 30 APR XXXXXXXXXXXXXXXXX,952.18,,1085626.68,AccountTransactionsReport.csv,313,2025-05,False,Cloud Services,Cloud Services,Cloud Services
,2025-05-02,8400/000 : FNB,50.00 OBSIDIAN.MD 4XX*5191 29 APR XX3810 50.00 OBSIDIAN.MD 4XXXXX*5191 29 APR XXXXXXXXXXXXXXXXXXX381,Account Payment,50.00 OBSIDIAN.MD 4XX*5191 29 APR XX3810 50.00 OBSIDIAN.MD 4XXXXX*5191 29 APR XXXXXXXXXXXXXXXXXXX38,958.25,,1086584.93,AccountTransactionsReport.csv,314,2025-05,False,Other Computer Services,Other Computer Services,Other Computer Services
,2025-05-02,8400/000 : FNB,2162.00 SNAPPY LLC 4XX*5191 29 APR XX0123 2162.00 SNAPPY LLC 4XXXXX*5191 29 APR XXXXXXXXXXXXXXXXXXX0,Account Payment,2162.00 SNAPPY LLC 4XX*5191 29 APR XX0123 2162.00 SNAPPY LLC 4XXXXX*5191 29 APR XXXXXXXXXXXXXXXXXXX,2162.0,,1088746.93,AccountTransactionsReport.csv,315,2025-05,False,Other Computer Services,Other Computer Services,Other Computer Services
,2025-05-02,8400/000 : FNB,5050.80 FRESHWORKS 4XX*5225 29 APR XX1842 5050.80 FRESHWORKS 4XXXXX*5225 29 APR XXXXXXXXXXXXXXXXXXX1,Account Payment,5050.80 FRESHWORKS 4XX*5225 29 APR XX1842 5050.80 FRESHWORKS 4XXXXX*5225 29 APR XXXXXXXXXXXXXXXXXXX,5050.8,,1093797.73,AccountTransactionsReport.csv,316,2025-05,False,Productivity Software,Productivity Software,Productivity Software
,2025-05-03,8400/000 : FNB,Google Store 365.04 Google GSUIT 4XXXXX*5225 01 MAY XXXXXXXXXXXXXXXXXXX5083 Google Store,Account Payment,Google Store 365.04 Google GSUIT 4XXXXX*5225 01 MAY XXXXXXXXXXXXXXXXXXX5083 Google Store,7902.57,,1101700.3,AccountTransactionsReport.csv,317,2025-05,False,Other Computer Services,Analytics & Monitoring,Analytics & Monitoring
,2025-05-03,8400/000 : FNB,44.14 GOOGLE*GSUITE 4XX*5225 01 MAY XX7258 44.14 GOOGLE*GSUITE 4XXXXX*5225 01 MAY XXXXXXXXXXXXXXXXXX,Account Payment,44.14 GOOGLE*GSUITE 4XX*5225 01 MAY XX7258 44.14 GOOGLE*GSUITE 4XXXXX*5225 01 MAY XXXXXXXXXXXXXXXXX,955.57,,1102655.87,AccountTransactionsReport.csv,318,2025-05,False,Other Computer Services,Analytics & Monitoring,Analytics & Monitoring
,2025-05-03,8400/000 : FNB,39.82 GOOGLE*GSUITE 4XX*5225 01 MAY XX6975 39.82 GOOGLE*GSUITE 4XXXXX*5225 01 MAY XXXXXXXXXXXXXXXXXX,Account Payment,39.82 GOOGLE*GSUITE 4XX*5225 01 MAY XX6975 39.82 GOOGLE*GSUITE 4XXXXX*5225 01 MAY XXXXXXXXXXXXXXXXX,862.04,,1103517.91,AccountTransactionsReport.csv,319,2025-05,False,Other Computer Services,Analytics & Monitoring,Analytics & Monitoring
,2025-05-03,8400/000 : FNB,1.00 VERCEL-NEON 4XX*5225 01 MAY XX6564 1.00 VERCEL-NEON 4XXXXX*5225 01 MAY XXXXXXXXXXXXXXXXXXX6564,Account Payment,1.00 VERCEL-NEON 4XX*5225 01 MAY XX6564 1.00 VERCEL-NEON 4XXXXX*5225 01 MAY XXXXXXXXXXXXXXXXXXX6564,19.03,,1103536.94,AccountTransactionsReport.csv,320,2025-05,False,Cloud Services,Cloud Services,Cloud Services
,2025-05-06,8400/000 : FNB,1499.00 APPDIRECT 4XX*5225 04 MAY XX5301 1499.00 APPDIRECT 4XXXXX*5225 04 MAY XXXXXXXXXXXXXXXXXXX530,Account Payment,1499.00 APPDIRECT 4XX*5225 04 MAY XX5301 1499.00 APPDIRECT 4XXXXX*5225 04 MAY XXXXXXXXXXXXXXXXXXX53,28597.4,,1132134.34,AccountTransactionsReport.csv,321,2025-05,False,Other Computer Services,Other Computer Services,Other Computer Services
,2025-05-06,8400/000 : FNB,ManageWP 120.75 MANAGEWP 4XXXXX*5225 05 MAY XXXXXXXXXXXXXXXXXXX3794 ManageWP,Account Payment,ManageWP 120.75 MANAGEWP 4XXXXX*5225 05 MAY XXXXXXXXXXXXXXXXXXX3794 ManageWP,2303.63,,1134437.97,AccountTransactionsReport.csv,322,2025-05,False,Other Computer Services,Other Computer Services,Other Computer Services
,2025-05-06,8400/000 : FNB,ManageWP 120.75 MANAGEWP 4XXXXX*5225 05 MAY XXXXXXXXXXXXXXXXXXX2183 ManageWP,Account Payment,ManageWP 120.75 MANAGEWP 4XXXXX*5225 05 MAY XXXXXXXXXXXXXXXXXXX2183 ManageWP,2303.63,,1136741.6,AccountTransactionsReport.csv,323,2025-05,False,Other Computer Services,Other Computer Services,Other Computer Services
,2025-05-06,8400/000 : FNB,"Github Inc. 19.00 GITHUB, INC. 4XXXXX*5225 04 MAY XXXXXXXXXXXXXXXXXXX7956 Github Inc.",Account Payment,"Github Inc. 19.00 GITHUB, INC. 4XXXXX*5225 04 MAY XXXXXXXXXXXXXXXXXXX7956 Github Inc.",362.48,,1137104.08,AccountTransactionsReport.csv,324,2025-05,False,Development Tools,Development Tools,Development Tools
,2025-05-06,8400/000 : FNB,"Github Inc. GITHUB, INC. 4XXXXX*5225 04 MAY XXXXXXXXXXXXXXXXXXX5760 Github Inc.",Account Payment,"Github Inc. GITHUB, INC. 4XXXXX*5225 04 MAY XXXXXXXXXXXXXXXXXXX5760 Github Inc.",15.65,,1137119.73,AccountTransactionsReport.csv,325,2025-05,False,Development Tools,Development Tools,Development Tools
,2025-05-07,8400/000 : FNB,Facebook Service Charges/Fees #INT PYMT FEE-585.90 FACE Facebook,Account Payment,Facebook Service Charges/Fees INT PYMT FEE-585.90 FACE Facebook,11.72,,1137131.45,AccountTransactionsReport.csv,326,2025-05,False,Marketing Tools,Marketing Tools,Marketing Tools
,2025-05-08,8400/000 : FNB,40.00 VERCEL INC. 4XX*5225 06 MAY XX2938 40.00 VERCEL INC. 4XXXXX*5225 06 MAY XXXXXXXXXXXXXXXXXXX293,Account Payment,40.00 VERCEL INC. 4XX*5225 06 MAY XX2938 40.00 VERCEL INC. 4XXXXX*5225 06 MAY XXXXXXXXXXXXXXXXXXX29,752.61,,1137884.06,AccountTransactionsReport.csv,327,2025-05,False,Cloud Services,Cloud Services,Cloud Services
,2025-05-08,8400/000 : FNB,20.00 VERCEL INC. 4XX*5225 06 MAY XX1373 20.00 VERCEL INC. 4XXXXX*5225 06 MAY XXXXXXXXXXXXXXXXXXX137,Account Payment,20.00 VERCEL INC. 4XX*5225 06 MAY XX1373 20.00 VERCEL INC. 4XXXXX*5225 06 MAY XXXXXXXXXXXXXXXXXXX13,376.3,,1138260.36,AccountTransactionsReport.csv,328,2025-05,False,Cloud Services,Cloud Services,Cloud Services
,2025-05-08,8400/000 : FNB,Woocommerce 19.99 WOOCOMMERCE S 4XXXXX*5225 06 MAY XXXXXXXXXXXXXXXXXXX6750 Woocommerce,Account Payment,Woocommerce 19.99 WOOCOMMERCE S 4XXXXX*5225 06 MAY XXXXXXXXXXXXXXXXXXX6750 Woocommerce,376.11,,1138636.47,AccountTransactionsReport.csv,329,2025-05,False,Other Computer Services,Other Computer Services,Other Computer Services
,2025-05-08,8400/000 : FNB,3.60 GETADDRESS.IO 4XX*5225 07 MAY XX5162 3.60 GETADDRESS.IO 4XXXXX*5225 07 MAY XXXXXXXXXXXXXXXXXXX5,Account Payment,3.60 GETADDRESS.IO 4XX*5225 07 MAY XX5162 3.60 GETADDRESS.IO 4XXXXX*5225 07 MAY XXXXXXXXXXXXXXXXXXX,89.78,,1138726.25,AccountTransactionsReport.csv,330,2025-05,False,Other Computer Services,Other Computer Services,Other Computer Services
,2025-05-09,8400/000 : FNB,Paddle 171.35 PADDLE.NET* 4XXXXX*5191 08 MAY XXXXXXXXXXXXXXXXXXX6983 Paddle,Account Payment,Paddle 171.35 PADDLE.NET* 4XXXXX*5191 08 MAY XXXXXXXXXXXXXXXXXXX6983 Paddle,3207.42,,1141933.67,AccountTransactionsReport.csv,331,2025-05,False,Other Computer Services,Subscription Management,Subscription Management
,2025-05-09,8400/000 : FNB,134.00 SINCH MAILGU 4XX*5191 07 MAY XX3741 134.00 SINCH MAILGU 4XXXXX*5191 07 MAY XXXXXXXXXXXXXXXXXX,Account Payment,134.00 SINCH MAILGU 4XX*5191 07 MAY XX3741 134.00 SINCH MAILGU 4XXXXX*5191 07 MAY XXXXXXXXXXXXXXXXX,2503.14,,1144436.81,AccountTransactionsReport.csv,332,2025-05,False,Other Computer Services,Other Computer Services,Other Computer Services
,2025-05-09,8400/000 : FNB,"105.00 NOTION LABS, 4XX*5191 07 MAY XX9327 105.00 NOTION LABS, 4XXXXX*5191 07 MAY XXXXXXXXXXXXXXXXXX",Account Payment,"105.00 NOTION LABS, 4XX*5191 07 MAY XX9327 105.00 NOTION LABS, 4XXXXX*5191 07 MAY XXXXXXXXXXXXXXXXX",1961.42,,1146398.23,AccountTransactionsReport.csv,333,2025-05,False,Other Computer Services,Collaboration Tools,Collaboration Tools
,2025-05-09,8400/000 : FNB,99.99 JINA.AI 4XX*5191 07 MAY XX5366 99.99 JINA.AI 4XXXXX*5191 07 MAY XXXXXXXXXXXXXXXXXXX5366,Account Payment,99.99 JINA.AI 4XX*5191 07 MAY XX5366 99.99 JINA.AI 4XXXXX*5191 07 MAY XXXXXXXXXXXXXXXXXXX5366,1867.82,,1148266.05,AccountTransactionsReport.csv,334,2025-05,False,Other Computer Services,Other Computer Services,Other Computer Services
,2025-05-09,8400/000 : FNB,99.00 MIOSALON.COM( 4XX*5225 07 MAY XX4045 99.00 MIOSALON.COM( 4XXXXX*5225 07 MAY XXXXXXXXXXXXXXXXXX,Account Payment,99.00 MIOSALON.COM( 4XX*5225 07 MAY XX4045 99.00 MIOSALON.COM( 4XXXXX*5225 07 MAY XXXXXXXXXXXXXXXXX,1849.33,,1150115.38,AccountTransactionsReport.csv,335,2025-05,False,Other Computer Services,Other Computer Services,Other Computer Services
,2025-05-09,8400/000 : FNB,99.00 MIOSALON.COM( 4XX*5225 07 MAY XX9889 99.00 MIOSALON.COM( 4XXXXX*5225 07 MAY XXXXXXXXXXXXXXXXXX,Account Payment,99.00 MIOSALON.COM( 4XX*5225 07 MAY XX9889 99.00 MIOSALON.COM( 4XXXXX*5225 07 MAY XXXXXXXXXXXXXXXXX,1849.33,,1151964.71,AccountTransactionsReport.csv,336,2025-05,False,Other Computer Services,Other Computer Services,Other Computer Services
,2025-05-09,8400/000 : FNB,Intuit 570.40 INTUIT *QBoo 4XXXXX*5225 07 MAY XXXXXXXXXXXXXXXXXXX4227 Intuit,Account Payment,Intuit 570.40 INTUIT *QBoo 4XXXXX*5225 07 MAY XXXXXXXXXXXXXXXXXXX4227 Intuit,570.4,,1152535.11,AccountTransactionsReport.csv,337,2025-05,False,Productivity Software,Productivity Software,Productivity Software
,2025-05-09,8400/000 : FNB,20.00 HUGGINGFACE 4XX*5191 07 MAY XX3488 20.00 HUGGINGFACE 4XXXXX*5191 07 MAY XXXXXXXXXXXXXXXXXXX348,Account Payment,20.00 HUGGINGFACE 4XX*5191 07 MAY XX3488 20.00 HUGGINGFACE 4XXXXX*5191 07 MAY XXXXXXXXXXXXXXXXXXX34,373.61,,1152908.72,AccountTransactionsReport.csv,338,2025-05,False,AI Services,AI Services,AI Services
,2025-05-09,8400/000 : FNB,17.25 SLACK T06A3T4 4XX*5191 07 MAY XX7425 17.25 SLACK T06A3T4 4XXXXX*5191 07 MAY XXXXXXXXXXXXXXXXXX,Account Payment,17.25 SLACK T06A3T4 4XX*5191 07 MAY XX7425 17.25 SLACK T06A3T4 4XXXXX*5191 07 MAY XXXXXXXXXXXXXXXXX,322.23,,1153230.95,AccountTransactionsReport.csv,339,2025-05,False,Communication,Communication,Communication
,2025-05-09,8400/000 : FNB,224.99 Google Chara 4XX*5191 07 MAY XX2066 224.99 Google Chara 4XXXXX*5191 07 MAY XXXXXXXXXXXXXXXXXX,Account Payment,224.99 Google Chara 4XX*5191 07 MAY XX2066 224.99 Google Chara 4XXXXX*5191 07 MAY XXXXXXXXXXXXXXXXX,224.99,,1153455.94,AccountTransactionsReport.csv,340,2025-05,False,Other Computer Services,Analytics & Monitoring,Analytics & Monitoring
,2025-05-09,8400/000 : FNB,12.00 CODESANDBOX 4XX*5191 07 MAY XX4385 12.00 CODESANDBOX 4XXXXX*5191 07 MAY XXXXXXXXXXXXXXXXXXX438,Account Payment,12.00 CODESANDBOX 4XX*5191 07 MAY XX4385 12.00 CODESANDBOX 4XXXXX*5191 07 MAY XXXXXXXXXXXXXXXXXXX43,224.17,,1153680.11,AccountTransactionsReport.csv,341,2025-05,False,Other Computer Services,Other Computer Services,Other Computer Services
,2025-05-09,8400/000 : FNB,"7.00 NPM, INC. 4XX*5191 08 MAY XX1842 7.00 NPM, INC. 4XXXXX*5191 08 MAY XXXXXXXXXXXXXXXXXXX1842",Account Payment,"7.00 NPM, INC. 4XX*5191 08 MAY XX1842 7.00 NPM, INC. 4XXXXX*5191 08 MAY XXXXXXXXXXXXXXXXXXX1842",131.03,,1153811.14,AccountTransactionsReport.csv,342,2025-05,False,Other Computer Services,Other Computer Services,Other Computer Services
,2025-05-09,8400/000 : FNB,"7.00 NPM, INC. 4XX*5191 08 MAY XX1809 7.00 NPM, INC. 4XXXXX*5191 08 MAY XXXXXXXXXXXXXXXXXXX1809",Account Payment,"7.00 NPM, INC. 4XX*5191 08 MAY XX1809 7.00 NPM, INC. 4XXXXX*5191 08 MAY XXXXXXXXXXXXXXXXXXX1809",131.03,,1153942.17,AccountTransactionsReport.csv,343,2025-05,False,Other Computer Services,Other Computer Services,Other Computer Services
,2025-05-09,8400/000 : FNB,"7.00 NPM, INC. 4XX*5191 08 MAY XX2543 7.00 NPM, INC. 4XXXXX*5191 08 MAY XXXXXXXXXXXXXXXXXXX2543",Account Payment,"7.00 NPM, INC. 4XX*5191 08 MAY XX2543 7.00 NPM, INC. 4XXXXX*5191 08 MAY XXXXXXXXXXXXXXXXXXX2543",131.03,,1154073.2,AccountTransactionsReport.csv,344,2025-05,False,Other Computer Services,Other Computer Services,Other Computer Services
,2025-05-09,8400/000 : FNB,"7.00 NPM, INC. 4XX*5191 08 MAY XX4451 7.00 NPM, INC. 4XXXXX*5191 08 MAY XXXXXXXXXXXXXXXXXXX4451",Account Payment,"7.00 NPM, INC. 4XX*5191 08 MAY XX4451 7.00 NPM, INC. 4XXXXX*5191 08 MAY XXXXXXXXXXXXXXXXXXX4451",131.03,,1154204.23,AccountTransactionsReport.csv,345,2025-05,False,Other Computer Services,Other Computer Services,Other Computer Services
,2025-05-10,8400/000 : FNB,Shopify 2558.98 SHOPIFY* 36 4XXXXX*5191 08 MAY XXXXXXXXXXXXXXXXXXX2019 Shopify,Account Payment,Shopify 2558.98 SHOPIFY* 36 4XXXXX*5191 08 MAY XXXXXXXXXXXXXXXXXXX2019 Shopify,47900.31,,1202104.54,AccountTransactionsReport.csv,346,2025-05,False,E-commerce Platforms,E-commerce Platforms,E-commerce Platforms
,2025-05-10,8400/000 : FNB,599.00 TRIPLE WHALE 4XX*5191 08 MAY XX4842 599.00 TRIPLE WHALE 4XXXXX*5191 08 MAY XXXXXXXXXXXXXXXXXX,Account Payment,599.00 TRIPLE WHALE 4XX*5191 08 MAY XX4842 599.00 TRIPLE WHALE 4XXXXX*5191 08 MAY XXXXXXXXXXXXXXXXX,11212.39,,1213316.93,AccountTransactionsReport.csv,347,2025-05,False,Other Computer Services,Other Computer Services,Other Computer Services
,2025-05-10,8400/000 : FNB,Stable 249.00 STABLE 4XXXXX*5191 09 MAY XXXXXXXXXXXXXXXXXXX1770 Stable,Account Payment,Stable 249.00 STABLE 4XXXXX*5191 09 MAY XXXXXXXXXXXXXXXXXXX1770 Stable,4661.09,,1217978.02,AccountTransactionsReport.csv,348,2025-05,False,Other Computer Services,Other Computer Services,Other Computer Services
,2025-05-10,8400/000 : FNB,179.00 MOZSEO:HELP@ 4XX*5191 08 MAY XX6597 179.00 MOZSEO:HELP@ 4XXXXX*5191 08 MAY XXXXXXXXXXXXXXXXXX,Account Payment,179.00 MOZSEO:HELP@ 4XX*5191 08 MAY XX6597 179.00 MOZSEO:HELP@ 4XXXXX*5191 08 MAY XXXXXXXXXXXXXXXXX,3350.74,,1221328.76,AccountTransactionsReport.csv,349,2025-05,False,Other Computer Services,Other Computer Services,Other Computer Services
,2025-05-10,8400/000 : FNB,150.00 AUTH0.COM 4XX*5191 08 MAY XX0874 150.00 AUTH0.COM 4XXXXX*5191 08 MAY XXXXXXXXXXXXXXXXXXX0874,Account Payment,150.00 AUTH0.COM 4XX*5191 08 MAY XX0874 150.00 AUTH0.COM 4XXXXX*5191 08 MAY XXXXXXXXXXXXXXXXXXX0874,2807.77,,1224136.53,AccountTransactionsReport.csv,350,2025-05,False,Security Services,Security Services,Security Services
,2025-05-10,8400/000 : FNB,99.00 CHATBASE 4XX*5191 09 MAY XX6889 99.00 CHATBASE 4XXXXX*5191 09 MAY XXXXXXXXXXXXXXXXXXX6889,Account Payment,99.00 CHATBASE 4XX*5191 09 MAY XX6889 99.00 CHATBASE 4XXXXX*5191 09 MAY XXXXXXXXXXXXXXXXXXX6889,1853.21,,1225989.74,AccountTransactionsReport.csv,351,2025-05,False,Other Computer Services,Other Computer Services,Other Computer Services
,2025-05-10,8400/000 : FNB,"Github Inc. 91.00 GITHUB, INC. 4XXXXX*5191 08 MAY XXXXXXXXXXXXXXXXXXX2406 Github Inc.",Account Payment,"Github Inc. 91.00 GITHUB, INC. 4XXXXX*5191 08 MAY XXXXXXXXXXXXXXXXXXX2406 Github Inc.",1703.39,,1227693.13,AccountTransactionsReport.csv,352,2025-05,False,Development Tools,Development Tools,Development Tools
,2025-05-10,8400/000 : FNB,72.00 TERMIUS CORPO 4XX*5191 08 MAY XX3711 72.00 TERMIUS CORPO 4XXXXX*5191 08 MAY XXXXXXXXXXXXXXXXXX,Account Payment,72.00 TERMIUS CORPO 4XX*5191 08 MAY XX3711 72.00 TERMIUS CORPO 4XXXXX*5191 08 MAY XXXXXXXXXXXXXXXXX,1347.74,,1229040.87,AccountTransactionsReport.csv,353,2025-05,False,Other Computer Services,Other Computer Services,Other Computer Services
,2025-05-10,8400/000 : FNB,"25.00 NOTION LABS, 4XX*5191 08 MAY XX5089 25.00 NOTION LABS, 4XXXXX*5191 08 MAY XXXXXXXXXXXXXXXXXXX5",Account Payment,"25.00 NOTION LABS, 4XX*5191 08 MAY XX5089 25.00 NOTION LABS, 4XXXXX*5191 08 MAY XXXXXXXXXXXXXXXXXXX",467.97,,1229508.84,AccountTransactionsReport.csv,354,2025-05,False,Other Computer Services,Collaboration Tools,Collaboration Tools
,2025-05-10,8400/000 : FNB,Google Play 434.99 Google Perpl 4XXXXX*5191 09 MAY XXXXXXXXXXXXXXXXXXX1035 Google Play,Account Payment,Google Play 434.99 Google Perpl 4XXXXX*5191 09 MAY XXXXXXXXXXXXXXXXXXX1035 Google Play,434.99,,1229943.83,AccountTransactionsReport.csv,355,2025-05,False,Other Computer Services,Analytics & Monitoring,Analytics & Monitoring
,2025-05-10,8400/000 : FNB,19.00 CHATBASE 4XX*5191 08 MAY XX6135 19.00 CHATBASE 4XXXXX*5191 08 MAY XXXXXXXXXXXXXXXXXXX6135,Account Payment,19.00 CHATBASE 4XX*5191 08 MAY XX6135 19.00 CHATBASE 4XXXXX*5191 08 MAY XXXXXXXXXXXXXXXXXXX6135,355.65,,1230299.48,AccountTransactionsReport.csv,356,2025-05,False,Other Computer Services,Other Computer Services,Other Computer Services
,2025-05-10,8400/000 : FNB,Paddle 187.94 PADDLE.NET* 4XXXXX*5191 08 MAY XXXXXXXXXXXXXXXXXXX5165 Paddle,Account Payment,Paddle 187.94 PADDLE.NET* 4XXXXX*5191 08 MAY XXXXXXXXXXXXXXXXXXX5165 Paddle,187.94,,1230487.42,AccountTransactionsReport.csv,357,2025-05,False,Other Computer Services,Subscription Management,Subscription Management
,2025-05-10,8400/000 : FNB,Google Store 34.99 Google One 4XXXXX*5191 08 MAY XXXXXXXXXXXXXXXXXXX1020 Google Store,Account Payment,Google Store 34.99 Google One 4XXXXX*5191 08 MAY XXXXXXXXXXXXXXXXXXX1020 Google Store,34.99,,1230522.41,AccountTransactionsReport.csv,358,2025-05,False,Other Computer Services,Analytics & Monitoring,Analytics & Monitoring
,2025-05-12,8400/000 : FNB,920.00 AUTH0.COM 4XX*5191 09 MAY XX9909 920.00 AUTH0.COM 4XXXXX*5191 09 MAY XXXXXXXXXXXXXXXXXXX9909,Account Payment,920.00 AUTH0.COM 4XX*5191 09 MAY XX9909 920.00 AUTH0.COM 4XXXXX*5191 09 MAY XXXXXXXXXXXXXXXXXXX9909,17221.7,,1247744.11,AccountTransactionsReport.csv,359,2025-05,False,Security Services,Security Services,Security Services
,2025-05-12,8400/000 : FNB,174.00 INTERCOM R&D 4XX*5191 09 MAY XX8678 174.00 INTERCOM R&D 4XXXXX*5191 09 MAY XXXXXXXXXXXXXXXXXX,Account Payment,174.00 INTERCOM R&D 4XX*5191 09 MAY XX8678 174.00 INTERCOM R&D 4XXXXX*5191 09 MAY XXXXXXXXXXXXXXXXX,3257.15,,1251001.26,AccountTransactionsReport.csv,360,2025-05,False,Other Computer Services,Customer Support,Customer Support
,2025-05-12,8400/000 : FNB,"70.00 NOTION LABS, 4XX*5191 10 MAY XX5242 70.00 NOTION LABS, 4XXXXX*5191 10 MAY XXXXXXXXXXXXXXXXXXX5",Account Payment,"70.00 NOTION LABS, 4XX*5191 10 MAY XX5242 70.00 NOTION LABS, 4XXXXX*5191 10 MAY XXXXXXXXXXXXXXXXXXX",1307.76,,1252309.02,AccountTransactionsReport.csv,361,2025-05,False,Other Computer Services,Collaboration Tools,Collaboration Tools
,2025-05-12,8400/000 : FNB,49.00 SKRAPP.IO STA 4XX*5191 09 MAY XX3319 49.00 SKRAPP.IO STA 4XXXXX*5191 09 MAY XXXXXXXXXXXXXXXXXX,Account Payment,49.00 SKRAPP.IO STA 4XX*5191 09 MAY XX3319 49.00 SKRAPP.IO STA 4XXXXX*5191 09 MAY XXXXXXXXXXXXXXXXX,917.25,,1253226.27,AccountTransactionsReport.csv,362,2025-05,False,Other Computer Services,Other Computer Services,Other Computer Services
,2025-05-12,8400/000 : FNB,Digitalocean 47.84 DIGITALOCEAN. 4XXXXX*5191 09 MAY XXXXXXXXXXXXXXXXXXX1977 Digitalocean,Account Payment,Digitalocean 47.84 DIGITALOCEAN. 4XXXXX*5191 09 MAY XXXXXXXXXXXXXXXXXXX1977 Digitalocean,895.53,,1254121.8,AccountTransactionsReport.csv,363,2025-05,False,Cloud Services,Cloud Services,Cloud Services
,2025-05-12,8400/000 : FNB,"40.00 REPLIT, INC. 4XX*5191 09 MAY XX2533 40.00 REPLIT, INC. 4XXXXX*5191 09 MAY XXXXXXXXXXXXXXXXXXX2",Account Payment,"40.00 REPLIT, INC. 4XX*5191 09 MAY XX2533 40.00 REPLIT, INC. 4XXXXX*5191 09 MAY XXXXXXXXXXXXXXXXXXX",748.77,,1254870.57,AccountTransactionsReport.csv,364,2025-05,False,Other Computer Services,Other Computer Services,Other Computer Services
,2025-05-12,8400/000 : FNB,Intuit 570.40 INTUIT *QBoo 4XXXXX*5225 09 MAY XXXXXXXXXXXXXXXXXXX9272 Intuit,Account Payment,Intuit 570.40 INTUIT *QBoo 4XXXXX*5225 09 MAY XXXXXXXXXXXXXXXXXXX9272 Intuit,570.4,,1255440.97,AccountTransactionsReport.csv,365,2025-05,False,Productivity Software,Productivity Software,Productivity Software
,2025-05-12,8400/000 : FNB,30.00 ISHRAQ LLC 4XX*5191 09 MAY XX1483 30.00 ISHRAQ LLC 4XXXXX*5191 09 MAY XXXXXXXXXXXXXXXXXXX1483,Account Payment,30.00 ISHRAQ LLC 4XX*5191 09 MAY XX1483 30.00 ISHRAQ LLC 4XXXXX*5191 09 MAY XXXXXXXXXXXXXXXXXXX1483,561.58,,1256002.55,AccountTransactionsReport.csv,366,2025-05,False,Other Computer Services,Other Computer Services,Other Computer Services
,2025-05-12,8400/000 : FNB,30.00 XAI LLC 4XX*5191 09 MAY XX7532 30.00 XAI LLC 4XXXXX*5191 09 MAY XXXXXXXXXXXXXXXXXXX7532,Account Payment,30.00 XAI LLC 4XX*5191 09 MAY XX7532 30.00 XAI LLC 4XXXXX*5191 09 MAY XXXXXXXXXXXXXXXXXXX7532,561.58,,1256564.13,AccountTransactionsReport.csv,367,2025-05,False,Other Computer Services,Other Computer Services,Other Computer Services
,2025-05-12,8400/000 : FNB,25.00 BEECEPTOR 4XX*5191 09 MAY XX0040 25.00 BEECEPTOR 4XXXXX*5191 09 MAY XXXXXXXXXXXXXXXXXXX0040,Account Payment,25.00 BEECEPTOR 4XX*5191 09 MAY XX0040 25.00 BEECEPTOR 4XXXXX*5191 09 MAY XXXXXXXXXXXXXXXXXXX0040,467.98,,1257032.11,AccountTransactionsReport.csv,368,2025-05,False,Other Computer Services,Other Computer Services,Other Computer Services
,2025-05-12,8400/000 : FNB,25.00 BEECEPTOR 4XX*5191 09 MAY XX0096 25.00 BEECEPTOR 4XXXXX*5191 09 MAY XXXXXXXXXXXXXXXXXXX0096,Account Payment,25.00 BEECEPTOR 4XX*5191 09 MAY XX0096 25.00 BEECEPTOR 4XXXXX*5191 09 MAY XXXXXXXXXXXXXXXXXXX0096,467.98,,1257500.09,AccountTransactionsReport.csv,369,2025-05,False,Other Computer Services,Other Computer Services,Other Computer Services
,2025-05-12,8400/000 : FNB,Facebook 23.00 FACEBK *P4SNN 4XXXXX*5191 09 MAY XXXXXXXXXXXXXXXXXXX3027 Facebook,Account Payment,Facebook 23.00 FACEBK *P4SNN 4XXXXX*5191 09 MAY XXXXXXXXXXXXXXXXXXX3027 Facebook,430.54,,1257930.63,AccountTransactionsReport.csv,370,2025-05,False,Marketing Tools,Marketing Tools,Marketing Tools
,2025-05-12,8400/000 : FNB,20.00 VERCEL INC. 4XX*5191 09 MAY XX9944 20.00 VERCEL INC. 4XXXXX*5191 09 MAY XXXXXXXXXXXXXXXXXXX994,Account Payment,20.00 VERCEL INC. 4XX*5191 09 MAY XX9944 20.00 VERCEL INC. 4XXXXX*5191 09 MAY XXXXXXXXXXXXXXXXXXX99,374.38,,1258305.01,AccountTransactionsReport.csv,371,2025-05,False,Cloud Services,Cloud Services,Cloud Services
,2025-05-12,8400/000 : FNB,Hightail 15.00 HIGHTAIL 4XXXXX*5191 09 MAY XXXXXXXXXXXXXXXXXXX3054 Hightail,Account Payment,Hightail 15.00 HIGHTAIL 4XXXXX*5191 09 MAY XXXXXXXXXXXXXXXXXXX3054 Hightail,280.79,,1258585.8,AccountTransactionsReport.csv,372,2025-05,False,Other Computer Services,Other Computer Services,Other Computer Services
,2025-05-12,8400/000 : FNB,Facebook 13.80 FACEBK *EBA7K 4XXXXX*5191 09 MAY XXXXXXXXXXXXXXXXXXX6095 Facebook,Account Payment,Facebook 13.80 FACEBK *EBA7K 4XXXXX*5191 09 MAY XXXXXXXXXXXXXXXXXXX6095 Facebook,258.33,,1258844.13,AccountTransactionsReport.csv,373,2025-05,False,Marketing Tools,Marketing Tools,Marketing Tools
,2025-05-12,8400/000 : FNB,7.00 CHATBASE 4XX*5191 10 MAY XX3978 7.00 CHATBASE 4XXXXX*5191 10 MAY XXXXXXXXXXXXXXXXXXX3978,Account Payment,7.00 CHATBASE 4XX*5191 10 MAY XX3978 7.00 CHATBASE 4XXXXX*5191 10 MAY XXXXXXXXXXXXXXXXXXX3978,130.77,,1258974.9,AccountTransactionsReport.csv,374,2025-05,False,Other Computer Services,Other Computer Services,Other Computer Services
,2025-05-12,8400/000 : FNB,Facebook 4.60 FACEBK *RVMWPQ 4XXXXX*5191 09 MAY XXXXXXXXXXXXXXXXXXX7055 Facebook,Account Payment,Facebook 4.60 FACEBK *RVMWPQ 4XXXXX*5191 09 MAY XXXXXXXXXXXXXXXXXXX7055 Facebook,86.11,,1259061.01,AccountTransactionsReport.csv,375,2025-05,False,Marketing Tools,Marketing Tools,Marketing Tools
,2025-05-12,8400/000 : FNB,1.50 LINODE . AKAMA 4XX*5191 09 MAY XX3922 1.50 LINODE . AKAMA 4XXXXX*5191 09 MAY XXXXXXXXXXXXXXXXXX,Account Payment,1.50 LINODE . AKAMA 4XX*5191 09 MAY XX3922 1.50 LINODE . AKAMA 4XXXXX*5191 09 MAY XXXXXXXXXXXXXXXXX,28.08,,1259089.09,AccountTransactionsReport.csv,376,2025-05,False,Cloud Services,Cloud Services,Cloud Services
,2025-05-13,8400/000 : FNB,Shopify 3633.95 SHOPIFY* 36 4XXXXX*5225 10 MAY XXXXXXXXXXXXXXXXXXX4805 Shopify,Account Payment,Shopify 3633.95 SHOPIFY* 36 4XXXXX*5225 10 MAY XXXXXXXXXXXXXXXXXXX4805 Shopify,67890.59,,1326979.68,AccountTransactionsReport.csv,377,2025-05,False,E-commerce Platforms,E-commerce Platforms,E-commerce Platforms
,2025-05-13,8400/000 : FNB,500.00 KDZ LLC 4XX*5191 10 MAY XX7664 500.00 KDZ LLC 4XXXXX*5191 10 MAY XXXXXXXXXXXXXXXXXXX7664,Account Payment,500.00 KDZ LLC 4XX*5191 10 MAY XX7664 500.00 KDZ LLC 4XXXXX*5191 10 MAY XXXXXXXXXXXXXXXXXXX7664,9341.16,,1336320.84,AccountTransactionsReport.csv,378,2025-05,False,Other Computer Services,Other Computer Services,Other Computer Services
,2025-05-13,8400/000 : FNB,499.00 CASSIDYAI.CO 4XX*5191 09 MAY XX3102 499.00 CASSIDYAI.CO 4XXXXX*5191 09 MAY XXXXXXXXXXXXXXXXXX,Account Payment,499.00 CASSIDYAI.CO 4XX*5191 09 MAY XX3102 499.00 CASSIDYAI.CO 4XXXXX*5191 09 MAY XXXXXXXXXXXXXXXXX,9340.89,,1345661.73,AccountTransactionsReport.csv,379,2025-05,False,Other Computer Services,Other Computer Services,Other Computer Services
,2025-05-13,8400/000 : FNB,350.00 KODZ LLC 4XX*5191 10 MAY XX8016 350.00 KODZ LLC 4XXXXX*5191 10 MAY XXXXXXXXXXXXXXXXXXX8016,Account Payment,350.00 KODZ LLC 4XX*5191 10 MAY XX8016 350.00 KODZ LLC 4XXXXX*5191 10 MAY XXXXXXXXXXXXXXXXXXX8016,6538.81,,1352200.54,AccountTransactionsReport.csv,380,2025-05,False,Other Computer Services,Other Computer Services,Other Computer Services
,2025-05-13,8400/000 : FNB,249.00 EMBEDCHAIN 4XX*5191 10 MAY XX3045 249.00 EMBEDCHAIN 4XXXXX*5191 10 MAY XXXXXXXXXXXXXXXXXXX304,Account Payment,249.00 EMBEDCHAIN 4XX*5191 10 MAY XX3045 249.00 EMBEDCHAIN 4XXXXX*5191 10 MAY XXXXXXXXXXXXXXXXXXX30,4651.89,,1356852.43,AccountTransactionsReport.csv,381,2025-05,False,Other Computer Services,Other Computer Services,Other Computer Services
,2025-05-13,8400/000 : FNB,"Github Inc. 210.00 GITHUB, INC. 4XXXXX*5225 11 MAY XXXXXXXXXXXXXXXXXXX4792 Github Inc.",Account Payment,"Github Inc. 210.00 GITHUB, INC. 4XXXXX*5225 11 MAY XXXXXXXXXXXXXXXXXXX4792 Github Inc.",3923.29,,1360775.72,AccountTransactionsReport.csv,382,2025-05,False,Development Tools,Development Tools,Development Tools
,2025-05-13,8400/000 : FNB,"99.00 PLAYFAB, INC. 4XX*5191 10 MAY XX2050 99.00 PLAYFAB, INC. 4XXXXX*5191 10 MAY XXXXXXXXXXXXXXXXXX",Account Payment,"99.00 PLAYFAB, INC. 4XX*5191 10 MAY XX2050 99.00 PLAYFAB, INC. 4XXXXX*5191 10 MAY XXXXXXXXXXXXXXXXX",1849.55,,1362625.27,AccountTransactionsReport.csv,383,2025-05,False,Other Computer Services,Other Computer Services,Other Computer Services
,2025-05-13,8400/000 : FNB,99.00 DMNS.APP BUSI 4XX*5191 10 MAY XX8580 99.00 DMNS.APP BUSI 4XXXXX*5191 10 MAY XXXXXXXXXXXXXXXXXX,Account Payment,99.00 DMNS.APP BUSI 4XX*5191 10 MAY XX8580 99.00 DMNS.APP BUSI 4XXXXX*5191 10 MAY XXXXXXXXXXXXXXXXX,1849.55,,1364474.82,AccountTransactionsReport.csv,384,2025-05,False,Other Computer Services,Other Computer Services,Other Computer Services
,2025-05-13,8400/000 : FNB,99.00 DYNAMIC.XYZ 4XX*5191 11 MAY XX0826 99.00 DYNAMIC.XYZ 4XXXXX*5191 11 MAY XXXXXXXXXXXXXXXXXXX082,Account Payment,99.00 DYNAMIC.XYZ 4XX*5191 11 MAY XX0826 99.00 DYNAMIC.XYZ 4XXXXX*5191 11 MAY XXXXXXXXXXXXXXXXXXX08,1849.55,,1366324.37,AccountTransactionsReport.csv,385,2025-05,False,Other Computer Services,Other Computer Services,Other Computer Services
,2025-05-13,8400/000 : FNB,Shopify 74.75 SHOPIFY* 3642 4XXXXX*5225 10 MAY XXXXXXXXXXXXXXXXXXX9234 Shopify,Account Payment,Shopify 74.75 SHOPIFY* 3642 4XXXXX*5225 10 MAY XXXXXXXXXXXXXXXXXXX9234 Shopify,1396.5,,1367720.87,AccountTransactionsReport.csv,386,2025-05,False,E-commerce Platforms,E-commerce Platforms,E-commerce Platforms
,2025-05-13,8400/000 : FNB,"Github Inc. 70.57 GITHUB, INC. 4XXXXX*5191 11 MAY XXXXXXXXXXXXXXXXXXX2963 Github Inc.",Account Payment,"Github Inc. 70.57 GITHUB, INC. 4XXXXX*5191 11 MAY XXXXXXXXXXXXXXXXXXX2963 Github Inc.",1318.41,,1369039.28,AccountTransactionsReport.csv,387,2025-05,False,Development Tools,Development Tools,Development Tools
,2025-05-13,8400/000 : FNB,67.85 LEMSQZY* CHAT 4XX*5191 10 MAY XX0969 67.85 LEMSQZY* CHAT 4XXXXX*5191 10 MAY XXXXXXXXXXXXXXXXXX,Account Payment,67.85 LEMSQZY* CHAT 4XX*5191 10 MAY XX0969 67.85 LEMSQZY* CHAT 4XXXXX*5191 10 MAY XXXXXXXXXXXXXXXXX,1267.59,,1370306.87,AccountTransactionsReport.csv,388,2025-05,False,AI Services,AI Services,AI Services
,2025-05-13,8400/000 : FNB,60.00 INSOMNIA TEAM 4XX*5191 11 MAY XX1829 60.00 INSOMNIA TEAM 4XXXXX*5191 11 MAY XXXXXXXXXXXXXXXXXX,Account Payment,60.00 INSOMNIA TEAM 4XX*5191 11 MAY XX1829 60.00 INSOMNIA TEAM 4XXXXX*5191 11 MAY XXXXXXXXXXXXXXXXX,1120.94,,1371427.81,AccountTransactionsReport.csv,389,2025-05,False,Other Computer Services,Other Computer Services,Other Computer Services
,2025-05-13,8400/000 : FNB,52.66 WINDSURF 4XX*5191 10 MAY XX3983 52.66 WINDSURF 4XXXXX*5191 10 MAY XXXXXXXXXXXXXXXXXXX3983,Account Payment,52.66 WINDSURF 4XX*5191 10 MAY XX3983 52.66 WINDSURF 4XXXXX*5191 10 MAY XXXXXXXXXXXXXXXXXXX3983,983.81,,1372411.62,AccountTransactionsReport.csv,390,2025-05,False,Other Computer Services,Other Computer Services,Other Computer Services
,2025-05-13,8400/000 : FNB,"Github Inc. 42.00 GITHUB, INC. 4XXXXX*5191 11 MAY XXXXXXXXXXXXXXXXXXX8456 Github Inc.",Account Payment,"Github Inc. 42.00 GITHUB, INC. 4XXXXX*5191 11 MAY XXXXXXXXXXXXXXXXXXX8456 Github Inc.",784.66,,1373196.28,AccountTransactionsReport.csv,391,2025-05,False,Development Tools,Development Tools,Development Tools
,2025-05-13,8400/000 : FNB,32.00 BUBBLE STARTE 4XX*5191 11 MAY XX4453 32.00 BUBBLE STARTE 4XXXXX*5191 11 MAY XXXXXXXXXXXXXXXXXX,Account Payment,32.00 BUBBLE STARTE 4XX*5191 11 MAY XX4453 32.00 BUBBLE STARTE 4XXXXX*5191 11 MAY XXXXXXXXXXXXXXXXX,597.83,,1373794.11,AccountTransactionsReport.csv,392,2025-05,False,Other Computer Services,Other Computer Services,Other Computer Services
,2025-05-13,8400/000 : FNB,Facebook 417.89 FACEBK *4SY3 4XXXXX*5191 11 MAY XXXXXXXXXXXXXXXXXXX3024 Facebook,Account Payment,Facebook 417.89 FACEBK *4SY3 4XXXXX*5191 11 MAY XXXXXXXXXXXXXXXXXXX3024 Facebook,417.89,,1374212.0,AccountTransactionsReport.csv,393,2025-05,False,Marketing Tools,Marketing Tools,Marketing Tools
,2025-05-13,8400/000 : FNB,21.56 SLACK T0740DV 4XX*5191 10 MAY XX9339 21.56 SLACK T0740DV 4XXXXX*5191 10 MAY XXXXXXXXXXXXXXXXXX,Account Payment,21.56 SLACK T0740DV 4XX*5191 10 MAY XX9339 21.56 SLACK T0740DV 4XXXXX*5191 10 MAY XXXXXXXXXXXXXXXXX,402.79,,1374614.79,AccountTransactionsReport.csv,394,2025-05,False,Communication,Communication,Communication
,2025-05-13,8400/000 : FNB,15.00 CAL.COM 4XX*5191 10 MAY XX7942 15.00 CAL.COM 4XXXXX*5191 10 MAY XXXXXXXXXXXXXXXXXXX7942,Account Payment,15.00 CAL.COM 4XX*5191 10 MAY XX7942 15.00 CAL.COM 4XXXXX*5191 10 MAY XXXXXXXXXXXXXXXXXXX7942,280.23,,1374895.02,AccountTransactionsReport.csv,395,2025-05,False,Other Computer Services,Other Computer Services,Other Computer Services
,2025-05-13,8400/000 : FNB,9.00 TWENTY.COM 4XX*5191 11 MAY XX2425 9.00 TWENTY.COM 4XXXXX*5191 11 MAY XXXXXXXXXXXXXXXXXXX2425,Account Payment,9.00 TWENTY.COM 4XX*5191 11 MAY XX2425 9.00 TWENTY.COM 4XXXXX*5191 11 MAY XXXXXXXXXXXXXXXXXXX2425,168.14,,1375063.16,AccountTransactionsReport.csv,396,2025-05,False,Other Computer Services,Other Computer Services,Other Computer Services
,2025-05-14,8400/000 : FNB,50.30 LINODE . AKAM 4XX*5191 12 MAY XX9059 50.30 LINODE . AKAM 4XXXXX*5191 12 MAY XXXXXXXXXXXXXXXXXX,Account Payment,50.30 LINODE . AKAM 4XX*5191 12 MAY XX9059 50.30 LINODE . AKAM 4XXXXX*5191 12 MAY XXXXXXXXXXXXXXXXX,939.72,,1376002.88,AccountTransactionsReport.csv,397,2025-05,False,Cloud Services,Cloud Services,Cloud Services
,2025-05-14,8400/000 : FNB,15.00 TABNINE 4XX*5191 12 MAY XX3180 15.00 TABNINE 4XXXXX*5191 12 MAY XXXXXXXXXXXXXXXXXXX3180,Account Payment,15.00 TABNINE 4XX*5191 12 MAY XX3180 15.00 TABNINE 4XXXXX*5191 12 MAY XXXXXXXXXXXXXXXXXXX3180,280.23,,1376283.11,AccountTransactionsReport.csv,398,2025-05,False,Other Computer Services,Other Computer Services,Other Computer Services
,2025-05-15,8400/000 : FNB,180.00 AGENCYANALYT 4XX*5225 13 MAY XX4040 180.00 AGENCYANALYT 4XXXXX*5225 13 MAY XXXXXXXXXXXXXXXXXX,Account Payment,180.00 AGENCYANALYT 4XX*5225 13 MAY XX4040 180.00 AGENCYANALYT 4XXXXX*5225 13 MAY XXXXXXXXXXXXXXXXX,3369.05,,1379652.16,AccountTransactionsReport.csv,399,2025-05,False,Other Computer Services,Other Computer Services,Other Computer Services
,2025-05-15,8400/000 : FNB,57.33 PADDLE.NET* W 4XX*5191 14 MAY XX7489 57.33 PADDLE.NET* W 4XXXXX*5191 14 MAY XXXXXXXXXXXXXXXXXX,Account Payment,57.33 PADDLE.NET* W 4XX*5191 14 MAY XX7489 57.33 PADDLE.NET* W 4XXXXX*5191 14 MAY XXXXXXXXXXXXXXXXX,1080.95,,1380733.11,AccountTransactionsReport.csv,400,2025-05,False,Other Computer Services,Subscription Management,Subscription Management
,2025-05-15,8400/000 : FNB,29.12 RAILWAY 4XX*5191 13 MAY XX1847 29.12 RAILWAY 4XXXXX*5191 13 MAY XXXXXXXXXXXXXXXXXXX1847,Account Payment,29.12 RAILWAY 4XX*5191 13 MAY XX1847 29.12 RAILWAY 4XXXXX*5191 13 MAY XXXXXXXXXXXXXXXXXXX1847,545.04,,1381278.15,AccountTransactionsReport.csv,401,2025-05,False,Other Computer Services,Other Computer Services,Other Computer Services
,2025-05-15,8400/000 : FNB,5.00 WWW.FLUX.AI 4XX*5191 13 MAY XX0251 5.00 WWW.FLUX.AI 4XXXXX*5191 13 MAY XXXXXXXXXXXXXXXXXXX0251,Account Payment,5.00 WWW.FLUX.AI 4XX*5191 13 MAY XX0251 5.00 WWW.FLUX.AI 4XXXXX*5191 13 MAY XXXXXXXXXXXXXXXXXXX0251,93.59,,1381371.74,AccountTransactionsReport.csv,402,2025-05,False,Other Computer Services,Other Computer Services,Other Computer Services
,2025-05-16,8400/000 : FNB,Google Service Charges/Fees #INT PYMT FEE-34.99 Googl Google,Account Payment,Google Service Charges/Fees INT PYMT FEE-34.99 Googl Google,0.7,,1381372.44,AccountTransactionsReport.csv,403,2025-05,False,Other Computer Services,Analytics & Monitoring,Analytics & Monitoring
,2025-05-16,8400/000 : FNB,Google Service Charges/Fees #INT PYMT FEE-434.99 Goog Google,Account Payment,Google Service Charges/Fees INT PYMT FEE-434.99 Goog Google,8.7,,1381381.14,AccountTransactionsReport.csv,404,2025-05,False,Other Computer Services,Analytics & Monitoring,Analytics & Monitoring
,2025-05-16,8400/000 : FNB,Google Service Charges/Fees #INT PYMT FEE-224.99 Goog Google,Account Payment,Google Service Charges/Fees INT PYMT FEE-224.99 Goog Google,4.5,,1381385.64,AccountTransactionsReport.csv,405,2025-05,False,Other Computer Services,Analytics & Monitoring,Analytics & Monitoring
,2025-05-16,8400/000 : FNB,25.12 RAILWAY 4XX*5191 14 MAY XX1608 25.12 RAILWAY 4XXXXX*5191 14 MAY XXXXXXXXXXXXXXXXXXX1608,Account Payment,25.12 RAILWAY 4XX*5191 14 MAY XX1608 25.12 RAILWAY 4XXXXX*5191 14 MAY XXXXXXXXXXXXXXXXXXX1608,473.64,,1381859.28,AccountTransactionsReport.csv,406,2025-05,False,Other Computer Services,Other Computer Services,Other Computer Services
,2025-05-16,8400/000 : FNB,"Github Inc. 14.00 GITHUB, INC. 4XXXXX*5225 14 MAY XXXXXXXXXXXXXXXXXXX4640 Github Inc.",Account Payment,"Github Inc. 14.00 GITHUB, INC. 4XXXXX*5225 14 MAY XXXXXXXXXXXXXXXXXXX4640 Github Inc.",263.97,,1382123.25,AccountTransactionsReport.csv,407,2025-05,False,Development Tools,Development Tools,Development Tools
,2025-05-16,8400/000 : FNB,11.49 GOOGLE *Colab 4XX*5191 14 MAY XX9898 11.49 GOOGLE *Colab 4XXXXX*5191 14 MAY XXXXXXXXXXXXXXXXXX,Account Payment,11.49 GOOGLE *Colab 4XX*5191 14 MAY XX9898 11.49 GOOGLE *Colab 4XXXXX*5191 14 MAY XXXXXXXXXXXXXXXXX,216.64,,1382339.89,AccountTransactionsReport.csv,408,2025-05,False,Other Computer Services,Analytics & Monitoring,Analytics & Monitoring
,2025-05-16,8400/000 : FNB,280.00 WIZA.CO 4XX*5191 14 MAY XX6125 280.00 WIZA.CO 4XXXXX*5191 14 MAY XXXXXXXXXXXXXXXXXXX6125,Account Payment,280.00 WIZA.CO 4XX*5191 14 MAY XX6125 280.00 WIZA.CO 4XXXXX*5191 14 MAY XXXXXXXXXXXXXXXXXXX6125,5279.34,,1387619.23,AccountTransactionsReport.csv,409,2025-05,False,Other Computer Services,Other Computer Services,Other Computer Services
,2025-05-16,8400/000 : FNB,156.98 SLACK T0MN3D 4XX*5225 15 MAY XX1897 156.98 SLACK T0MN3D 4XXXXX*5225 15 MAY XXXXXXXXXXXXXXXXXX,Account Payment,156.98 SLACK T0MN3D 4XX*5225 15 MAY XX1897 156.98 SLACK T0MN3D 4XXXXX*5225 15 MAY XXXXXXXXXXXXXXXXX,2943.44,,1390562.67,AccountTransactionsReport.csv,410,2025-05,False,Communication,Communication,Communication
,2025-05-16,8400/000 : FNB,"52.20 REPLIT, INC. 4XX*5191 14 MAY XX8688 52.20 REPLIT, INC. 4XXXXX*5191 14 MAY XXXXXXXXXXXXXXXXXXX8",Account Payment,"52.20 REPLIT, INC. 4XX*5191 14 MAY XX8688 52.20 REPLIT, INC. 4XXXXX*5191 14 MAY XXXXXXXXXXXXXXXXXXX",984.22,,1391546.89,AccountTransactionsReport.csv,411,2025-05,False,Other Computer Services,Other Computer Services,Other Computer Services
,2025-05-17,8400/000 : FNB,376.40 HOLASPIRIT 4XX*5225 15 MAY XX4365 376.40 HOLASPIRIT 4XXXXX*5225 15 MAY XXXXXXXXXXXXXXXXXXX436,Account Payment,376.40 HOLASPIRIT 4XX*5225 15 MAY XX4365 376.40 HOLASPIRIT 4XXXXX*5225 15 MAY XXXXXXXXXXXXXXXXXXX43,7932.59,,1399479.48,AccountTransactionsReport.csv,412,2025-05,False,Other Computer Services,Other Computer Services,Other Computer Services
,2025-05-17,8400/000 : FNB,231.95 HOLASPIRIT 4XX*5225 15 MAY XX9575 231.95 HOLASPIRIT 4XXXXX*5225 15 MAY XXXXXXXXXXXXXXXXXXX957,Account Payment,231.95 HOLASPIRIT 4XX*5225 15 MAY XX9575 231.95 HOLASPIRIT 4XXXXX*5225 15 MAY XXXXXXXXXXXXXXXXXXX95,4888.32,,1404367.8,AccountTransactionsReport.csv,413,2025-05,False,Other Computer Services,Other Computer Services,Other Computer Services
,2025-05-17,8400/000 : FNB,350.00 FRAMER.COM 4XX*5191 16 MAY XX6981 350.00 FRAMER.COM 4XXXXX*5191 16 MAY XXXXXXXXXXXXXXXXXXX698,Account Payment,350.00 FRAMER.COM 4XX*5191 16 MAY XX6981 350.00 FRAMER.COM 4XXXXX*5191 16 MAY XXXXXXXXXXXXXXXXXXX69,350.0,,1404717.8,AccountTransactionsReport.csv,414,2025-05,False,Other Computer Services,Design Tools,Design Tools
,2025-05-19,8400/000 : FNB,20.00 VERCEL INC. 4XX*5191 16 MAY XX1268 20.00 VERCEL INC. 4XXXXX*5191 16 MAY XXXXXXXXXXXXXXXXXXX126,Account Payment,20.00 VERCEL INC. 4XX*5191 16 MAY XX1268 20.00 VERCEL INC. 4XXXXX*5191 16 MAY XXXXXXXXXXXXXXXXXXX12,373.52,,1405091.32,AccountTransactionsReport.csv,415,2025-05,False,Cloud Services,Cloud Services,Cloud Services
,2025-05-20,8400/000 : FNB,Wix.com 579.60 WIX.COM 4XXXXX*5191 18 MAY XXXXXXXXXXXXXXXXXXX6952 Wix.com,Account Payment,Wix.com 579.60 WIX.COM 4XXXXX*5191 18 MAY XXXXXXXXXXXXXXXXXXX6952 Wix.com,10727.41,,1415818.73,AccountTransactionsReport.csv,416,2025-05,False,E-commerce Platforms,E-commerce Platforms,E-commerce Platforms
,2025-05-21,8400/000 : FNB,374.00 MANGOAPPS 4XX*5191 19 MAY XX5114 374.00 MANGOAPPS 4XXXXX*5191 19 MAY XXXXXXXXXXXXXXXXXXX5114,Account Payment,374.00 MANGOAPPS 4XX*5191 19 MAY XX5114 374.00 MANGOAPPS 4XXXXX*5191 19 MAY XXXXXXXXXXXXXXXXXXX5114,6922.11,,1422740.84,AccountTransactionsReport.csv,417,2025-05,False,Other Computer Services,Other Computer Services,Other Computer Services
,2025-05-21,8400/000 : FNB,59.00 GREENBACK.COM 4XX*5225 19 MAY XX9655 59.00 GREENBACK.COM 4XXXXX*5225 19 MAY XXXXXXXXXXXXXXXXXX,Account Payment,59.00 GREENBACK.COM 4XX*5225 19 MAY XX9655 59.00 GREENBACK.COM 4XXXXX*5225 19 MAY XXXXXXXXXXXXXXXXX,1091.99,,1423832.83,AccountTransactionsReport.csv,418,2025-05,False,Other Computer Services,Other Computer Services,Other Computer Services
,2025-05-22,8400/000 : FNB,"74.00 PIPEDREAM, IN 4XX*5191 20 MAY XX9052 74.00 PIPEDREAM, IN 4XXXXX*5191 20 MAY XXXXXXXXXXXXXXXXXX",Account Payment,"74.00 PIPEDREAM, IN 4XX*5191 20 MAY XX9052 74.00 PIPEDREAM, IN 4XXXXX*5191 20 MAY XXXXXXXXXXXXXXXXX",1367.02,,1425199.85,AccountTransactionsReport.csv,419,2025-05,False,Other Computer Services,Other Computer Services,Other Computer Services
,2025-05-22,8400/000 : FNB,54.00 AIRTABLE.COM/ 4XX*5191 21 MAY XX9771 54.00 AIRTABLE.COM/ 4XXXXX*5191 21 MAY XXXXXXXXXXXXXXXXXX,Account Payment,54.00 AIRTABLE.COM/ 4XX*5191 21 MAY XX9771 54.00 AIRTABLE.COM/ 4XXXXX*5191 21 MAY XXXXXXXXXXXXXXXXX,998.16,,1426198.01,AccountTransactionsReport.csv,420,2025-05,False,Other Computer Services,Collaboration Tools,Collaboration Tools
,2025-05-27,8400/000 : FNB,150.00 AUTH0.COM 4XX*5191 25 MAY XX4215 150.00 AUTH0.COM 4XXXXX*5191 25 MAY XXXXXXXXXXXXXXXXXXX4215,Account Payment,150.00 AUTH0.COM 4XX*5191 25 MAY XX4215 150.00 AUTH0.COM 4XXXXX*5191 25 MAY XXXXXXXXXXXXXXXXXXX4215,2759.57,,1428957.58,AccountTransactionsReport.csv,421,2025-05,False,Security Services,Security Services,Security Services
,2025-05-27,8400/000 : FNB,399.99 POE.COM 4XX*5191 26 MAY XX8987 399.99 POE.COM 4XXXXX*5191 26 MAY XXXXXXXXXXXXXXXXXXX8987,Account Payment,399.99 POE.COM 4XX*5191 26 MAY XX8987 399.99 POE.COM 4XXXXX*5191 26 MAY XXXXXXXXXXXXXXXXXXX8987,399.99,,1429357.57,AccountTransactionsReport.csv,422,2025-05,False,Other Computer Services,Other Computer Services,Other Computer Services
3300/020 : Computer - Platforms,Closing Balance as at: 28/02/2026,,,,,1429357.57,,,AccountTransactionsReport.csv,423,Unknown,False,Other Computer Services,Other Computer Services,Other Computer Services
,Movement for the period,,,,,1429357.57,,,AccountTransactionsReport.csv,424,Unknown,False,Other Computer Services,Other Computer Services,Other Computer Services
,2024-03-01,8400/000 : FNB,74838424059105627089966,Account Payment,546.25 INTUIT QBoo 4910505225 28 FEB 74838424059105627089966,546.25,,546.25,AccountTransactionsReport(1).csv,425,2024-03,False,Productivity Software,Productivity Software,Productivity Software
,2024-03-01,8400/000 : FNB,74838424059105627089958,Account Payment,546.25 INTUIT QBoo 4910505225 28 FEB 74838424059105627089958,546.25,,1092.5,AccountTransactionsReport(1).csv,426,2024-03,False,Productivity Software,Productivity Software,Productivity Software
,2024-03-01,8400/000 : FNB,24011344060000013555616,Account Payment,141.99 CANVA I0407 4910505225 29 FEB 24011344060000013555616,141.99,,1234.49,AccountTransactionsReport(1).csv,427,2024-03,False,Other Computer Services,Design Tools,Design Tools
,2024-03-01,8400/000 : FNB,24492154060715485858617,Account Payment,182.85 WIX.COM 4910505191 29 FEB 24492154060715485858617,3605.29,,4839.78,AccountTransactionsReport(1).csv,428,2024-03,False,E-commerce Platforms,E-commerce Platforms,E-commerce Platforms
,2024-03-01,8400/000 : FNB,74007484060245460213921,Account Payment,6338.80 CBAMindjet 4910505191 28 FEB 74007484060245460213921,6338.8,,11178.58,AccountTransactionsReport(1).csv,429,2024-03,False,Other Computer Services,Other Computer Services,Other Computer Services
,2024-03-02,8400/000 : FNB,74389244060000000034543,Account Payment,39.56 FRAPPE CLOUD 4910505191 29 FEB 74389244060000000034543,780.01,,11958.59,AccountTransactionsReport(1).csv,430,2024-03,False,Other Computer Services,Other Computer Services,Other Computer Services
,2024-03-02,8400/000 : FNB,74143614061000065948652,Account Payment,606.30 FACEBK 7L8R 4910505191 29 FEB 74143614061000065948652,606.3,,12564.89,AccountTransactionsReport(1).csv,431,2024-03,False,Other Computer Services,Other Computer Services,Other Computer Services
,2024-03-02,8400/000 : FNB,74143614061000065086818,Account Payment,230.00 FACEBK 6YHQ 4910505191 29 FEB 74143614061000065086818,230.0,,12794.89,AccountTransactionsReport(1).csv,432,2024-03,False,Other Computer Services,Other Computer Services,Other Computer Services
,2024-03-04,8400/000 : FNB,74697694062920050377883,Account Payment,48.24 GOOGLEGSUITE 4910505225 01 MAR 74697694062920050377883,1031.76,,13826.65,AccountTransactionsReport(1).csv,433,2024-03,False,Other Computer Services,Analytics & Monitoring,Analytics & Monitoring
,2024-03-04,8400/000 : FNB,74796314061000800649059,Account Payment,18.40 FACEBK FACEB 4910505191 01 MAR 74796314061000800649059,362.9,,14189.55,AccountTransactionsReport(1).csv,434,2024-03,False,Other Computer Services,Other Computer Services,Other Computer Services
,2024-03-04,8400/000 : FNB,24011344061000080872109,Account Payment,29.00 ECM A LEGALZ 4910505191 01 MAR 24011344061000080872109,571.95,,14761.5,AccountTransactionsReport(1).csv,435,2024-03,False,Other Computer Services,Other Computer Services,Other Computer Services
,2024-03-04,8400/000 : FNB,24492164061000052396848,Account Payment,6.00 GLASSFROG 4910505191 01 MAR 24492164061000052396848,118.34,,14879.84,AccountTransactionsReport(1).csv,436,2024-03,False,Other Computer Services,Other Computer Services,Other Computer Services
,2024-03-04,8400/000 : FNB,74697694062920040509553,Account Payment,39.82 GOOGLEGSUITE 4910505191 01 MAR 74697694062920040509553,851.67,,15731.51,AccountTransactionsReport(1).csv,437,2024-03,False,Other Computer Services,Analytics & Monitoring,Analytics & Monitoring
,2024-03-04,8400/000 : FNB,74838424061107522512007,Account Payment,546.25 INTUIT QBoo 4910505225 01 MAR 74838424061107522512007,546.25,,16277.76,AccountTransactionsReport(1).csv,438,2024-03,False,Productivity Software,Productivity Software,Productivity Software
,2024-03-04,8400/000 : FNB,24011344062000021572346,Account Payment,134.00 SINCH MAILGU 4910505191 02 MAR 24011344062000021572346,2631.58,,18909.34,AccountTransactionsReport(1).csv,439,2024-03,False,Other Computer Services,Other Computer Services,Other Computer Services
,2024-03-04,8400/000 : FNB,24011344061000044082902,Account Payment,1013.36 CANVA I040 4910505225 01 MAR 24011344061000044082902,1013.36,,19922.7,AccountTransactionsReport(1).csv,440,2024-03,False,Other Computer Services,Design Tools,Design Tools
,2024-03-04,8400/000 : FNB,74697694062920050389193,Account Payment,376.03 GOOGLEGSUIT 4910505225 01 MAR 74697694062920050389193,8042.56,,27965.26,AccountTransactionsReport(1).csv,441,2024-03,False,Other Computer Services,Analytics & Monitoring,Analytics & Monitoring
,2024-03-04,8400/000 : FNB,74697694062920040656727,Account Payment,29.81 GOOGLEGSUITE 4910505191 01 MAR 74697694062920040656727,587.94,,28553.2,AccountTransactionsReport(1).csv,442,2024-03,False,Other Computer Services,Analytics & Monitoring,Analytics & Monitoring
,2024-03-04,8400/000 : FNB,74796314061000900663042,Account Payment,18.40 FACEBK FACEB 4910505191 01 MAR 74796314061000900663042,362.9,,28916.1,AccountTransactionsReport(1).csv,443,2024-03,False,Other Computer Services,Other Computer Services,Other Computer Services
,2024-03-04,8400/000 : FNB,74609054061000011136978,Account Payment,4.76 SLACK T06A3T45 4910505191 01 MAR 74609054061000011136978,93.88,,29009.98,AccountTransactionsReport(1).csv,444,2024-03,False,Communication,Communication,Communication
,2024-03-04,8400/000 : FNB,74796314061000100531064,Account Payment,9.20 FACEBK FACEBK 4910505191 01 MAR 74796314061000100531064,181.45,,29191.43,AccountTransactionsReport(1).csv,445,2024-03,False,Other Computer Services,Other Computer Services,Other Computer Services
,2024-03-05,8400/000 : FNB,24492164064000018168114,Account Payment,1499.00 APPDIRECT 4910505225 04 MAR 24492164064000018168114,29438.33,,58629.76,AccountTransactionsReport(1).csv,446,2024-03,False,Other Computer Services,Other Computer Services,Other Computer Services
,2024-03-05,8400/000 : FNB,74201334062000006852834,Account Payment,450.00 WAPPALYZER 4910505191 02 MAR 74201334062000006852834,8837.39,,67467.15,AccountTransactionsReport(1).csv,447,2024-03,False,Other Computer Services,Other Computer Services,Other Computer Services
,2024-03-05,8400/000 : FNB,24011344064000021451309,Account Payment,279.96 STABLE 4910505191 04 MAR 24011344064000021451309,5498.03,,72965.18,AccountTransactionsReport(1).csv,448,2024-03,False,Other Computer Services,Other Computer Services,Other Computer Services
,2024-03-05,8400/000 : FNB,24011344063000051930645,Account Payment,143.20 MOZSEOHELP@ 4910505191 03 MAR 24011344063000051930645,2812.25,,75777.43,AccountTransactionsReport(1).csv,449,2024-03,False,Other Computer Services,Other Computer Services,Other Computer Services
,2024-03-05,8400/000 : FNB,74609054064000003356698,Account Payment,99.00 DMNS.APP BUSI 4910505191 04 MAR 74609054064000003356698,1944.22,,77721.65,AccountTransactionsReport(1).csv,450,2024-03,False,Other Computer Services,Other Computer Services,Other Computer Services
,2024-03-05,8400/000 : FNB,24011344063000021249241,Account Payment,95.00 10WEB.IO 4910505191 03 MAR 24011344063000021249241,1865.67,,79587.32,AccountTransactionsReport(1).csv,451,2024-03,False,Other Computer Services,Other Computer Services,Other Computer Services
,2024-03-05,8400/000 : FNB,74083424064000001286624,Account Payment,60.00 INSOMNIA TEAM 4910505191 03 MAR 74083424064000001286624,1178.31,,80765.63,AccountTransactionsReport(1).csv,452,2024-03,False,Other Computer Services,Other Computer Services,Other Computer Services
,2024-03-05,8400/000 : FNB,24492164064000015524384,Account Payment,4.95 SHELLS.COM 4910505191 04 MAR 24492164064000015524384,97.22,,80862.85,AccountTransactionsReport(1).csv,453,2024-03,False,Other Computer Services,Other Computer Services,Other Computer Services
,2024-03-05,8400/000 : FNB,24000774064000000318660,Account Payment,3.97 CLOUDFLARE 4910505191 04 MAR 24000774064000000318660,77.97,,80940.82,AccountTransactionsReport(1).csv,454,2024-03,False,Cloud Services,Cloud Services,Cloud Services
,2024-03-05,8400/000 : FNB,24492164062000046984922,Account Payment,1.00 VIRTONOMICS SI 4910505191 02 MAR 24492164062000046984922,19.64,,80960.46,AccountTransactionsReport(1).csv,455,2024-03,False,Other Computer Services,Other Computer Services,Other Computer Services
,2024-03-06,8400/000 : FNB,74143614065000103931617,Account Payment,2058.98 SHOPIFY 21 4910505191 04 MAR 74143614065000103931617,40435.58,,121396.04,AccountTransactionsReport(1).csv,456,2024-03,False,E-commerce Platforms,E-commerce Platforms,E-commerce Platforms
,2024-03-06,8400/000 : FNB,24011344064000053161727,Account Payment,329.00 TRIPLE WHALE 4910505191 04 MAR 24011344064000053161727,6461.12,,127857.16,AccountTransactionsReport(1).csv,457,2024-03,False,Other Computer Services,Other Computer Services,Other Computer Services
,2024-03-06,8400/000 : FNB,24492164065000019699595,Account Payment,120.75 MANAGEWP 4910505225 05 MAR 24492164065000019699595,2356.63,,130213.79,AccountTransactionsReport(1).csv,458,2024-03,False,Other Computer Services,Other Computer Services,Other Computer Services
,2024-03-06,8400/000 : FNB,24492164065000019693515,Account Payment,120.75 MANAGEWP 4910505225 05 MAR 24492164065000019693515,2356.63,,132570.42,AccountTransactionsReport(1).csv,459,2024-03,False,Other Computer Services,Other Computer Services,Other Computer Services
,2024-03-06,8400/000 : FNB,74601004064409070916123,Account Payment,408.94 MSFT E0700 4910505225 04 MAR 74601004064409070916123,408.94,,132979.36,AccountTransactionsReport(1).csv,460,2024-03,False,Other Computer Services,Other Computer Services,Other Computer Services
,2024-03-06,8400/000 : FNB,24492164064000040025142,Account Payment,19.00 GITHUB INC. 4910505225 04 MAR 24492164064000040025142,373.14,,133352.5,AccountTransactionsReport(1).csv,461,2024-03,False,Development Tools,Development Tools,Development Tools
,2024-03-06,8400/000 : FNB,24492164064000040200984,Account Payment,6.35 GITHUB INC. 4910505225 04 MAR 24492164064000040200984,124.71,,133477.21,AccountTransactionsReport(1).csv,462,2024-03,False,Development Tools,Development Tools,Development Tools
,2024-03-06,8400/000 : FNB,74548584065002707023227,Account Payment,SAGE ACC 4910505225 04 MAR 74548584065002707023227,3160.0,,136637.21,AccountTransactionsReport(1).csv,463,2024-03,False,Other Computer Services,Other Computer Services,Other Computer Services
,2024-03-07,8400/000 : FNB,74143614066000066921505,Account Payment,345.00 FACEBK PQPU 4910505191 05 MAR 74143614066000066921505,345.0,,136982.21,AccountTransactionsReport(1).csv,464,2024-03,False,Other Computer Services,Other Computer Services,Other Computer Services
,2024-03-07,8400/000 : FNB,74007484066246184341240,Account Payment,77.05 CBAPlesk 4910505191 05 MAR 74007484066246184341240,1503.76,,138485.97,AccountTransactionsReport(1).csv,465,2024-03,False,Domain & Hosting,Domain & Hosting,Domain & Hosting
,2024-03-07,8400/000 : FNB,24011344066000018908756,Account Payment,15.00 HIGHTAIL 4910505191 06 MAR 24011344066000018908756,292.32,,138778.29,AccountTransactionsReport(1).csv,466,2024-03,False,Other Computer Services,Other Computer Services,Other Computer Services
,2024-03-08,8400/000 : FNB,74987504066000113233021,Account Payment,690.00 FACEBK HABDX 4910505191 06 MAR 74987504066000113233021,690.0,,139468.29,AccountTransactionsReport(1).csv,467,2024-03,False,Other Computer Services,Other Computer Services,Other Computer Services
,2024-03-08,8400/000 : FNB,24011344066000058714502,Account Payment,20.00 VERCEL INC. 4910505225 06 MAR 24011344066000058714502,389.76,,139858.05,AccountTransactionsReport(1).csv,468,2024-03,False,Cloud Services,Cloud Services,Cloud Services
,2024-03-08,8400/000 : FNB,24011344066000058567868,Account Payment,20.00 VERCEL INC. 4910505225 06 MAR 24011344066000058567868,389.76,,140247.81,AccountTransactionsReport(1).csv,469,2024-03,False,Cloud Services,Cloud Services,Cloud Services
,2024-03-08,8400/000 : FNB,74609054066000010244273,Account Payment,19.99 WOOCOMMERCE S 4910505225 06 MAR 74609054066000010244273,389.56,,140637.37,AccountTransactionsReport(1).csv,470,2024-03,False,Other Computer Services,Other Computer Services,Other Computer Services
,2024-03-08,8400/000 : FNB,24492164067000013899736,Account Payment,7.00 NPM INC. 4910505191 07 MAR 24492164067000013899736,135.72,,140773.09,AccountTransactionsReport(1).csv,471,2024-03,False,Other Computer Services,Other Computer Services,Other Computer Services
,2024-03-08,8400/000 : FNB,24492164067000013874242,Account Payment,7.00 NPM INC. 4910505191 07 MAR 24492164067000013874242,135.72,,140908.81,AccountTransactionsReport(1).csv,472,2024-03,False,Other Computer Services,Other Computer Services,Other Computer Services
,2024-03-08,8400/000 : FNB,24492164067000013837579,Account Payment,7.00 NPM INC. 4910505191 07 MAR 24492164067000013837579,135.72,,141044.53,AccountTransactionsReport(1).csv,473,2024-03,False,Other Computer Services,Other Computer Services,Other Computer Services
,2024-03-08,8400/000 : FNB,24492164067000013620108,Account Payment,7.00 NPM INC. 4910505191 07 MAR 24492164067000013620108,135.72,,141180.25,AccountTransactionsReport(1).csv,474,2024-03,False,Other Computer Services,Other Computer Services,Other Computer Services
,2024-03-08,8400/000 : FNB,74208474067000011542216,Account Payment,3.60 GETADDRESS.IO 4910505225 07 MAR 74208474067000011542216,88.94,,141269.19,AccountTransactionsReport(1).csv,475,2024-03,False,Other Computer Services,Other Computer Services,Other Computer Services
,2024-03-09,8400/000 : FNB,24021214068012609863853,Account Payment,171.35 PADDLE.NETD 4910505191 08 MAR 24021214068012609863853,3299.63,,144568.82,AccountTransactionsReport(1).csv,476,2024-03,False,Other Computer Services,Subscription Management,Subscription Management
,2024-03-09,8400/000 : FNB,24492164068000000097293,Account Payment,99.00 MIOSALON.COM 4910505225 07 MAR 24492164068000000097293,1919.49,,146488.31,AccountTransactionsReport(1).csv,477,2024-03,False,Other Computer Services,Other Computer Services,Other Computer Services
,2024-03-09,8400/000 : FNB,24492164068000000067155,Account Payment,99.00 MIOSALON.COM 4910505225 07 MAR 24492164068000000067155,1919.49,,148407.8,AccountTransactionsReport(1).csv,478,2024-03,False,Other Computer Services,Other Computer Services,Other Computer Services
,2024-03-09,8400/000 : FNB,24000774068000003905741,Account Payment,28.75 CLOUDFLARE 4910505191 08 MAR 24000774068000003905741,553.63,,148961.43,AccountTransactionsReport(1).csv,479,2024-03,False,Cloud Services,Cloud Services,Cloud Services
,2024-03-09,8400/000 : FNB,74838424067102485556160,Account Payment,546.25 INTUIT QBoo 4910505225 07 MAR 74838424067102485556160,546.25,,149507.68,AccountTransactionsReport(1).csv,480,2024-03,False,Productivity Software,Productivity Software,Productivity Software
,2024-03-11,8400/000 : FNB,24492164068000042875680,Account Payment,150.00 AUTH0.COM 4910505191 08 MAR 24492164068000042875680,2888.5,,152396.18,AccountTransactionsReport(1).csv,481,2024-03,False,Security Services,Security Services,Security Services
,2024-03-11,8400/000 : FNB,24492164068000050171345,Account Payment,25.00 NOTION LABS 4910505191 08 MAR 24492164068000050171345,481.42,,152877.6,AccountTransactionsReport(1).csv,482,2024-03,False,Other Computer Services,Collaboration Tools,Collaboration Tools
,2024-03-12,8400/000 : FNB,74143254069000002269557,Account Payment,49.00 SKRAPP.IO STA 4910505191 09 MAR 74143254069000002269557,938.57,,153816.17,AccountTransactionsReport(1).csv,483,2024-03,False,Other Computer Services,Other Computer Services,Other Computer Services
,2024-03-12,8400/000 : FNB,24492164071000014844255,Account Payment,32.00 BUBBLE STARTE 4910505191 11 MAR 24492164071000014844255,612.94,,154429.11,AccountTransactionsReport(1).csv,484,2024-03,False,Other Computer Services,Other Computer Services,Other Computer Services
,2024-03-12,8400/000 : FNB,24492164070000012421230,Account Payment,25.00 NOTION LABS 4910505191 10 MAR 24492164070000012421230,478.86,,154907.97,AccountTransactionsReport(1).csv,485,2024-03,False,Other Computer Services,Collaboration Tools,Collaboration Tools
,2024-03-12,8400/000 : FNB,74143614071000933531282,Account Payment,345.00 FACEBK 7HE7 4910505191 10 MAR 74143614071000933531282,345.0,,155252.97,AccountTransactionsReport(1).csv,486,2024-03,False,Other Computer Services,Other Computer Services,Other Computer Services
,2024-03-12,8400/000 : FNB,24492164070000021571728,Account Payment,9.90 NOTION LABS I 4910505191 10 MAR 24492164070000021571728,189.63,,155442.6,AccountTransactionsReport(1).csv,487,2024-03,False,Other Computer Services,Collaboration Tools,Collaboration Tools
,2024-03-12,8400/000 : FNB,74143614071001100127565,Account Payment,3001.45 SHOPIFY 22 4910505225 10 MAR 74143614071001100127565,57491.16,,212933.76,AccountTransactionsReport(1).csv,488,2024-03,False,E-commerce Platforms,E-commerce Platforms,E-commerce Platforms
,2024-03-12,8400/000 : FNB,24011344071000019609364,Account Payment,99.00 DYNAMIC.XYZ 4910505191 11 MAR 24011344071000019609364,1896.29,,214830.05,AccountTransactionsReport(1).csv,489,2024-03,False,Other Computer Services,Other Computer Services,Other Computer Services
,2024-03-13,8400/000 : FNB,24492164071000034375397,Account Payment,189.00 GITHUB INC. 4910505225 11 MAR 24492164071000034375397,3620.19,,218450.24,AccountTransactionsReport(1).csv,490,2024-03,False,Development Tools,Development Tools,Development Tools
,2024-03-13,8400/000 : FNB,24492164071000034485832,Account Payment,63.00 GITHUB INC. 4910505225 11 MAR 24492164071000034485832,1206.73,,219656.97,AccountTransactionsReport(1).csv,491,2024-03,False,Development Tools,Development Tools,Development Tools
,2024-03-13,8400/000 : FNB,24492164071000034120397,Account Payment,42.00 GITHUB INC. 4910505225 11 MAR 24492164071000034120397,804.48,,220461.45,AccountTransactionsReport(1).csv,492,2024-03,False,Development Tools,Development Tools,Development Tools
,2024-03-13,8400/000 : FNB,74838424071105795137153,Account Payment,546.25 INTUIT QBoo 4910505225 11 MAR 74838424071105795137153,546.25,,221007.7,AccountTransactionsReport(1).csv,493,2024-03,False,Productivity Software,Productivity Software,Productivity Software
,2024-03-13,8400/000 : FNB,74838424071105795137104,Account Payment,546.25 INTUIT QBoo 4910505225 11 MAR 74838424071105795137104,546.25,,221553.95,AccountTransactionsReport(1).csv,494,2024-03,False,Productivity Software,Productivity Software,Productivity Software
,2024-03-13,8400/000 : FNB,24492164072000011883131,Account Payment,25.00 NOTION LABS 4910505191 12 MAR 24492164072000011883131,481.07,,222035.02,AccountTransactionsReport(1).csv,495,2024-03,False,Other Computer Services,Collaboration Tools,Collaboration Tools
,2024-03-14,8400/000 : FNB,24492164072000036530576,Account Payment,15.00 TABNINE 4910505191 12 MAR 24492164072000036530576,288.65,,222323.67,AccountTransactionsReport(1).csv,496,2024-03,False,Other Computer Services,Other Computer Services,Other Computer Services
,2024-03-15,8400/000 : FNB,74247284073820125340910,Account Payment,180.00 AGENCYANALYT 4910505225 13 MAR 74247284073820125340910,3448.03,,225771.7,AccountTransactionsReport(1).csv,497,2024-03,False,Other Computer Services,Other Computer Services,Other Computer Services
,2024-03-15,8400/000 : FNB,74987504073000909640059,Account Payment,690.00 FACEBK 46U9X 4910505191 13 MAR 74987504073000909640059,690.0,,226461.7,AccountTransactionsReport(1).csv,498,2024-03,False,Other Computer Services,Other Computer Services,Other Computer Services
,2024-03-16,8400/000 : FNB,24000774074000012937117,Account Payment,14.00 GITHUB INC. 4910505225 14 MAR 24000774074000012937117,268.08,,226729.78,AccountTransactionsReport(1).csv,499,2024-03,False,Development Tools,Development Tools,Development Tools
,2024-03-16,8400/000 : FNB,24011344075000036948684,Account Payment,23.00 FIGMA MONTHLY 4910505191 15 MAR 24011344075000036948684,441.08,,227170.86,AccountTransactionsReport(1).csv,500,2024-03,False,Other Computer Services,Design Tools,Design Tools
,2024-03-16,8400/000 : FNB,24049454075000001847146,Account Payment,456.00 ANIMA APP I 4910505191 15 MAR 24049454075000001847146,8744.77,,235915.63,AccountTransactionsReport(1).csv,501,2024-03,False,Other Computer Services,Other Computer Services,Other Computer Services
,2024-03-16,8400/000 : FNB,24049454075000001781659,Account Payment,456.00 ANIMA APP I 4910505191 15 MAR 24049454075000001781659,8744.77,,244660.4,AccountTransactionsReport(1).csv,502,2024-03,False,Other Computer Services,Other Computer Services,Other Computer Services
,2024-03-16,8400/000 : FNB,24011344074000085648251,Account Payment,280.00 WIZA.CO 4910505191 14 MAR 24011344074000085648251,5361.51,,250021.91,AccountTransactionsReport(1).csv,503,2024-03,False,Other Computer Services,Other Computer Services,Other Computer Services
,2024-03-18,8400/000 : FNB,74609054075000009646370,Account Payment,3085.00 FRAMER.COM 4910505191 15 MAR 74609054075000009646370,3085.0,,253106.91,AccountTransactionsReport(1).csv,504,2024-03,False,Other Computer Services,Design Tools,Design Tools
,2024-03-18,8400/000 : FNB,24011344075000058564559,Account Payment,67.85 FIGMA 4910505191 15 MAR 24011344075000058564559,1301.16,,254408.07,AccountTransactionsReport(1).csv,505,2024-03,False,Other Computer Services,Design Tools,Design Tools
,2024-03-18,8400/000 : FNB,74143614076000064800725,Account Payment,345.00 FACEBK T6HS 4910505191 15 MAR 74143614076000064800725,345.0,,254753.07,AccountTransactionsReport(1).csv,506,2024-03,False,Other Computer Services,Other Computer Services,Other Computer Services
,2024-03-19,8400/000 : FNB,74796314077000500007071,Account Payment,26415.96 MSFT E07 4910505225 17 MAR 74796314077000500007071,26415.96,,281169.03,AccountTransactionsReport(1).csv,507,2024-03,False,Other Computer Services,Other Computer Services,Other Computer Services
,2024-03-19,8400/000 : FNB,74601004077410313623034,Account Payment,5439.50 MSFT E070 4910505225 17 MAR 74601004077410313623034,5439.5,,286608.53,AccountTransactionsReport(1).csv,508,2024-03,False,Other Computer Services,Other Computer Services,Other Computer Services
,2024-03-19,8400/000 : FNB,24011344076000073368803,Account Payment,279.00 TRIPLE WHALE 4910505191 16 MAR 24011344076000073368803,5352.29,,291960.82,AccountTransactionsReport(1).csv,509,2024-03,False,Other Computer Services,Other Computer Services,Other Computer Services
,2024-03-19,8400/000 : FNB,74875304077000707584059,Account Payment,178.68 PipedriveUK 4910505191 17 MAR 74875304077000707584059,4365.1,,296325.92,AccountTransactionsReport(1).csv,510,2024-03,False,Other Computer Services,Other Computer Services,Other Computer Services
,2024-03-19,8400/000 : FNB,74143614078001022389353,Account Payment,74.75 SHOPIFY 2217 4910505225 16 MAR 74143614078001022389353,1433.99,,297759.91,AccountTransactionsReport(1).csv,511,2024-03,False,E-commerce Platforms,E-commerce Platforms,E-commerce Platforms
,2024-03-19,8400/000 : FNB,24011344077000030159336,Account Payment,1150.00 SQUARESPACE 4910505191 17 MAR 24011344077000030159336,1150.0,,298909.91,AccountTransactionsReport(1).csv,512,2024-03,False,Payment Processing,Payment Processing,Payment Processing
,2024-03-19,8400/000 : FNB,24011344078000026247334,Account Payment,9.00 EMMA AI 4910505191 18 MAR 24011344078000026247334,172.66,,299082.57,AccountTransactionsReport(1).csv,513,2024-03,False,Other Computer Services,Other Computer Services,Other Computer Services
,2024-03-20,8400/000 : FNB,74609054079000000384050,Account Payment,292.07 SLACK T0MN3D 4910505225 18 MAR 74609054079000000384050,5603.02,,304685.59,AccountTransactionsReport(1).csv,514,2024-03,False,Communication,Communication,Communication
,2024-03-20,8400/000 : FNB,24000774079000004218984,Account Payment,100.00 NAMEBIO 4910505191 19 MAR 24000774079000004218984,1938.86,,306624.45,AccountTransactionsReport(1).csv,515,2024-03,False,Other Computer Services,Other Computer Services,Other Computer Services
,2024-03-20,8400/000 : FNB,24692164078101485291595,Account Payment,100.00 INTUIT QBoo 4910505191 18 MAR 24692164078101485291595,1918.39,,308542.84,AccountTransactionsReport(1).csv,516,2024-03,False,Productivity Software,Productivity Software,Productivity Software
,2024-03-20,8400/000 : FNB,74208474079000006939431,Account Payment,46.80 ENDOLE.CO.UK 4910505191 19 MAR 74208474079000006939431,1154.94,,309697.78,AccountTransactionsReport(1).csv,517,2024-03,False,Other Computer Services,Other Computer Services,Other Computer Services
,2024-03-22,8400/000 : FNB,74838424079102248578945,Account Payment,546.25 INTUIT QBoo 4910505225 19 MAR 74838424079102248578945,546.25,,310244.03,AccountTransactionsReport(1).csv,518,2024-03,False,Productivity Software,Productivity Software,Productivity Software
,2024-03-22,8400/000 : FNB,74609054079000008092390,Account Payment,15.27 SLACK T4ENT13 4910505225 19 MAR 74609054079000008092390,296.07,,310540.1,AccountTransactionsReport(1).csv,519,2024-03,False,Communication,Communication,Communication
,2024-03-22,8400/000 : FNB,74143614081000061810308,Account Payment,345.00 FACEBK KYPB 4910505191 20 MAR 74143614081000061810308,345.0,,310885.1,AccountTransactionsReport(1).csv,520,2024-03,False,Other Computer Services,Other Computer Services,Other Computer Services
,2024-03-22,8400/000 : FNB,74838424079102250113169,Account Payment,546.25 INTUIT QBoo 4910505225 19 MAR 74838424079102250113169,546.25,,311431.35,AccountTransactionsReport(1).csv,521,2024-03,False,Productivity Software,Productivity Software,Productivity Software
,2024-03-22,8400/000 : FNB,74838424079102256738613,Account Payment,546.25 INTUIT QBoo 4910505225 19 MAR 74838424079102256738613,546.25,,311977.6,AccountTransactionsReport(1).csv,522,2024-03,False,Productivity Software,Productivity Software,Productivity Software
,2024-03-22,8400/000 : FNB,74007484081248316945428,Account Payment,249.00 CBACCleaner 4910505191 20 MAR 74007484081248316945428,249.0,,312226.6,AccountTransactionsReport(1).csv,523,2024-03,False,Other Computer Services,Other Computer Services,Other Computer Services
,2024-03-22,8400/000 : FNB,24011344079000043863732,Account Payment,59.00 GREENBACK.COM 4910505225 19 MAR 24011344079000043863732,1143.92,,313370.52,AccountTransactionsReport(1).csv,524,2024-03,False,Other Computer Services,Other Computer Services,Other Computer Services
,2024-03-22,8400/000 : FNB,24492164080000009425598,Account Payment,20.00 REPLIT INC. 4910505225 20 MAR 24492164080000009425598,388.4,,313758.92,AccountTransactionsReport(1).csv,525,2024-03,False,Other Computer Services,Other Computer Services,Other Computer Services
,2024-03-22,8400/000 : FNB,74987504080000604031043,Account Payment,690.00 FACEBK S5VK8 4910505191 20 MAR 74987504080000604031043,690.0,,314448.92,AccountTransactionsReport(1).csv,526,2024-03,False,Other Computer Services,Other Computer Services,Other Computer Services
,2024-03-22,8400/000 : FNB,74838424079102256738605,Account Payment,264.50 INTUIT QBoo 4910505225 19 MAR 74838424079102256738605,264.5,,314713.42,AccountTransactionsReport(1).csv,527,2024-03,False,Productivity Software,Productivity Software,Productivity Software
,2024-03-22,8400/000 : FNB,24000774081000004898161,Account Payment,54.00 AIRTABLE.COM 4910505191 21 MAR 24000774081000004898161,1045.3,,315758.72,AccountTransactionsReport(1).csv,528,2024-03,False,Other Computer Services,Collaboration Tools,Collaboration Tools
,2024-03-23,8400/000 : FNB,24492154082713363979039,Account Payment,1.00 BEENVERIFIED I 4910505191 22 MAR 24492154082713363979039,19.26,,315777.98,AccountTransactionsReport(1).csv,529,2024-03,False,Other Computer Services,Other Computer Services,Other Computer Services
,2024-03-25,8400/000 : FNB,74609054083000001401220,Account Payment,299.00 TIME IS LTD 4910505191 22 MAR 74609054083000001401220,5821.76,,321599.74,AccountTransactionsReport(1).csv,530,2024-03,False,Other Computer Services,Other Computer Services,Other Computer Services
,2024-03-25,8400/000 : FNB,24430994083091089002326,Account Payment,378.35 DNHGODADDY. 4910505191 22 MAR 24430994083091089002326,378.35,,321978.09,AccountTransactionsReport(1).csv,531,2024-03,False,Domain & Hosting,Domain & Hosting,Domain & Hosting
,2024-03-25,STOCK2SHOP (PTY) LTD,WWI31301,Supplier Invoice,B2B Trade Store,253.2,,322231.29,AccountTransactionsReport(1).csv,532,2024-03,False,E-commerce Platforms,E-commerce Platforms,E-commerce Platforms
,2024-03-26,8400/000 : FNB,74609054085000000504303,Account Payment,10.00 MATTERMOST 4910505191 24 MAR 74609054085000000504303,194.71,,322426.0,AccountTransactionsReport(1).csv,533,2024-03,False,Other Computer Services,Other Computer Services,Other Computer Services
,2024-03-26,8400/000 : FNB,74609054083000004315310,Account Payment,17.25 SLACK T1AS3LC 4910505191 23 MAR 74609054083000004315310,335.88,,322761.88,AccountTransactionsReport(1).csv,534,2024-03,False,Communication,Communication,Communication
,2024-03-26,8400/000 : FNB,74987504084001522838036,Account Payment,18.38 Dropbox 11TDM 4910505191 24 MAR 74987504084001522838036,357.88,,323119.76,AccountTransactionsReport(1).csv,535,2024-03,False,Other Computer Services,Other Computer Services,Other Computer Services
,2024-03-26,8400/000 : FNB,74609054085000003855900,Account Payment,376.40 HOLASPIRIT 4910505225 25 MAR 74609054085000003855900,7937.35,,331057.11,AccountTransactionsReport(1).csv,536,2024-03,False,Other Computer Services,Other Computer Services,Other Computer Services
,2024-03-26,8400/000 : FNB,74609054085000003938060,Account Payment,231.95 HOLASPIRIT 4910505225 25 MAR 74609054085000003938060,4891.26,,335948.37,AccountTransactionsReport(1).csv,537,2024-03,False,Other Computer Services,Other Computer Services,Other Computer Services
,2024-03-26,8400/000 : FNB,74987504084000009395080,Account Payment,1124.99 LinkedIn SN 4910505191 24 MAR 74987504084000009395080,1124.99,,337073.36,AccountTransactionsReport(1).csv,538,2024-03,False,Other Computer Services,Other Computer Services,Other Computer Services
,2024-03-26,8400/000 : FNB,24011344084000047613508,Account Payment,34.12 WWW.MAKE.COM 4910505191 24 MAR 24011344084000047613508,664.35,,337737.71,AccountTransactionsReport(1).csv,539,2024-03,False,Other Computer Services,API Services,API Services
,2024-03-26,8400/000 : FNB,74609054084000001043062,Account Payment,30.00 HASURA 4910505191 23 MAR 74609054084000001043062,584.12,,338321.83,AccountTransactionsReport(1).csv,540,2024-03,False,Other Computer Services,Other Computer Services,Other Computer Services
,2024-03-27,8400/000 : FNB,24492164086000003096399,Account Payment,150.00 AUTH0.COM 4910505191 25 MAR 24492164086000003096399,2913.56,,341235.39,AccountTransactionsReport(1).csv,541,2024-03,False,Security Services,Security Services,Security Services
,2024-03-27,8400/000 : FNB,74143614086000061800940,Account Payment,345.00 FACEBK 3AZU 4910505191 25 MAR 74143614086000061800940,345.0,,341580.39,AccountTransactionsReport(1).csv,542,2024-03,False,Other Computer Services,Other Computer Services,Other Computer Services
,2024-03-28,8400/000 : FNB,74987504086000512892027,Account Payment,690.00 FACEBK NHRE7 4910505191 26 MAR 74987504086000512892027,690.0,,342270.39,AccountTransactionsReport(1).csv,543,2024-03,False,Other Computer Services,Other Computer Services,Other Computer Services
,2024-03-28,8400/000 : FNB,74143614087000058223998,Account Payment,47.61 FACEBK 2NAAL 4910505191 26 MAR 74143614087000058223998,47.61,,342318.0,AccountTransactionsReport(1).csv,544,2024-03,False,Other Computer Services,Other Computer Services,Other Computer Services
,2024-03-28,STOCK2SHOP (PTY) LTD,WWI31306,Supplier Invoice,3300/020 : Computer - Platforms,3134.4,,345452.4,AccountTransactionsReport(1).csv,545,2024-03,False,E-commerce Platforms,E-commerce Platforms,E-commerce Platforms
,2024-03-30,8400/000 : FNB,24011344089000013168441,Account Payment,141.99 CANVA I0410 4910505225 29 MAR 24011344089000013168441,141.99,,345594.39,AccountTransactionsReport(1).csv,546,2024-03,False,Other Computer Services,Design Tools,Design Tools
,2024-03-30,8400/000 : FNB,74838424087109098117799,Account Payment,34.99 GOOGLE Googl 4910505191 27 MAR 74838424087109098117799,34.99,,345629.38,AccountTransactionsReport(1).csv,547,2024-03,False,Other Computer Services,Analytics & Monitoring,Analytics & Monitoring
,2024-03-30,8400/000 : FNB,74143614088000113662452,Account Payment,3041.60 SHOPIFY 22 4910505225 27 MAR 74143614088000113662452,58969.37,,404598.75,AccountTransactionsReport(1).csv,548,2024-03,False,E-commerce Platforms,E-commerce Platforms,E-commerce Platforms
,2024-03-30,8400/000 : FNB,74838424088109673658166,Account Payment,546.25 INTUIT QBoo 4910505225 28 MAR 74838424088109673658166,546.25,,405145.0,AccountTransactionsReport(1).csv,549,2024-03,False,Productivity Software,Productivity Software,Productivity Software
,2024-03-30,8400/000 : FNB,74838424088109673658141,Account Payment,546.25 INTUIT QBoo 4910505225 28 MAR 74838424088109673658141,546.25,,405691.25,AccountTransactionsReport(1).csv,550,2024-03,False,Productivity Software,Productivity Software,Productivity Software
,2024-04-02,8400/000 : FNB,74143614092000942780206,Account Payment,345.00 FACEBK 6J9R 4910505191 31 MAR 74143614092000942780206,345.0,,406036.25,AccountTransactionsReport(1).csv,551,2024-04,False,Other Computer Services,Other Computer Services,Other Computer Services
,2024-04-02,8400/000 : FNB,24011344089000035142457,Account Payment,5050.80 FRESHWORKS 4910505225 29 MAR 24011344089000035142457,5050.8,,411087.05,AccountTransactionsReport(1).csv,552,2024-04,False,Productivity Software,Productivity Software,Productivity Software
,2024-04-02,8400/000 : FNB,24492164089000019417743,Account Payment,20.00 YOU.COM 4910505191 29 MAR 24492164089000019417743,389.93,,411476.98,AccountTransactionsReport(1).csv,553,2024-04,False,Other Computer Services,Other Computer Services,Other Computer Services
,2024-04-02,8400/000 : FNB,74987504091000706730051,Account Payment,438.86 FACEBK 7E8BK 4910505191 31 MAR 74987504091000706730051,438.86,,411915.84,AccountTransactionsReport(1).csv,554,2024-04,False,Other Computer Services,Other Computer Services,Other Computer Services
,2024-04-02,8400/000 : FNB,74007484090249745537595,Account Payment,499.00 CBACCleaner 4910505191 29 MAR 74007484090249745537595,499.0,,412414.84,AccountTransactionsReport(1).csv,555,2024-04,False,Other Computer Services,Other Computer Services,Other Computer Services
,2024-04-02,8400/000 : FNB,74838424091102073159880,Account Payment,546.25 INTUIT QBoo 4910505225 31 MAR 74838424091102073159880,546.25,,412961.09,AccountTransactionsReport(1).csv,556,2024-04,False,Productivity Software,Productivity Software,Productivity Software
,2024-04-02,8400/000 : FNB,24492154089719641117170,Account Payment,29.99 BEENVERIFIED 4910505191 29 MAR 24492154089719641117170,580.15,,413541.24,AccountTransactionsReport(1).csv,557,2024-04,False,Other Computer Services,Other Computer Services,Other Computer Services
,2024-04-02,8400/000 : FNB,74389244091000000021857,Account Payment,49.91 FRAPPE CLOUD 4910505191 31 MAR 74389244091000000021857,965.48,,414506.72,AccountTransactionsReport(1).csv,558,2024-04,False,Other Computer Services,Other Computer Services,Other Computer Services
,2024-04-02,8400/000 : FNB,74208474090000015683546,Account Payment,119.94 CLINICSOFTWA 4910505225 30 MAR 74208474090000015683546,2934.19,,417440.91,AccountTransactionsReport(1).csv,559,2024-04,False,Other Computer Services,Other Computer Services,Other Computer Services
,2024-04-02,8400/000 : FNB,24492154089745582647982,Account Payment,182.85 WIX.COM 4910505191 29 MAR 24492154089745582647982,3537.14,,420978.05,AccountTransactionsReport(1).csv,560,2024-04,False,E-commerce Platforms,E-commerce Platforms,E-commerce Platforms
,2024-04-03,8400/000 : FNB,74697694093920045396231,Account Payment,391.60 GOOGLEGSUIT 4910505225 01 APR 74697694093920045396231,8184.3,,429162.35,AccountTransactionsReport(1).csv,561,2024-04,False,Other Computer Services,Analytics & Monitoring,Analytics & Monitoring
,2024-04-03,8400/000 : FNB,74609054092000007097989,Account Payment,17.25 SLACK T06A3T4 4910505191 01 APR 74609054092000007097989,333.69,,429496.04,AccountTransactionsReport(1).csv,562,2024-04,False,Communication,Communication,Communication
,2024-04-03,8400/000 : FNB,74987504092001376460051,Account Payment,12.00 GSUITE_rzoneu 4910505191 01 APR 74987504092001376460051,293.57,,429789.61,AccountTransactionsReport(1).csv,563,2024-04,False,Other Computer Services,Other Computer Services,Other Computer Services
,2024-04-03,8400/000 : FNB,74796314092000400758071,Account Payment,9.20 FACEBK FACEBK 4910505191 01 APR 74796314092000400758071,177.97,,429967.58,AccountTransactionsReport(1).csv,564,2024-04,False,Other Computer Services,Other Computer Services,Other Computer Services
,2024-04-03,8400/000 : FNB,24049454092000002330026,Account Payment,6.00 GLASSFROG 4910505191 01 APR 24049454092000002330026,116.07,,430083.65,AccountTransactionsReport(1).csv,565,2024-04,False,Other Computer Services,Other Computer Services,Other Computer Services
,2024-04-03,8400/000 : FNB,74697694093920041549783,Account Payment,1.45 GOOGLECLOUD J 4910505191 01 APR 74697694093920041549783,28.05,,430111.7,AccountTransactionsReport(1).csv,566,2024-04,False,Other Computer Services,Analytics & Monitoring,Analytics & Monitoring
,2024-04-03,8400/000 : FNB,24011344093000018881786,Account Payment,134.00 SINCH MAILGU 4910505191 02 APR 24011344093000018881786,2601.58,,432713.28,AccountTransactionsReport(1).csv,567,2024-04,False,Other Computer Services,Other Computer Services,Other Computer Services
,2024-04-03,8400/000 : FNB,74697694093920045511888,Account Payment,83.96 GOOGLEGSUITE 4910505225 01 APR 74697694093920045511888,1754.74,,434468.02,AccountTransactionsReport(1).csv,568,2024-04,False,Other Computer Services,Analytics & Monitoring,Analytics & Monitoring
,2024-04-03,8400/000 : FNB,74796314092000300753032,Account Payment,46.00 FACEBK FACEB 4910505191 01 APR 74796314092000300753032,889.85,,435357.87,AccountTransactionsReport(1).csv,569,2024-04,False,Other Computer Services,Other Computer Services,Other Computer Services
,2024-04-03,8400/000 : FNB,74697694093920041440488,Account Payment,39.82 GOOGLEGSUITE 4910505191 01 APR 74697694093920041440488,832.23,,436190.1,AccountTransactionsReport(1).csv,570,2024-04,False,Other Computer Services,Analytics & Monitoring,Analytics & Monitoring
,2024-04-03,8400/000 : FNB,74796314092000077633045,Account Payment,29.81 GSUITE_zone.m 4910505191 01 APR 74796314092000077633045,576.66,,436766.76,AccountTransactionsReport(1).csv,571,2024-04,False,Other Computer Services,Other Computer Services,Other Computer Services
,2024-04-03,8400/000 : FNB,24492164092000046592331,Account Payment,29.00 VIRTONOMICS S 4910505191 01 APR 24492164092000046592331,560.99,,437327.75,AccountTransactionsReport(1).csv,572,2024-04,False,Other Computer Services,Other Computer Services,Other Computer Services
,2024-04-03,8400/000 : FNB,24011344092000062884877,Account Payment,29.00 ECM A LEGALZ 4910505191 01 APR 24011344092000062884877,560.99,,437888.74,AccountTransactionsReport(1).csv,573,2024-04,False,Other Computer Services,Other Computer Services,Other Computer Services
,2024-04-03,8400/000 : FNB,74796314092000800848050,Account Payment,27.60 FACEBK FACEB 4910505191 01 APR 74796314092000800848050,533.91,,438422.65,AccountTransactionsReport(1).csv,574,2024-04,False,Other Computer Services,Other Computer Services,Other Computer Services
,2024-04-04,8400/000 : FNB,74201334093000007019295,Account Payment,450.00 WAPPALYZER 4910505191 02 APR 74201334093000007019295,8736.65,,447159.3,AccountTransactionsReport(1).csv,575,2024-04,False,Other Computer Services,Other Computer Services,Other Computer Services
,2024-04-04,8400/000 : FNB,24906414093197117460717,Account Payment,3883.91 DNHGODADDY 4910505191 02 APR 24906414093197117460717,3883.91,,451043.21,AccountTransactionsReport(1).csv,576,2024-04,False,Domain & Hosting,Domain & Hosting,Domain & Hosting
,2024-04-05,8400/000 : FNB,74922134094037630010631,Account Payment,BOB GROUP 4910505191 01 APR 74922134094037630010631,2298.85,,453342.06,AccountTransactionsReport(1).csv,577,2024-04,False,Other Computer Services,Other Computer Services,Other Computer Services
,2024-04-05,8400/000 : FNB,74609054095000002252289,Account Payment,99.00 DMNS.APP BUSI 4910505191 04 APR 74609054095000002252289,1905.13,,455247.19,AccountTransactionsReport(1).csv,578,2024-04,False,Other Computer Services,Other Computer Services,Other Computer Services
,2024-04-05,8400/000 : FNB,74083424095000001489379,Account Payment,60.00 INSOMNIA TEAM 4910505191 03 APR 74083424095000001489379,1154.62,,456401.81,AccountTransactionsReport(1).csv,579,2024-04,False,Other Computer Services,Other Computer Services,Other Computer Services
,2024-04-05,8400/000 : FNB,24000774095000005601550,Account Payment,4.95 SHELLS.COM 4910505191 04 APR 24000774095000005601550,95.26,,456497.07,AccountTransactionsReport(1).csv,580,2024-04,False,Other Computer Services,Other Computer Services,Other Computer Services
,2024-04-05,8400/000 : FNB,24011344095000024326287,Account Payment,4.87 TRIPLE WHALE 4910505191 04 APR 24011344095000024326287,93.72,,456590.79,AccountTransactionsReport(1).csv,581,2024-04,False,Other Computer Services,Other Computer Services,Other Computer Services
,2024-04-05,8400/000 : FNB,24492164095000012290883,Account Payment,1499.00 APPDIRECT 4910505225 04 APR 24492164095000012290883,28846.33,,485437.12,AccountTransactionsReport(1).csv,582,2024-04,False,Other Computer Services,Other Computer Services,Other Computer Services
,2024-04-05,8400/000 : FNB,24011344095000023001774,Account Payment,249.00 STABLE 4910505191 04 APR 24011344095000023001774,4791.68,,490228.8,AccountTransactionsReport(1).csv,583,2024-04,False,Other Computer Services,Other Computer Services,Other Computer Services
,2024-04-05,8400/000 : FNB,24011344094000063579789,Account Payment,143.20 MOZSEOHELP@ 4910505191 03 APR 24011344094000063579789,2779.84,,493008.64,AccountTransactionsReport(1).csv,584,2024-04,False,Other Computer Services,Other Computer Services,Other Computer Services
,2024-04-05,8400/000 : FNB,74922134094037630011217,Account Payment,BOB GROUP 4910505191 01 APR 74922134094037630011217,2298.85,,495307.49,AccountTransactionsReport(1).csv,585,2024-04,False,Other Computer Services,Other Computer Services,Other Computer Services
,2024-04-06,8400/000 : FNB,24000774095000014064741,Account Payment,7.40 GITHUB INC. 4910505225 04 APR 24000774095000014064741,142.4,,495449.89,AccountTransactionsReport(1).csv,586,2024-04,False,Development Tools,Development Tools,Development Tools
,2024-04-06,8400/000 : FNB,24000774095000013877093,Account Payment,19.00 GITHUB INC. 4910505225 04 APR 24000774095000013877093,365.63,,495815.52,AccountTransactionsReport(1).csv,587,2024-04,False,Development Tools,Development Tools,Development Tools
,2024-04-06,8400/000 : FNB,24011344096000000761225,Account Payment,599.00 TRIPLE WHALE 4910505191 04 APR 24011344096000000761225,11526.99,,507342.51,AccountTransactionsReport(1).csv,588,2024-04,False,Other Computer Services,Other Computer Services,Other Computer Services
,2024-04-06,8400/000 : FNB,74143614096000103723165,Account Payment,2058.98 SHOPIFY 22 4910505191 04 APR 74143614096000103723165,39622.44,,546964.95,AccountTransactionsReport(1).csv,589,2024-04,False,E-commerce Platforms,E-commerce Platforms,E-commerce Platforms
,2024-04-06,8400/000 : FNB,24011344096000019170343,Account Payment,134.00 SQUARESPACE 4910505191 05 APR 24011344096000019170343,134.0,,547098.95,AccountTransactionsReport(1).csv,590,2024-04,False,Payment Processing,Payment Processing,Payment Processing
,2024-04-08,8400/000 : FNB,74007484097250498874196,Account Payment,77.05 CBAPlesk 4910505191 05 APR 74007484097250498874196,1474.27,,548573.22,AccountTransactionsReport(1).csv,591,2024-04,False,Domain & Hosting,Domain & Hosting,Domain & Hosting
,2024-04-08,8400/000 : FNB,24011344097000020265271,Account Payment,15.00 HIGHTAIL 4910505191 06 APR 24011344097000020265271,287.32,,548860.54,AccountTransactionsReport(1).csv,592,2024-04,False,Other Computer Services,Other Computer Services,Other Computer Services
,2024-04-09,8400/000 : FNB,24492164098000009261308,Account Payment,7.00 NPM INC. 4910505191 07 APR 24492164098000009261308,134.09,,548994.63,AccountTransactionsReport(1).csv,593,2024-04,False,Other Computer Services,Other Computer Services,Other Computer Services
,2024-04-09,8400/000 : FNB,74609054098000004067443,Account Payment,9.00 GITPOD.IO 4910505191 07 APR 74609054098000004067443,172.39,,549167.02,AccountTransactionsReport(1).csv,594,2024-04,False,Development Tools,Development Tools,Development Tools
,2024-04-09,8400/000 : FNB,74609054097000007779623,Account Payment,19.99 WOOCOMMERCE S 4910505225 06 APR 74609054097000007779623,382.91,,549549.93,AccountTransactionsReport(1).csv,595,2024-04,False,Other Computer Services,Other Computer Services,Other Computer Services
,2024-04-09,8400/000 : FNB,24011344097000061712512,Account Payment,20.00 VERCEL INC. 4910505225 06 APR 24011344097000061712512,383.1,,549933.03,AccountTransactionsReport(1).csv,596,2024-04,False,Cloud Services,Cloud Services,Cloud Services
,2024-04-09,8400/000 : FNB,24011344097000063684123,Account Payment,20.00 VERCEL INC. 4910505225 06 APR 24011344097000063684123,383.1,,550316.13,AccountTransactionsReport(1).csv,597,2024-04,False,Cloud Services,Cloud Services,Cloud Services
,2024-04-09,8400/000 : FNB,24168884098104976702363,Account Payment,546.25 INTUIT QBoo 4910505225 07 APR 24168884098104976702363,546.25,,550862.38,AccountTransactionsReport(1).csv,598,2024-04,False,Productivity Software,Productivity Software,Productivity Software
,2024-04-09,8400/000 : FNB,24492164099000000037458,Account Payment,99.00 MIOSALON.COM 4910505225 07 APR 24492164099000000037458,1896.34,,552758.72,AccountTransactionsReport(1).csv,599,2024-04,False,Other Computer Services,Other Computer Services,Other Computer Services
,2024-04-09,8400/000 : FNB,74208474098000010518350,Account Payment,3.60 GETADDRESS.IO 4910505225 07 APR 74208474098000010518350,87.13,,552845.85,AccountTransactionsReport(1).csv,600,2024-04,False,Other Computer Services,Other Computer Services,Other Computer Services
,2024-04-09,8400/000 : FNB,24492164098000009100324,Account Payment,7.00 NPM INC. 4910505191 07 APR 24492164098000009100324,134.09,,552979.94,AccountTransactionsReport(1).csv,601,2024-04,False,Other Computer Services,Other Computer Services,Other Computer Services
,2024-04-09,8400/000 : FNB,24492164098000009213101,Account Payment,7.00 NPM INC. 4910505191 07 APR 24492164098000009213101,134.09,,553114.03,AccountTransactionsReport(1).csv,602,2024-04,False,Other Computer Services,Other Computer Services,Other Computer Services
,2024-04-09,8400/000 : FNB,24492164098000009255052,Account Payment,7.00 NPM INC. 4910505191 07 APR 24492164098000009255052,134.09,,553248.12,AccountTransactionsReport(1).csv,603,2024-04,False,Other Computer Services,Other Computer Services,Other Computer Services
,2024-04-09,8400/000 : FNB,24492164099000000062100,Account Payment,99.00 MIOSALON.COM 4910505225 07 APR 24492164099000000062100,1896.34,,555144.46,AccountTransactionsReport(1).csv,604,2024-04,False,Other Computer Services,Other Computer Services,Other Computer Services
,2024-04-09,8400/000 : FNB,24021214099016175440627,Account Payment,171.35 PADDLE.NETD 4910505191 08 APR 24021214099016175440627,3282.21,,558426.67,AccountTransactionsReport(1).csv,605,2024-04,False,Other Computer Services,Subscription Management,Subscription Management
,2024-04-10,8400/000 : FNB,24492164099000032428238,Account Payment,25.00 NOTION LABS 4910505191 08 APR 24492164099000032428238,478.87,,558905.54,AccountTransactionsReport(1).csv,606,2024-04,False,Other Computer Services,Collaboration Tools,Collaboration Tools
,2024-04-10,8400/000 : FNB,24000774099000007106372,Account Payment,28.75 CLOUDFLARE 4910505191 08 APR 24000774099000007106372,550.71,,559456.25,AccountTransactionsReport(1).csv,607,2024-04,False,Cloud Services,Cloud Services,Cloud Services
,2024-04-10,8400/000 : FNB,74143614100000062161070,Account Payment,575.00 FACEBK HY7U 4910505191 08 APR 74143614100000062161070,575.0,,560031.25,AccountTransactionsReport(1).csv,608,2024-04,False,Other Computer Services,Other Computer Services,Other Computer Services
,2024-04-10,8400/000 : FNB,74987504099001201957050,Account Payment,862.50 FACEBK T5NGE 4910505191 08 APR 74987504099001201957050,862.5,,560893.75,AccountTransactionsReport(1).csv,609,2024-04,False,Other Computer Services,Other Computer Services,Other Computer Services
,2024-04-10,8400/000 : FNB,24492164099000027125278,Account Payment,150.00 AUTH0.COM 4910505191 08 APR 24492164099000027125278,2873.25,,563767.0,AccountTransactionsReport(1).csv,610,2024-04,False,Security Services,Security Services,Security Services
,2024-04-11,8400/000 : FNB,74143254100000002378953,Account Payment,49.00 SKRAPP.IO STA 4910505191 09 APR 74143254100000002378953,937.35,,564704.35,AccountTransactionsReport(1).csv,611,2024-04,False,Other Computer Services,Other Computer Services,Other Computer Services
,2024-04-11,8400/000 : FNB,74838424100106731023338,Account Payment,546.25 INTUIT QBoo 4910505225 09 APR 74838424100106731023338,546.25,,565250.6,AccountTransactionsReport(1).csv,612,2024-04,False,Productivity Software,Productivity Software,Productivity Software
,2024-04-11,8400/000 : FNB,24492164101000009613008,Account Payment,102.74 NOTION LABS 4910505191 10 APR 24492164101000009613008,1956.02,,567206.62,AccountTransactionsReport(1).csv,613,2024-04,False,Other Computer Services,Collaboration Tools,Collaboration Tools
,2024-04-12,8400/000 : FNB,74143614102000109485290,Account Payment,3001.45 SHOPIFY 22 4910505225 10 APR 74143614102000109485290,57143.37,,624349.99,AccountTransactionsReport(1).csv,614,2024-04,False,E-commerce Platforms,E-commerce Platforms,E-commerce Platforms
,2024-04-12,8400/000 : FNB,24049454101000003144524,Account Payment,198.00 PLAYFAB INC 4910505191 10 APR 24049454101000003144524,3769.64,,628119.63,AccountTransactionsReport(1).csv,615,2024-04,False,Other Computer Services,Other Computer Services,Other Computer Services
,2024-04-12,8400/000 : FNB,24011344102000024690303,Account Payment,99.00 DYNAMIC.XYZ 4910505191 11 APR 24011344102000024690303,1900.03,,630019.66,AccountTransactionsReport(1).csv,616,2024-04,False,Other Computer Services,Other Computer Services,Other Computer Services
,2024-04-12,8400/000 : FNB,24492164102000012523672,Account Payment,32.00 BUBBLE STARTE 4910505191 11 APR 24492164102000012523672,614.15,,630633.81,AccountTransactionsReport(1).csv,617,2024-04,False,Other Computer Services,Other Computer Services,Other Computer Services
,2024-04-13,8400/000 : FNB,24000774102000014521253,Account Payment,42.00 GITHUB INC. 4910505225 11 APR 24000774102000014521253,806.08,,631439.89,AccountTransactionsReport(1).csv,618,2024-04,False,Development Tools,Development Tools,Development Tools
,2024-04-13,8400/000 : FNB,24000774102000014642513,Account Payment,63.00 GITHUB INC. 4910505225 11 APR 24000774102000014642513,1209.11,,632649.0,AccountTransactionsReport(1).csv,619,2024-04,False,Development Tools,Development Tools,Development Tools
,2024-04-13,8400/000 : FNB,24000774102000014574450,Account Payment,189.00 GITHUB INC. 4910505225 11 APR 24000774102000014574450,3627.32,,636276.32,AccountTransactionsReport(1).csv,620,2024-04,False,Development Tools,Development Tools,Development Tools
,2024-04-13,8400/000 : FNB,24168884102108166604283,Account Payment,546.25 INTUIT QBoo 4910505225 11 APR 24168884102108166604283,546.25,,636822.57,AccountTransactionsReport(1).csv,621,2024-04,False,Productivity Software,Productivity Software,Productivity Software
,2024-04-13,8400/000 : FNB,24168884102108166604291,Account Payment,546.25 INTUIT QBoo 4910505225 11 APR 24168884102108166604291,546.25,,637368.82,AccountTransactionsReport(1).csv,622,2024-04,False,Productivity Software,Productivity Software,Productivity Software
,2024-04-15,8400/000 : FNB,24000774103000017963824,Account Payment,15.00 TABNINE 4910505191 12 APR 24000774103000017963824,288.49,,637657.31,AccountTransactionsReport(1).csv,623,2024-04,False,Other Computer Services,Other Computer Services,Other Computer Services
,2024-04-16,8400/000 : FNB,24000774105000012957787,Account Payment,14.00 GITHUB INC. 4910505225 14 APR 24000774105000012957787,271.13,,637928.44,AccountTransactionsReport(1).csv,624,2024-04,False,Development Tools,Development Tools,Development Tools
,2024-04-16,8400/000 : FNB,24492164106000000303240,Account Payment,280.00 WIZA.CO 4910505191 14 APR 24492164106000000303240,5422.56,,643351.0,AccountTransactionsReport(1).csv,625,2024-04,False,Other Computer Services,Other Computer Services,Other Computer Services
,2024-04-16,8400/000 : FNB,74247284104820130887940,Account Payment,180.00 AGENCYANALYT 4910505225 13 APR 74247284104820130887940,3485.93,,646836.93,AccountTransactionsReport(1).csv,626,2024-04,False,Other Computer Services,Other Computer Services,Other Computer Services
,2024-04-16,8400/000 : FNB,24492164105000028848219,Account Payment,123.39 NOTION LABS 4910505191 14 APR 24492164105000028848219,2389.61,,649226.54,AccountTransactionsReport(1).csv,627,2024-04,False,Other Computer Services,Collaboration Tools,Collaboration Tools
,2024-04-16,8400/000 : FNB,24168884105100698914394,Account Payment,546.25 INTUIT QBoo 4910505225 14 APR 24168884105100698914394,546.25,,649772.79,AccountTransactionsReport(1).csv,628,2024-04,False,Productivity Software,Productivity Software,Productivity Software
,2024-04-17,8400/000 : FNB,74609054106000009684077,Account Payment,226.47 SLACK T0MN3D 4910505225 15 APR 74609054106000009684077,4385.89,,654158.68,AccountTransactionsReport(1).csv,629,2024-04,False,Communication,Communication,Communication
,2024-04-17,8400/000 : FNB,24000774106000017370084,Account Payment,120.75 MANAGEWP 4910505225 15 APR 24000774106000017370084,2338.48,,656497.16,AccountTransactionsReport(1).csv,630,2024-04,False,Other Computer Services,Other Computer Services,Other Computer Services
,2024-04-17,8400/000 : FNB,24000774106000017247860,Account Payment,120.75 MANAGEWP 4910505225 15 APR 24000774106000017247860,2338.48,,658835.64,AccountTransactionsReport(1).csv,631,2024-04,False,Other Computer Services,Other Computer Services,Other Computer Services
,2024-04-17,8400/000 : FNB,74143614107000112672293,Account Payment,74.75 SHOPIFY 2260 4910505225 15 APR 74143614107000112672293,1447.64,,660283.28,AccountTransactionsReport(1).csv,632,2024-04,False,E-commerce Platforms,E-commerce Platforms,E-commerce Platforms
,2024-04-17,8400/000 : FNB,24011344106000029125509,Account Payment,23.00 FIGMA MONTHLY 4910505191 15 APR 24011344106000029125509,445.42,,660728.7,AccountTransactionsReport(1).csv,633,2024-04,False,Other Computer Services,Design Tools,Design Tools
,2024-04-18,8400/000 : FNB,24011344107000051573740,Account Payment,279.00 TRIPLE WHALE 4910505191 16 APR 24011344107000051573740,5424.23,,666152.93,AccountTransactionsReport(1).csv,634,2024-04,False,Other Computer Services,Other Computer Services,Other Computer Services
,2024-04-18,8400/000 : FNB,24011344108000020359345,Account Payment,1150.00 SQUARESPACE 4910505191 17 APR 24011344108000020359345,1150.0,,667302.93,AccountTransactionsReport(1).csv,635,2024-04,False,Payment Processing,Payment Processing,Payment Processing
,2024-04-18,8400/000 : FNB,74143614108000068600636,Account Payment,575.00 FACEBK KTYK 4910505191 16 APR 74143614108000068600636,575.0,,667877.93,AccountTransactionsReport(1).csv,636,2024-04,False,Other Computer Services,Other Computer Services,Other Computer Services
,2024-04-18,8400/000 : FNB,74796314108000900043075,Account Payment,408.94 MSFT 3cE07 4910505225 17 APR 74796314108000900043075,408.94,,668286.87,AccountTransactionsReport(1).csv,637,2024-04,False,Other Computer Services,Other Computer Services,Other Computer Services
,2024-04-18,8400/000 : FNB,74796314108000200003076,Account Payment,26415.96 MSFT E07 4910505225 17 APR 74796314108000200003076,26415.96,,694702.83,AccountTransactionsReport(1).csv,638,2024-04,False,Other Computer Services,Other Computer Services,Other Computer Services
,2024-04-18,8400/000 : FNB,74796314108000800020033,Account Payment,5439.50 MSFT 3cE0 4910505225 17 APR 74796314108000800020033,5439.5,,700142.33,AccountTransactionsReport(1).csv,639,2024-04,False,Other Computer Services,Other Computer Services,Other Computer Services
,2024-04-19,8400/000 : FNB,74875304108000006774057,Account Payment,178.68 PipedriveUK 4910505191 17 APR 74875304108000006774057,4335.1,,704477.43,AccountTransactionsReport(1).csv,640,2024-04,False,Other Computer Services,Other Computer Services,Other Computer Services
,2024-04-19,8400/000 : FNB,24492164109000009852020,Account Payment,9.00 EMMA AI 4910505191 18 APR 24492164109000009852020,175.49,,704652.92,AccountTransactionsReport(1).csv,641,2024-04,False,Other Computer Services,Other Computer Services,Other Computer Services
,2024-04-20,8400/000 : FNB,74208474110000006705502,Account Payment,46.80 ENDOLE.CO.UK 4910505191 19 APR 74208474110000006705502,1141.22,,705794.14,AccountTransactionsReport(1).csv,642,2024-04,False,Other Computer Services,Other Computer Services,Other Computer Services
,2024-04-20,8400/000 : FNB,24000774110000005662967,Account Payment,100.00 NAMEBIO 4910505191 19 APR 24000774110000005662967,1960.07,,707754.21,AccountTransactionsReport(1).csv,643,2024-04,False,Other Computer Services,Other Computer Services,Other Computer Services
,2024-04-20,8400/000 : FNB,74609054110000004376509,Account Payment,17.25 SLACK T4ENT13 4910505225 19 APR 74609054110000004376509,338.11,,708092.32,AccountTransactionsReport(1).csv,644,2024-04,False,Communication,Communication,Communication
,2024-04-20,8400/000 : FNB,24692164109103965634669,Account Payment,100.00 INTUIT QBoo 4910505191 18 APR 24692164109103965634669,1949.86,,710042.18,AccountTransactionsReport(1).csv,645,2024-04,False,Productivity Software,Productivity Software,Productivity Software
,2024-04-22,8400/000 : FNB,24492164110000014112086,Account Payment,59.00 GREENBACK.COM 4910505225 19 APR 24492164110000014112086,1156.45,,711198.63,AccountTransactionsReport(1).csv,646,2024-04,False,Other Computer Services,Other Computer Services,Other Computer Services
,2024-04-22,8400/000 : FNB,74987504110000710056045,Account Payment,1150.00 FACEBK 35DS 4910505191 19 APR 74987504110000710056045,1150.0,,712348.63,AccountTransactionsReport(1).csv,647,2024-04,False,Other Computer Services,Other Computer Services,Other Computer Services
,2024-04-22,8400/000 : FNB,24168884110104867167969,Account Payment,546.25 INTUIT QBoo 4910505225 19 APR 24168884110104867167969,546.25,,712894.88,AccountTransactionsReport(1).csv,648,2024-04,False,Productivity Software,Productivity Software,Productivity Software
,2024-04-22,8400/000 : FNB,24168884110104861841411,Account Payment,546.25 INTUIT QBoo 4910505225 19 APR 24168884110104861841411,546.25,,713441.13,AccountTransactionsReport(1).csv,649,2024-04,False,Productivity Software,Productivity Software,Productivity Software
,2024-04-22,8400/000 : FNB,24168884110104859898266,Account Payment,546.25 INTUIT QBoo 4910505225 19 APR 24168884110104859898266,546.25,,713987.38,AccountTransactionsReport(1).csv,650,2024-04,False,Productivity Software,Productivity Software,Productivity Software
,2024-04-22,8400/000 : FNB,24168884110104867168017,Account Payment,264.50 INTUIT QBoo 4910505225 19 APR 24168884110104867168017,264.5,,714251.88,AccountTransactionsReport(1).csv,651,2024-04,False,Productivity Software,Productivity Software,Productivity Software
,2024-04-22,8400/000 : FNB,74313284111105425846490,Account Payment,3.01 Illustrator 4910505191 20 APR 74313284111105425846490,59.0,,714310.88,AccountTransactionsReport(1).csv,652,2024-04,False,Other Computer Services,Other Computer Services,Other Computer Services
,2024-04-23,8400/000 : FNB,24492164111000036196009,Account Payment,20.00 REPLIT INC. 4910505225 20 APR 24492164111000036196009,395.75,,714706.63,AccountTransactionsReport(1).csv,653,2024-04,False,Other Computer Services,Other Computer Services,Other Computer Services
,2024-04-23,8400/000 : FNB,24000774112000005464768,Account Payment,54.00 AIRTABLE.COM 4910505191 21 APR 24000774112000005464768,1068.53,,715775.16,AccountTransactionsReport(1).csv,654,2024-04,False,Other Computer Services,Collaboration Tools,Collaboration Tools
,2024-04-24,8400/000 : FNB,74609054114000001428630,Account Payment,299.00 TIME IS LTD 4910505191 22 APR 74609054114000001428630,5857.96,,721633.12,AccountTransactionsReport(1).csv,655,2024-04,False,Other Computer Services,Other Computer Services,Other Computer Services
,2024-04-25,8400/000 : FNB,74987504115000604227087,Account Payment,1124.99 LinkedIn 95 4910505191 24 APR 74987504115000604227087,1124.99,,722758.11,AccountTransactionsReport(1).csv,656,2024-04,False,Other Computer Services,Other Computer Services,Other Computer Services
,2024-04-25,8400/000 : FNB,74609054115000001149417,Account Payment,30.00 HASURA 4910505191 23 APR 74609054115000001149417,589.9,,723348.01,AccountTransactionsReport(1).csv,657,2024-04,False,Other Computer Services,Other Computer Services,Other Computer Services
,2024-04-25,8400/000 : FNB,74609054114000009003955,Account Payment,17.25 SLACK T1AS3LC 4910505191 23 APR 74609054114000009003955,337.96,,723685.97,AccountTransactionsReport(1).csv,658,2024-04,False,Communication,Communication,Communication
,2024-04-26,8400/000 : FNB,74987504115001652644041,Account Payment,18.38 Dropbox 45NV5 4910505191 24 APR 74987504115001652644041,361.41,,724047.38,AccountTransactionsReport(1).csv,659,2024-04,False,Other Computer Services,Other Computer Services,Other Computer Services
,2024-04-26,8400/000 : FNB,74313284116109476904401,Account Payment,18.09 Illustrator 4910505191 25 APR 74313284116109476904401,355.7,,724403.08,AccountTransactionsReport(1).csv,660,2024-04,False,Other Computer Services,Other Computer Services,Other Computer Services
,2024-04-26,8400/000 : FNB,74609054116000003871603,Account Payment,376.40 HOLASPIRIT 4910505225 25 APR 74609054116000003871603,7912.05,,732315.13,AccountTransactionsReport(1).csv,661,2024-04,False,Other Computer Services,Other Computer Services,Other Computer Services
,2024-04-26,8400/000 : FNB,74609054116000003991021,Account Payment,231.95 HOLASPIRIT 4910505225 25 APR 74609054116000003991021,4875.66,,737190.79,AccountTransactionsReport(1).csv,662,2024-04,False,Other Computer Services,Other Computer Services,Other Computer Services
,2024-04-26,8400/000 : FNB,74796314115000018421040,Account Payment,100.00 CLOUD B8HSRR 4910505191 24 APR 74796314115000018421040,1966.33,,739157.12,AccountTransactionsReport(1).csv,663,2024-04,False,Other Computer Services,Other Computer Services,Other Computer Services
,2024-04-26,8400/000 : FNB,24011344115000056383202,Account Payment,34.12 WWW.MAKE.COM 4910505191 24 APR 24011344115000056383202,670.91,,739828.03,AccountTransactionsReport(1).csv,664,2024-04,False,Other Computer Services,API Services,API Services
,2024-04-26,8400/000 : FNB,74609054116000000503043,Account Payment,10.00 MATTERMOST 4910505191 24 APR 74609054116000000503043,196.64,,740024.67,AccountTransactionsReport(1).csv,665,2024-04,False,Other Computer Services,Other Computer Services,Other Computer Services
,2024-04-29,8400/000 : FNB,24011344117000052621942,Account Payment,960.00 SQUARESPACE 4910505191 26 APR 24011344117000052621942,960.0,,740984.67,AccountTransactionsReport(1).csv,666,2024-04,False,Payment Processing,Payment Processing,Payment Processing
,2024-04-29,8400/000 : FNB,74143614118000060721446,Account Payment,645.58 FACEBK 6L6A 4910505191 26 APR 74143614118000060721446,645.58,,741630.25,AccountTransactionsReport(1).csv,667,2024-04,False,Other Computer Services,Other Computer Services,Other Computer Services
,2024-04-29,8400/000 : FNB,24492164117000003625364,Account Payment,150.00 AUTH0.COM 4910505191 25 APR 24492164117000003625364,2946.81,,744577.06,AccountTransactionsReport(1).csv,668,2024-04,False,Security Services,Security Services,Security Services
,2024-04-29,8400/000 : FNB,74922134116037830009726,Account Payment,BOB GROUP 4910505191 21 APR 74922134116037830009726,2298.85,,746875.91,AccountTransactionsReport(1).csv,669,2024-04,False,Other Computer Services,Other Computer Services,Other Computer Services
,2024-04-29,8400/000 : FNB,74922134116037830009718,Account Payment,BOB GROUP 4910505191 21 APR 74922134116037830009718,2298.85,,749174.76,AccountTransactionsReport(1).csv,670,2024-04,False,Other Computer Services,Other Computer Services,Other Computer Services
,2024-04-29,8400/000 : FNB,24492164116000032093494,Account Payment,24.00 LEMSQZY CODE 4910505191 25 APR 24492164116000032093494,471.76,,749646.52,AccountTransactionsReport(1).csv,671,2024-04,False,AI Services,AI Services,AI Services
,2024-04-29,STOCK2SHOP (PTY) LTD,WWI31335,Supplier Invoice,Stock to Shop,3134.4,,752780.92,AccountTransactionsReport(1).csv,672,2024-04,False,E-commerce Platforms,E-commerce Platforms,E-commerce Platforms
,2024-04-30,8400/000 : FNB,74143614120001252145994,Account Payment,2926.66 SHOPIFY 22 4910505225 27 APR 74143614120001252145994,57076.52,,809857.44,AccountTransactionsReport(1).csv,673,2024-04,False,E-commerce Platforms,E-commerce Platforms,E-commerce Platforms
,2024-04-30,8400/000 : FNB,74796314118000312370049,Account Payment,200.00 CLOUD BJMMMM 4910505191 27 APR 74796314118000312370049,3900.45,,813757.89,AccountTransactionsReport(1).csv,674,2024-04,False,Other Computer Services,Other Computer Services,Other Computer Services
,2024-04-30,8400/000 : FNB,24011344120000021428267,Account Payment,182.85 WIX.COM 1113 4910505191 29 APR 24011344120000021428267,3565.99,,817323.88,AccountTransactionsReport(1).csv,675,2024-04,False,E-commerce Platforms,E-commerce Platforms,E-commerce Platforms
,2024-04-30,8400/000 : FNB,24492154119719633605004,Account Payment,29.99 BEENVERIFIED 4910505191 28 APR 24492154119719633605004,584.88,,817908.76,AccountTransactionsReport(1).csv,676,2024-04,False,Other Computer Services,Other Computer Services,Other Computer Services
,2024-04-30,8400/000 : FNB,24168884119102265737095,Account Payment,546.25 INTUIT QBoo 4910505225 28 APR 24168884119102265737095,546.25,,818455.01,AccountTransactionsReport(1).csv,677,2024-04,False,Productivity Software,Productivity Software,Productivity Software
,2024-04-30,8400/000 : FNB,24168884119102265737087,Account Payment,546.25 INTUIT QBoo 4910505225 28 APR 24168884119102265737087,546.25,,819001.26,AccountTransactionsReport(1).csv,678,2024-04,False,Productivity Software,Productivity Software,Productivity Software
,2024-04-30,8400/000 : FNB,74313284119102032239922,Account Payment,22.99 Adobe 4910505191 28 APR 74313284119102032239922,448.36,,819449.62,AccountTransactionsReport(1).csv,679,2024-04,False,Productivity Software,Productivity Software,Productivity Software
,2024-04-30,8400/000 : FNB,24011344120000012901215,Account Payment,141.99 CANVA I0413 4910505225 29 APR 24011344120000012901215,141.99,,819591.61,AccountTransactionsReport(1).csv,680,2024-04,False,Other Computer Services,Design Tools,Design Tools
,2024-04-30,8400/000 : FNB,74875304118001100958081,Account Payment,34.99 Google Storag 4910505191 28 APR 74875304118001100958081,34.99,,819626.6,AccountTransactionsReport(1).csv,681,2024-04,False,Other Computer Services,Analytics & Monitoring,Analytics & Monitoring
,2024-05-02,8400/000 : FNB,74165884120417104783976,Account Payment,275.15 DNHDOMAINH 4910505191 28 APR 74165884120417104783976,6704.45,,826331.05,AccountTransactionsReport(1).csv,682,2024-05,False,Domain & Hosting,Domain & Hosting,Domain & Hosting
,2024-05-02,8400/000 : FNB,24011344120000034675250,Account Payment,5050.80 FRESHWORKS 4910505225 29 APR 24011344120000034675250,5050.8,,831381.85,AccountTransactionsReport(1).csv,683,2024-05,False,Productivity Software,Productivity Software,Productivity Software
,2024-05-02,8400/000 : FNB,74208474121000020249591,Account Payment,119.94 CLINICSOFTWA 4910505225 30 APR 74208474121000020249591,2889.87,,834271.72,AccountTransactionsReport(1).csv,684,2024-05,False,Other Computer Services,Other Computer Services,Other Computer Services
,2024-05-02,8400/000 : FNB,24492164120000034431639,Account Payment,2162.00 APPY PIE T 4910505191 29 APR 24492164120000034431639,2162.0,,836433.72,AccountTransactionsReport(1).csv,685,2024-05,False,Other Computer Services,Other Computer Services,Other Computer Services
,2024-05-02,8400/000 : FNB,74389244121000000032973,Account Payment,50.10 FRAPPE CLOUD 4910505191 30 APR 74389244121000000032973,963.78,,837397.5,AccountTransactionsReport(1).csv,686,2024-05,False,Other Computer Services,Other Computer Services,Other Computer Services
,2024-05-02,8400/000 : FNB,24492164120000020613562,Account Payment,20.00 YOU.COM 4910505191 29 APR 24492164120000020613562,390.05,,837787.55,AccountTransactionsReport(1).csv,687,2024-05,False,Other Computer Services,Other Computer Services,Other Computer Services
,2024-05-02,8400/000 : FNB,74609054120000008059265,Account Payment,5.00 COMPONENTS.STU 4910505191 29 APR 74609054120000008059265,97.51,,837885.06,AccountTransactionsReport(1).csv,688,2024-05,False,Other Computer Services,Other Computer Services,Other Computer Services
,2024-05-03,8400/000 : FNB,74697694123920055323020,Account Payment,83.96 GOOGLEGSUITE 4910505225 01 MAY 74697694123920055323020,1725.09,,839610.15,AccountTransactionsReport(1).csv,689,2024-05,False,Other Computer Services,Analytics & Monitoring,Analytics & Monitoring
,2024-05-03,8400/000 : FNB,74987504122000908248079,Account Payment,1096.18 FACEBK 4910505191 01 MAY 74987504122000908248079,1096.18,,840706.33,AccountTransactionsReport(1).csv,690,2024-05,False,Other Computer Services,Other Computer Services,Other Computer Services
,2024-05-03,8400/000 : FNB,74796314122000600610027,Account Payment,46.00 FACEBK FACEB 4910505191 01 MAY 74796314122000600610027,884.58,,841590.91,AccountTransactionsReport(1).csv,691,2024-05,False,Other Computer Services,Other Computer Services,Other Computer Services
,2024-05-03,8400/000 : FNB,74987504122001605418080,Account Payment,39.82 Google GSUITE 4910505191 01 MAY 74987504122001605418080,818.16,,842409.07,AccountTransactionsReport(1).csv,692,2024-05,False,Other Computer Services,Analytics & Monitoring,Analytics & Monitoring
,2024-05-03,8400/000 : FNB,74697694123920051593725,Account Payment,29.81 GOOGLEGSUITE 4910505191 01 MAY 74697694123920051593725,573.25,,842982.32,AccountTransactionsReport(1).csv,693,2024-05,False,Other Computer Services,Analytics & Monitoring,Analytics & Monitoring
,2024-05-03,8400/000 : FNB,24492164122000053646578,Account Payment,29.00 VIRTONOMICS S 4910505191 01 MAY 24492164122000053646578,557.67,,843539.99,AccountTransactionsReport(1).csv,694,2024-05,False,Other Computer Services,Other Computer Services,Other Computer Services
,2024-05-03,8400/000 : FNB,24011344122000078866581,Account Payment,29.00 ECM A LEGALZ 4910505191 01 MAY 24011344122000078866581,557.67,,844097.66,AccountTransactionsReport(1).csv,695,2024-05,False,Other Computer Services,Other Computer Services,Other Computer Services
,2024-05-03,8400/000 : FNB,74697694123920055283521,Account Payment,391.60 GOOGLEGSUIT 4910505225 01 MAY 74697694123920055283521,8046.0,,852143.66,AccountTransactionsReport(1).csv,696,2024-05,False,Other Computer Services,Analytics & Monitoring,Analytics & Monitoring
,2024-05-03,8400/000 : FNB,74697694123920051385445,Account Payment,275.68 GOOGLECLOUD 4910505191 01 MAY 74697694123920051385445,5301.34,,857445.0,AccountTransactionsReport(1).csv,697,2024-05,False,Other Computer Services,Analytics & Monitoring,Analytics & Monitoring
,2024-05-03,8400/000 : FNB,24011344122000073191357,Account Payment,134.00 SINCH MAILGU 4910505191 01 MAY 24011344122000073191357,2576.83,,860021.83,AccountTransactionsReport(1).csv,698,2024-05,False,Other Computer Services,Other Computer Services,Other Computer Services
,2024-05-03,8400/000 : FNB,24168884122104845110962,Account Payment,546.25 INTUIT QBoo 4910505225 01 MAY 24168884122104845110962,546.25,,860568.08,AccountTransactionsReport(1).csv,699,2024-05,False,Productivity Software,Productivity Software,Productivity Software
,2024-05-03,8400/000 : FNB,74796314122000800583065,Account Payment,27.60 FACEBK FACEB 4910505191 01 MAY 74796314122000800583065,530.75,,861098.83,AccountTransactionsReport(1).csv,700,2024-05,False,Other Computer Services,Other Computer Services,Other Computer Services
,2024-05-03,8400/000 : FNB,74609054122000018703900,Account Payment,17.25 SLACK T06A3T4 4910505191 01 MAY 74609054122000018703900,331.71,,861430.54,AccountTransactionsReport(1).csv,701,2024-05,False,Communication,Communication,Communication
,2024-05-03,8400/000 : FNB,74987504122001745744056,Account Payment,12.00 GSUITE_rzoneu 4910505191 01 MAY 74987504122001745744056,288.92,,861719.46,AccountTransactionsReport(1).csv,702,2024-05,False,Other Computer Services,Other Computer Services,Other Computer Services
,2024-05-03,8400/000 : FNB,74796314122000900513079,Account Payment,9.20 FACEBK FACEBK 4910505191 01 MAY 74796314122000900513079,176.92,,861896.38,AccountTransactionsReport(1).csv,703,2024-05,False,Other Computer Services,Other Computer Services,Other Computer Services
,2024-05-03,8400/000 : FNB,24492164122000033918584,Account Payment,7.00 GLASSFROG 4910505191 01 MAY 24492164122000033918584,134.61,,862030.99,AccountTransactionsReport(1).csv,704,2024-05,False,Other Computer Services,Other Computer Services,Other Computer Services
,2024-05-04,8400/000 : FNB,74201334123000007500983,Account Payment,450.00 WAPPALYZER 4910505191 02 MAY 74201334123000007500983,8637.92,,870668.91,AccountTransactionsReport(1).csv,705,2024-05,False,Other Computer Services,Other Computer Services,Other Computer Services
,2024-05-06,8400/000 : FNB,24011344124000078083391,Account Payment,143.20 MOZSEOHELP@ 4910505191 03 MAY 24011344124000078083391,2732.31,,873401.22,AccountTransactionsReport(1).csv,706,2024-05,False,Other Computer Services,Other Computer Services,Other Computer Services
,2024-05-06,8400/000 : FNB,74609054125000002163951,Account Payment,99.00 DMNS.APP BUSI 4910505191 04 MAY 74609054125000002163951,1879.22,,875280.44,AccountTransactionsReport(1).csv,707,2024-05,False,Other Computer Services,Other Computer Services,Other Computer Services
,2024-05-06,8400/000 : FNB,74083424125000001643599,Account Payment,60.00 INSOMNIA TEAM 4910505191 03 MAY 74083424125000001643599,1138.92,,876419.36,AccountTransactionsReport(1).csv,708,2024-05,False,Other Computer Services,Other Computer Services,Other Computer Services
,2024-05-06,8400/000 : FNB,24000774125000006853683,Account Payment,4.95 SHELLS.COM 4910505191 04 MAY 24000774125000006853683,93.96,,876513.32,AccountTransactionsReport(1).csv,709,2024-05,False,Other Computer Services,Other Computer Services,Other Computer Services
,2024-05-06,8400/000 : FNB,76230133,Account Payment,FNB OBE 76230133 76230133,24.14,,876537.46,AccountTransactionsReport(1).csv,710,2024-05,False,Other Computer Services,Other Computer Services,Other Computer Services
,2024-05-07,8400/000 : FNB,74143614127001070740706,Account Payment,2058.98 SHOPIFY 22 4910505191 04 MAY 74143614127001070740706,39083.5,,915620.96,AccountTransactionsReport(1).csv,711,2024-05,False,E-commerce Platforms,E-commerce Platforms,E-commerce Platforms
,2024-05-07,8400/000 : FNB,24492164125000016631839,Account Payment,1499.00 APPDIRECT 4910505225 04 MAY 24492164125000016631839,28453.97,,944074.93,AccountTransactionsReport(1).csv,712,2024-05,False,Other Computer Services,Other Computer Services,Other Computer Services
,2024-05-07,8400/000 : FNB,24492164127000013962466,Account Payment,1499.00 APPDIRECT 4910505191 06 MAY 24492164127000013962466,28453.97,,972528.9,AccountTransactionsReport(1).csv,713,2024-05,False,Other Computer Services,Other Computer Services,Other Computer Services
,2024-05-07,8400/000 : FNB,24492164126000014688301,Account Payment,1499.00 APPDIRECT 4910505191 05 MAY 24492164126000014688301,28453.97,,1000982.87,AccountTransactionsReport(1).csv,714,2024-05,False,Other Computer Services,Other Computer Services,Other Computer Services
,2024-05-07,8400/000 : FNB,24492164126000011277058,Account Payment,1499.00 APPDIRECT 4910505191 05 MAY 24492164126000011277058,28453.97,,1029436.84,AccountTransactionsReport(1).csv,715,2024-05,False,Other Computer Services,Other Computer Services,Other Computer Services
,2024-05-07,8400/000 : FNB,24011344126000000859494,Account Payment,599.00 TRIPLE WHALE 4910505191 04 MAY 24011344126000000859494,11370.21,,1040807.05,AccountTransactionsReport(1).csv,716,2024-05,False,Other Computer Services,Other Computer Services,Other Computer Services
,2024-05-07,8400/000 : FNB,24011344125000030095631,Account Payment,249.00 STABLE 4910505191 04 MAY 24011344125000030095631,4726.51,,1045533.56,AccountTransactionsReport(1).csv,717,2024-05,False,Other Computer Services,Other Computer Services,Other Computer Services
,2024-05-07,8400/000 : FNB,74548584126002804005504,Account Payment,SAGE ACC 4910505225 04 MAY 74548584126002804005504,3160.0,,1048693.56,AccountTransactionsReport(1).csv,718,2024-05,False,Other Computer Services,Other Computer Services,Other Computer Services
,2024-05-07,8400/000 : FNB,74878464126417230922707,Account Payment,126.50 MICROSOFTG0 4910505191 05 MAY 74878464126417230922707,2401.22,,1051094.78,AccountTransactionsReport(1).csv,719,2024-05,False,Productivity Software,Productivity Software,Productivity Software
,2024-05-07,8400/000 : FNB,24000774126000010053675,Account Payment,120.75 MANAGEWP 4910505225 05 MAY 24000774126000010053675,2292.07,,1053386.85,AccountTransactionsReport(1).csv,720,2024-05,False,Other Computer Services,Other Computer Services,Other Computer Services
,2024-05-07,8400/000 : FNB,24000774126000010053642,Account Payment,120.75 MANAGEWP 4910505225 05 MAY 24000774126000010053642,2292.07,,1055678.92,AccountTransactionsReport(1).csv,721,2024-05,False,Other Computer Services,Other Computer Services,Other Computer Services
,2024-05-07,8400/000 : FNB,74007484127254883971371,Account Payment,77.05 CBAPlesk 4910505191 05 MAY 74007484127254883971371,1462.56,,1057141.48,AccountTransactionsReport(1).csv,722,2024-05,False,Domain & Hosting,Domain & Hosting,Domain & Hosting
,2024-05-07,8400/000 : FNB,24000774125000015396567,Account Payment,7.15 GITHUB INC. 4910505225 04 MAY 24000774125000015396567,135.72,,1057277.2,AccountTransactionsReport(1).csv,723,2024-05,False,Development Tools,Development Tools,Development Tools
,2024-05-07,8400/000 : FNB,24011344127000020222292,Account Payment,134.00 SQUARESPACE 4910505191 06 MAY 24011344127000020222292,134.0,,1057411.2,AccountTransactionsReport(1).csv,724,2024-05,False,Payment Processing,Payment Processing,Payment Processing
,2024-05-07,8400/000 : FNB,24000774125000015291107,Account Payment,19.00 GITHUB INC. 4910505225 04 MAY 24000774125000015291107,360.66,,1057771.86,AccountTransactionsReport(1).csv,725,2024-05,False,Development Tools,Development Tools,Development Tools
,2024-05-07,8400/000 : FNB,24011344127000021024556,Account Payment,15.00 HIGHTAIL 4910505191 06 MAY 24011344127000021024556,284.73,,1058056.59,AccountTransactionsReport(1).csv,726,2024-05,False,Other Computer Services,Other Computer Services,Other Computer Services
,2024-05-08,8400/000 : FNB,24011344127000071096769,Account Payment,20.00 VERCEL INC. 4910505225 06 MAY 24011344127000071096769,379.64,,1058436.23,AccountTransactionsReport(1).csv,727,2024-05,False,Cloud Services,Cloud Services,Cloud Services
,2024-05-08,8400/000 : FNB,24011344127000068248381,Account Payment,20.00 VERCEL INC. 4910505225 06 MAY 24011344127000068248381,379.64,,1058815.87,AccountTransactionsReport(1).csv,728,2024-05,False,Cloud Services,Cloud Services,Cloud Services
,2024-05-08,8400/000 : FNB,74609054127000010097702,Account Payment,19.99 WOOCOMMERCE S 4910505225 06 MAY 74609054127000010097702,379.45,,1059195.32,AccountTransactionsReport(1).csv,729,2024-05,False,Other Computer Services,Other Computer Services,Other Computer Services
,2024-05-08,8400/000 : FNB,24000774127000006752958,Account Payment,9.00 TWENTY.COM 4910505191 06 MAY 24000774127000006752958,170.84,,1059366.16,AccountTransactionsReport(1).csv,730,2024-05,False,Other Computer Services,Other Computer Services,Other Computer Services
,2024-05-08,8400/000 : FNB,74609054128000005039676,Account Payment,9.00 GITPOD.IO 4910505191 07 MAY 74609054128000005039676,170.57,,1059536.73,AccountTransactionsReport(1).csv,731,2024-05,False,Development Tools,Development Tools,Development Tools
,2024-05-08,8400/000 : FNB,24492164128000010567309,Account Payment,7.00 NPM INC. 4910505191 07 MAY 24492164128000010567309,132.67,,1059669.4,AccountTransactionsReport(1).csv,732,2024-05,False,Other Computer Services,Other Computer Services,Other Computer Services
,2024-05-08,8400/000 : FNB,24492164128000010555312,Account Payment,7.00 NPM INC. 4910505191 07 MAY 24492164128000010555312,132.67,,1059802.07,AccountTransactionsReport(1).csv,733,2024-05,False,Other Computer Services,Other Computer Services,Other Computer Services
,2024-05-08,8400/000 : FNB,24492164128000010532162,Account Payment,7.00 NPM INC. 4910505191 07 MAY 24492164128000010532162,132.67,,1059934.74,AccountTransactionsReport(1).csv,734,2024-05,False,Other Computer Services,Other Computer Services,Other Computer Services
,2024-05-08,8400/000 : FNB,24492164128000010392179,Account Payment,7.00 NPM INC. 4910505191 07 MAY 24492164128000010392179,132.67,,1060067.41,AccountTransactionsReport(1).csv,735,2024-05,False,Other Computer Services,Other Computer Services,Other Computer Services
,2024-05-08,8400/000 : FNB,74208474128000011381976,Account Payment,3.60 GETADDRESS.IO 4910505225 07 MAY 74208474128000011381976,85.66,,1060153.07,AccountTransactionsReport(1).csv,736,2024-05,False,Other Computer Services,Other Computer Services,Other Computer Services
,2024-05-09,8400/000 : FNB,24492164128000018002820,Account Payment,1499.00 APPDIRECT 4910505191 07 MAY 24492164128000018002820,28409.94,,1088563.01,AccountTransactionsReport(1).csv,737,2024-05,False,Other Computer Services,Other Computer Services,Other Computer Services
,2024-05-09,8400/000 : FNB,24021214129019927444081,Account Payment,171.35 PADDLE.NETD 4910505191 08 MAY 24021214129019927444081,3245.42,,1091808.43,AccountTransactionsReport(1).csv,738,2024-05,False,Other Computer Services,Subscription Management,Subscription Management
,2024-05-09,8400/000 : FNB,74922134128037930018292,Account Payment,BOB GROUP 4910505191 01 MAY 74922134128037930018292,2298.85,,1094107.28,AccountTransactionsReport(1).csv,739,2024-05,False,Other Computer Services,Other Computer Services,Other Computer Services
,2024-05-09,8400/000 : FNB,24492164129000000078936,Account Payment,99.00 MIOSALON.COM 4910505225 07 MAY 24492164129000000078936,1876.31,,1095983.59,AccountTransactionsReport(1).csv,740,2024-05,False,Other Computer Services,Other Computer Services,Other Computer Services
,2024-05-09,8400/000 : FNB,24492164129000000042957,Account Payment,99.00 MIOSALON.COM 4910505225 07 MAY 24492164129000000042957,1876.31,,1097859.9,AccountTransactionsReport(1).csv,741,2024-05,False,Other Computer Services,Other Computer Services,Other Computer Services
,2024-05-09,8400/000 : FNB,24168884128100009891813,Account Payment,546.25 INTUIT QBoo 4910505225 07 MAY 24168884128100009891813,546.25,,1098406.15,AccountTransactionsReport(1).csv,742,2024-05,False,Productivity Software,Productivity Software,Productivity Software
,2024-05-10,8400/000 : FNB,74697694130920042362314,Account Payment,500.00 GOOGLECLOUD 4910505191 08 MAY 74697694130920042362314,9470.14,,1107876.29,AccountTransactionsReport(1).csv,743,2024-05,False,Other Computer Services,Analytics & Monitoring,Analytics & Monitoring
,2024-05-10,8400/000 : FNB,24492164129000031344075,Account Payment,150.00 AUTH0.COM 4910505191 08 MAY 24492164129000031344075,2841.04,,1110717.33,AccountTransactionsReport(1).csv,744,2024-05,False,Security Services,Security Services,Security Services
,2024-05-10,8400/000 : FNB,74987504129001110262083,Account Payment,862.50 FACEBK 4910505191 08 MAY 74987504129001110262083,862.5,,1111579.83,AccountTransactionsReport(1).csv,745,2024-05,False,Other Computer Services,Other Computer Services,Other Computer Services
,2024-05-10,8400/000 : FNB,24492164129000038156936,Account Payment,25.00 NOTION LABS 4910505191 08 MAY 24492164129000038156936,473.5,,1112053.33,AccountTransactionsReport(1).csv,746,2024-05,False,Other Computer Services,Collaboration Tools,Collaboration Tools
,2024-05-10,8400/000 : FNB,24000774129000007653195,Account Payment,23.75 CLOUDFLARE 4910505191 08 MAY 24000774129000007653195,449.83,,1112503.16,AccountTransactionsReport(1).csv,747,2024-05,False,Cloud Services,Cloud Services,Cloud Services
,2024-05-11,8400/000 : FNB,24492164130000016617898,Account Payment,1499.00 APPDIRECT 4910505191 09 MAY 24492164130000016617898,28568.33,,1141071.49,AccountTransactionsReport(1).csv,748,2024-05,False,Other Computer Services,Other Computer Services,Other Computer Services
,2024-05-11,8400/000 : FNB,24492164131000011178507,Account Payment,70.00 NOTION LABS 4910505191 10 MAY 24492164131000011178507,1332.24,,1142403.73,AccountTransactionsReport(1).csv,749,2024-05,False,Other Computer Services,Collaboration Tools,Collaboration Tools
,2024-05-11,8400/000 : FNB,74143254130000002415635,Account Payment,49.00 SKRAPP.IO STA 4910505191 09 MAY 74143254130000002415635,933.85,,1143337.58,AccountTransactionsReport(1).csv,750,2024-05,False,Other Computer Services,Other Computer Services,Other Computer Services
,2024-05-13,8400/000 : FNB,74143614132000109374704,Account Payment,3001.45 SHOPIFY 23 4910505225 10 MAY 74143614132000109374704,57123.75,,1200461.33,AccountTransactionsReport(1).csv,751,2024-05,False,E-commerce Platforms,E-commerce Platforms,E-commerce Platforms
,2024-05-13,8400/000 : FNB,24011344132000026729566,Account Payment,99.00 DYNAMIC.XYZ 4910505191 11 MAY 24011344132000026729566,1870.15,,1202331.48,AccountTransactionsReport(1).csv,752,2024-05,False,Other Computer Services,Other Computer Services,Other Computer Services
,2024-05-13,8400/000 : FNB,24064664131000000563138,Account Payment,99.00 PLAYFAB INC. 4910505191 10 MAY 24064664131000000563138,1884.17,,1204215.65,AccountTransactionsReport(1).csv,753,2024-05,False,Other Computer Services,Other Computer Services,Other Computer Services
,2024-05-14,8400/000 : FNB,24000774132000016523897,Account Payment,189.00 GITHUB INC. 4910505225 11 MAY 24000774132000016523897,3570.29,,1207785.94,AccountTransactionsReport(1).csv,754,2024-05,False,Development Tools,Development Tools,Development Tools
,2024-05-14,8400/000 : FNB,24000774132000016623036,Account Payment,63.00 GITHUB INC. 4910505225 11 MAY 24000774132000016623036,1190.1,,1208976.04,AccountTransactionsReport(1).csv,755,2024-05,False,Development Tools,Development Tools,Development Tools
,2024-05-14,8400/000 : FNB,24000774132000016378508,Account Payment,42.00 GITHUB INC. 4910505225 11 MAY 24000774132000016378508,793.4,,1209769.44,AccountTransactionsReport(1).csv,756,2024-05,False,Development Tools,Development Tools,Development Tools
,2024-05-14,8400/000 : FNB,24492164132000014757793,Account Payment,32.00 BUBBLE STARTE 4910505191 11 MAY 24492164132000014757793,604.49,,1210373.93,AccountTransactionsReport(1).csv,757,2024-05,False,Other Computer Services,Other Computer Services,Other Computer Services
,2024-05-14,8400/000 : FNB,24168884132103361717042,Account Payment,546.25 INTUIT QBoo 4910505225 11 MAY 24168884132103361717042,546.25,,1210920.18,AccountTransactionsReport(1).csv,758,2024-05,False,Productivity Software,Productivity Software,Productivity Software
,2024-05-14,8400/000 : FNB,24168884132103361717034,Account Payment,546.25 INTUIT QBoo 4910505225 11 MAY 24168884132103361717034,546.25,,1211466.43,AccountTransactionsReport(1).csv,759,2024-05,False,Productivity Software,Productivity Software,Productivity Software
,2024-05-15,8400/000 : FNB,74247284134820127140828,Account Payment,180.00 AGENCYANALYT 4910505225 13 MAY 74247284134820127140828,3400.27,,1214866.7,AccountTransactionsReport(1).csv,760,2024-05,False,Other Computer Services,Other Computer Services,Other Computer Services
,2024-05-16,8400/000 : FNB,24000774135000014919060,Account Payment,14.00 GITHUB INC. 4910505225 14 MAY 24000774135000014919060,263.91,,1215130.61,AccountTransactionsReport(1).csv,761,2024-05,False,Development Tools,Development Tools,Development Tools
,2024-05-16,8400/000 : FNB,74609054136000005229970,Account Payment,214.47 SLACK T0MN3D 4910505225 15 MAY 74609054136000005229970,4044.14,,1219174.75,AccountTransactionsReport(1).csv,762,2024-05,False,Communication,Communication,Communication
,2024-05-16,8400/000 : FNB,24168884135105794532531,Account Payment,546.25 INTUIT QBoo 4910505225 14 MAY 24168884135105794532531,546.25,,1219721.0,AccountTransactionsReport(1).csv,763,2024-05,False,Productivity Software,Productivity Software,Productivity Software
,2024-05-17,8400/000 : FNB,74143614137000105044298,Account Payment,74.75 SHOPIFY 2325 4910505225 15 MAY 74143614137000105044298,1409.52,,1221130.52,AccountTransactionsReport(1).csv,764,2024-05,False,E-commerce Platforms,E-commerce Platforms,E-commerce Platforms
,2024-05-18,8400/000 : FNB,74796314138000500006047,Account Payment,26415.96 MSFT E07 4910505225 17 MAY 74796314138000500006047,26415.96,,1247546.48,AccountTransactionsReport(1).csv,765,2024-05,False,Other Computer Services,Other Computer Services,Other Computer Services
,2024-05-18,8400/000 : FNB,74796314138000500062040,Account Payment,5439.50 MSFT 3cE0 4910505225 17 MAY 74796314138000500062040,5439.5,,1252985.98,AccountTransactionsReport(1).csv,766,2024-05,False,Other Computer Services,Other Computer Services,Other Computer Services
,2024-05-18,8400/000 : FNB,74796314138000300064071,Account Payment,408.94 MSFT 3cE07 4910505225 17 MAY 74796314138000300064071,408.94,,1253394.92,AccountTransactionsReport(1).csv,767,2024-05,False,Other Computer Services,Other Computer Services,Other Computer Services
,2024-05-21,8400/000 : FNB,24168884140100037785304,Account Payment,546.25 INTUIT QBoo 4910505225 19 MAY 24168884140100037785304,546.25,,1253941.17,AccountTransactionsReport(1).csv,768,2024-05,False,Productivity Software,Productivity Software,Productivity Software
,2024-05-21,8400/000 : FNB,24168884140100035525108,Account Payment,546.25 INTUIT QBoo 4910505225 19 MAY 24168884140100035525108,546.25,,1254487.42,AccountTransactionsReport(1).csv,769,2024-05,False,Productivity Software,Productivity Software,Productivity Software
,2024-05-21,8400/000 : FNB,24168884140100035024888,Account Payment,546.25 INTUIT QBoo 4910505225 19 MAY 24168884140100035024888,546.25,,1255033.67,AccountTransactionsReport(1).csv,770,2024-05,False,Productivity Software,Productivity Software,Productivity Software
,2024-05-21,8400/000 : FNB,74609054140000006541419,Account Payment,17.25 SLACK T4ENT13 4910505225 19 MAY 74609054140000006541419,322.05,,1255355.72,AccountTransactionsReport(1).csv,771,2024-05,False,Communication,Communication,Communication
,2024-05-21,8400/000 : FNB,24168884140100037785254,Account Payment,264.50 INTUIT QBoo 4910505225 19 MAY 24168884140100037785254,264.5,,1255620.22,AccountTransactionsReport(1).csv,772,2024-05,False,Productivity Software,Productivity Software,Productivity Software
,2024-05-21,8400/000 : FNB,24492164140000015320674,Account Payment,59.00 GREENBACK.COM 4910505225 19 MAY 24492164140000015320674,1101.54,,1256721.76,AccountTransactionsReport(1).csv,773,2024-05,False,Other Computer Services,Other Computer Services,Other Computer Services
,2024-05-22,8400/000 : FNB,24492164141000034382902,Account Payment,20.00 REPLIT INC. 4910505225 20 MAY 24492164141000034382902,373.4,,1257095.16,AccountTransactionsReport(1).csv,774,2024-05,False,Other Computer Services,Other Computer Services,Other Computer Services
,2024-05-23,8400/000 : FNB,24011344142000060610092,Account Payment,279.00 TRIPLE WHALE 4910505191 21 MAY 24011344142000060610092,5208.15,,1262303.31,AccountTransactionsReport(1).csv,775,2024-05,False,Other Computer Services,Other Computer Services,Other Computer Services
,2024-05-23,8400/000 : FNB,24000774142000012384763,Account Payment,100.00 NAMEBIO 4910505191 21 MAY 24000774142000012384763,1866.72,,1264170.03,AccountTransactionsReport(1).csv,776,2024-05,False,Other Computer Services,Other Computer Services,Other Computer Services
,2024-05-24,8400/000 : FNB,24000774143000019631389,Account Payment,15.00 TABNINE 4910505191 22 MAY 24000774143000019631389,279.12,,1264449.15,AccountTransactionsReport(1).csv,777,2024-05,False,Other Computer Services,Other Computer Services,Other Computer Services
,2024-05-24,8400/000 : FNB,24492164143000018223625,Account Payment,75.00 NOTION LABS 4910505191 22 MAY 24492164143000018223625,1395.59,,1265844.74,AccountTransactionsReport(1).csv,778,2024-05,False,Other Computer Services,Collaboration Tools,Collaboration Tools
,2024-05-24,8400/000 : FNB,74796314143000110559040,Account Payment,1000.00 CLOUD GCB2G 4910505191 22 MAY 74796314143000110559040,18607.94,,1284452.68,AccountTransactionsReport(1).csv,779,2024-05,False,Other Computer Services,Other Computer Services,Other Computer Services
,2024-05-24,8400/000 : FNB,74609054144000001599186,Account Payment,299.00 TIME IS LTD 4910505191 22 MAY 74609054144000001599186,5584.43,,1290037.11,AccountTransactionsReport(1).csv,780,2024-05,False,Other Computer Services,Other Computer Services,Other Computer Services
,2024-05-25,8400/000 : FNB,74609054145000001389223,Account Payment,30.00 HASURA 4910505191 23 MAY 74609054145000001389223,566.17,,1290603.28,AccountTransactionsReport(1).csv,781,2024-05,False,Other Computer Services,Other Computer Services,Other Computer Services
,2024-05-25,8400/000 : FNB,74609054144000008557237,Account Payment,17.25 SLACK T1AS3LC 4910505191 23 MAY 74609054144000008557237,322.18,,1290925.46,AccountTransactionsReport(1).csv,782,2024-05,False,Communication,Communication,Communication
,2024-05-27,8400/000 : FNB,74609054146000000515744,Account Payment,10.00 MATTERMOST 4910505191 24 MAY 74609054146000000515744,188.81,,1291114.27,AccountTransactionsReport(1).csv,783,2024-05,False,Other Computer Services,Other Computer Services,Other Computer Services
,2024-05-27,8400/000 : FNB,74987504145002348334033,Account Payment,18.38 Dropbox 2Q868 4910505191 24 MAY 74987504145002348334033,346.87,,1291461.14,AccountTransactionsReport(1).csv,784,2024-05,False,Other Computer Services,Other Computer Services,Other Computer Services
,2024-05-27,8400/000 : FNB,74609054146000003695725,Account Payment,376.40 HOLASPIRIT 4910505225 25 MAY 74609054146000003695725,7698.83,,1299159.97,AccountTransactionsReport(1).csv,785,2024-05,False,Other Computer Services,Other Computer Services,Other Computer Services
,2024-05-27,8400/000 : FNB,74609054146000003803485,Account Payment,231.95 HOLASPIRIT 4910505225 25 MAY 74609054146000003803485,4744.26,,1303904.23,AccountTransactionsReport(1).csv,786,2024-05,False,Other Computer Services,Other Computer Services,Other Computer Services
,2024-05-27,8400/000 : FNB,24011344145000065631108,Account Payment,34.12 WWW.MAKE.COM 4910505191 24 MAY 24011344145000065631108,643.92,,1304548.15,AccountTransactionsReport(1).csv,787,2024-05,False,Other Computer Services,API Services,API Services
,2024-05-27,8400/000 : FNB,74313284146101823396435,Account Payment,24.14 Illustrator 4910505191 25 MAY 74313284146101823396435,455.57,,1305003.72,AccountTransactionsReport(1).csv,788,2024-05,False,Other Computer Services,Other Computer Services,Other Computer Services
,2024-05-27,STOCK2SHOP (PTY) LTD,WWI31369,Supplier Invoice,3300/020 : Computer - Platforms - Stock2Shop,1371.14,,1306374.86,AccountTransactionsReport(1).csv,789,2024-05,False,E-commerce Platforms,E-commerce Platforms,E-commerce Platforms
,2024-05-28,8400/000 : FNB,24492164147000011651315,Account Payment,9.00 EMMA AI 4910505191 26 MAY 24492164147000011651315,169.93,,1306544.79,AccountTransactionsReport(1).csv,790,2024-05,False,Other Computer Services,Other Computer Services,Other Computer Services
,2024-05-28,8400/000 : FNB,24492164146000028412082,Account Payment,280.00 WIZA.CO 4910505191 25 MAY 24492164146000028412082,5286.85,,1311831.64,AccountTransactionsReport(1).csv,791,2024-05,False,Other Computer Services,Other Computer Services,Other Computer Services
,2024-05-28,8400/000 : FNB,24492164147000003244517,Account Payment,150.00 AUTH0.COM 4910505191 25 MAY 24492164147000003244517,2832.24,,1314663.88,AccountTransactionsReport(1).csv,792,2024-05,False,Security Services,Security Services,Security Services
,2024-05-28,8400/000 : FNB,74987504146000204644049,Account Payment,1726.83 FACEBK 4910505191 25 MAY 74987504146000204644049,1726.83,,1316390.71,AccountTransactionsReport(1).csv,793,2024-05,False,Other Computer Services,Other Computer Services,Other Computer Services
,2024-05-28,8400/000 : FNB,74987504146000804863072,Account Payment,1150.00 FACEBK 4910505191 25 MAY 74987504146000804863072,1150.0,,1317540.71,AccountTransactionsReport(1).csv,794,2024-05,False,Other Computer Services,Other Computer Services,Other Computer Services
,2024-05-28,8400/000 : FNB,24000774146000015390326,Account Payment,54.00 AIRTABLE.COM 4910505191 25 MAY 24000774146000015390326,1019.6,,1318560.31,AccountTransactionsReport(1).csv,795,2024-05,False,Other Computer Services,Collaboration Tools,Collaboration Tools
,2024-05-28,8400/000 : FNB,24492164146000035110463,Account Payment,24.00 LEMSQZY CODE 4910505191 25 MAY 24492164146000035110463,453.16,,1319013.47,AccountTransactionsReport(1).csv,796,2024-05,False,AI Services,AI Services,AI Services
,2024-05-28,8400/000 : FNB,74987504147000702137057,Account Payment,51.00 FACEBK 4910505191 26 MAY 74987504147000702137057,51.0,,1319064.47,AccountTransactionsReport(1).csv,797,2024-05,False,Other Computer Services,Other Computer Services,Other Computer Services
,2024-05-28,STOCK2SHOP (PTY) LTD,WWI31370,Supplier Invoice,3300/020 : Computer - Platforms - connectors,4790.0,,1323854.47,AccountTransactionsReport(1).csv,798,2024-05,False,E-commerce Platforms,E-commerce Platforms,E-commerce Platforms
,2024-05-28,STOCK2SHOP (PTY) LTD,WWI31371,Supplier Invoice,3300/020 : Computer - Platforms Connectors,3134.4,,1326988.87,AccountTransactionsReport(1).csv,799,2024-05,False,E-commerce Platforms,E-commerce Platforms,E-commerce Platforms
,2024-05-30,8400/000 : FNB,24011344150000014021320,Account Payment,141.99 CANVA I0416 4910505225 29 MAY 24011344150000014021320,141.99,,1327130.86,AccountTransactionsReport(1).csv,800,2024-05,False,Other Computer Services,Design Tools,Design Tools
,2024-05-30,8400/000 : FNB,74875304148002831440021,Account Payment,34.99 Google Storag 4910505191 27 MAY 74875304148002831440021,34.99,,1327165.85,AccountTransactionsReport(1).csv,801,2024-05,False,Other Computer Services,Analytics & Monitoring,Analytics & Monitoring
,2024-05-30,8400/000 : FNB,24168884149104418114887,Account Payment,546.25 INTUIT QBoo 4910505225 28 MAY 24168884149104418114887,546.25,,1327712.1,AccountTransactionsReport(1).csv,802,2024-05,False,Productivity Software,Productivity Software,Productivity Software
,2024-05-30,8400/000 : FNB,24168884149104418114879,Account Payment,546.25 INTUIT QBoo 4910505225 28 MAY 24168884149104418114879,546.25,,1328258.35,AccountTransactionsReport(1).csv,803,2024-05,False,Productivity Software,Productivity Software,Productivity Software
,2024-05-30,8400/000 : FNB,74313284149104174042472,Account Payment,22.99 Adobe 4910505191 28 MAY 74313284149104174042472,434.09,,1328692.44,AccountTransactionsReport(1).csv,804,2024-05,False,Productivity Software,Productivity Software,Productivity Software
,2024-05-30,8400/000 : FNB,24011344148000030098455,Account Payment,1150.00 SQUARESPACE 4910505191 27 MAY 24011344148000030098455,1150.0,,1329842.44,AccountTransactionsReport(1).csv,805,2024-05,False,Payment Processing,Payment Processing,Payment Processing
,2024-05-30,8400/000 : FNB,24492154149719587309474,Account Payment,29.99 BEENVERIFIED 4910505191 28 MAY 24492154149719587309474,564.04,,1330406.48,AccountTransactionsReport(1).csv,806,2024-05,False,Other Computer Services,Other Computer Services,Other Computer Services
,2024-05-30,8400/000 : FNB,74143614149000114521506,Account Payment,2846.17 SHOPIFY 23 4910505225 27 MAY 74143614149000114521506,53740.29,,1384146.77,AccountTransactionsReport(1).csv,807,2024-05,False,E-commerce Platforms,E-commerce Platforms,E-commerce Platforms
,2024-05-30,8400/000 : FNB,24011344150000024418995,Account Payment,182.85 WIX.COM 1118 4910505191 29 MAY 24011344150000024418995,3438.94,,1387585.71,AccountTransactionsReport(1).csv,808,2024-05,False,E-commerce Platforms,E-commerce Platforms,E-commerce Platforms
,2024-05-31,8400/000 : FNB,24011344150000037192694,Account Payment,5050.80 FRESHWORKS 4910505225 29 MAY 24011344150000037192694,5050.8,,1392636.51,AccountTransactionsReport(1).csv,809,2024-05,False,Productivity Software,Productivity Software,Productivity Software
,2024-05-31,8400/000 : FNB,24492164150000021204356,Account Payment,20.00 YOU.COM 4910505191 29 MAY 24492164150000021204356,376.15,,1393012.66,AccountTransactionsReport(1).csv,810,2024-05,False,Other Computer Services,Other Computer Services,Other Computer Services
,2024-05-31,8400/000 : FNB,74609054150000009318242,Account Payment,5.00 COMPONENTS.STU 4910505191 29 MAY 74609054150000009318242,94.03,,1393106.69,AccountTransactionsReport(1).csv,811,2024-05,False,Other Computer Services,Other Computer Services,Other Computer Services
,2024-05-31,The Courier Guy,WWI31380,Supplier Invoice,3300/020 : Computer - Platforms,2665.0,,1395771.69,AccountTransactionsReport(1).csv,812,2024-05,False,Other Computer Services,Other Computer Services,Other Computer Services
,2024-06-01,8400/000 : FNB,74208474151000019464840,Account Payment,119.94 CLINICSOFTWA 4910505225 30 MAY 74208474151000019464840,2872.39,,1398644.08,AccountTransactionsReport(1).csv,813,2024-06,False,Other Computer Services,Other Computer Services,Other Computer Services
,2024-06-03,8400/000 : FNB,74609054153000006133575,Account Payment,42.71 DIGITALOCEAN. 4910505191 01 JUN 74609054153000006133575,823.97,,1399468.05,AccountTransactionsReport(1).csv,814,2024-06,False,Cloud Services,Cloud Services,Cloud Services
,2024-06-03,8400/000 : FNB,74987504152000713205051,Account Payment,652.91 FACEBK 5MGN 4910505191 31 MAY 74987504152000713205051,652.91,,1400120.96,AccountTransactionsReport(1).csv,815,2024-06,False,Other Computer Services,Other Computer Services,Other Computer Services
,2024-06-03,8400/000 : FNB,24492164152000034937081,Account Payment,29.00 VIRTONOMICS S 4910505191 31 MAY 24492164152000034937081,556.13,,1400677.09,AccountTransactionsReport(1).csv,816,2024-06,False,Other Computer Services,Other Computer Services,Other Computer Services
,2024-06-03,8400/000 : FNB,24168884152106927593232,Account Payment,546.25 INTUIT QBoo 4910505225 31 MAY 24168884152106927593232,546.25,,1401223.34,AccountTransactionsReport(1).csv,817,2024-06,False,Productivity Software,Productivity Software,Productivity Software
,2024-06-03,8400/000 : FNB,24011344153000017310545,Account Payment,134.00 SQUARESPACE 4910505191 01 JUN 24011344153000017310545,134.0,,1401357.34,AccountTransactionsReport(1).csv,818,2024-06,False,Payment Processing,Payment Processing,Payment Processing
,2024-06-03,STOCK2SHOP (PTY) LTD,WWI31375,Supplier Invoice,3300/020 : Computer - Platforms,4728.0,,1406085.34,AccountTransactionsReport(1).csv,819,2024-06,False,E-commerce Platforms,E-commerce Platforms,E-commerce Platforms
,2024-06-04,8400/000 : FNB,74697694154920051548564,Account Payment,924.05 GOOGLECLOUD 4910505191 01 JUN 74697694154920051548564,17826.93,,1423912.27,AccountTransactionsReport(1).csv,820,2024-06,False,Other Computer Services,Analytics & Monitoring,Analytics & Monitoring
,2024-06-04,8400/000 : FNB,74201334154000006996143,Account Payment,450.00 WAPPALYZER 4910505191 02 JUN 74201334154000006996143,8681.48,,1432593.75,AccountTransactionsReport(1).csv,821,2024-06,False,Other Computer Services,Other Computer Services,Other Computer Services
,2024-06-04,8400/000 : FNB,24011344153000083665244,Account Payment,29.00 ECM A LEGALZ 4910505191 01 JUN 24011344153000083665244,559.47,,1433153.22,AccountTransactionsReport(1).csv,822,2024-06,False,Other Computer Services,Other Computer Services,Other Computer Services
,2024-06-04,8400/000 : FNB,74796314153000800812060,Account Payment,27.60 FACEBK CGLW5 4910505191 01 JUN 74796314153000800812060,532.46,,1433685.68,AccountTransactionsReport(1).csv,823,2024-06,False,Other Computer Services,Other Computer Services,Other Computer Services
,2024-06-04,8400/000 : FNB,74609054153000008336416,Account Payment,17.25 SLACK T06A3T4 4910505191 01 JUN 74609054153000008336416,332.79,,1434018.47,AccountTransactionsReport(1).csv,824,2024-06,False,Communication,Communication,Communication
,2024-06-04,8400/000 : FNB,74045464154910041033816,Account Payment,12.00 GOOGLEGSUITE 4910505191 01 JUN 74045464154910041033816,294.19,,1434312.66,AccountTransactionsReport(1).csv,825,2024-06,False,Other Computer Services,Analytics & Monitoring,Analytics & Monitoring
,2024-06-04,8400/000 : FNB,74796314153000400693068,Account Payment,9.20 FACEBK KLX493 4910505191 01 JUN 74796314153000400693068,177.49,,1434490.15,AccountTransactionsReport(1).csv,826,2024-06,False,Other Computer Services,Other Computer Services,Other Computer Services
,2024-06-04,8400/000 : FNB,24492164153000033306550,Account Payment,7.00 GLASSFROG 4910505191 01 JUN 24492164153000033306550,135.05,,1434625.2,AccountTransactionsReport(1).csv,827,2024-06,False,Other Computer Services,Other Computer Services,Other Computer Services
,2024-06-04,8400/000 : FNB,76230133,Account Payment,FNB OBE 76230133 76230133,37.92,,1434663.12,AccountTransactionsReport(1).csv,828,2024-06,False,Other Computer Services,Other Computer Services,Other Computer Services
,2024-06-04,8400/000 : FNB,74697694154920055238345,Account Payment,391.60 GOOGLEGSUIT 4910505225 01 JUN 74697694154920055238345,8176.2,,1442839.32,AccountTransactionsReport(1).csv,829,2024-06,False,Other Computer Services,Analytics & Monitoring,Analytics & Monitoring
,2024-06-04,8400/000 : FNB,74697694154920051304042,Account Payment,263.45 GOOGLEGSUIT 4910505191 01 JUN 74697694154920051304042,5082.52,,1447921.84,AccountTransactionsReport(1).csv,830,2024-06,False,Other Computer Services,Analytics & Monitoring,Analytics & Monitoring
,2024-06-04,8400/000 : FNB,24011344153000073994513,Account Payment,134.00 SINCH MAILGU 4910505191 01 JUN 24011344153000073994513,2585.15,,1450506.99,AccountTransactionsReport(1).csv,831,2024-06,False,Other Computer Services,Other Computer Services,Other Computer Services
,2024-06-04,8400/000 : FNB,74697694154920055206227,Account Payment,83.96 GOOGLEGSUITE 4910505225 01 JUN 74697694154920055206227,1753.0,,1452259.99,AccountTransactionsReport(1).csv,832,2024-06,False,Other Computer Services,Analytics & Monitoring,Analytics & Monitoring
,2024-06-04,8400/000 : FNB,74796314153000500779072,Account Payment,46.00 FACEBK SP48L 4910505191 01 JUN 74796314153000500779072,887.44,,1453147.43,AccountTransactionsReport(1).csv,833,2024-06,False,Other Computer Services,Other Computer Services,Other Computer Services
,2024-06-04,8400/000 : FNB,74697694154920051223887,Account Payment,39.82 GOOGLEGSUITE 4910505191 01 JUN 74697694154920051223887,831.4,,1453978.83,AccountTransactionsReport(1).csv,834,2024-06,False,Other Computer Services,Analytics & Monitoring,Analytics & Monitoring
,2024-06-04,8400/000 : FNB,24011344153000043555006,Account Payment,674.34 CANVA I0416 4910505225 01 JUN 24011344153000043555006,674.34,,1454653.17,AccountTransactionsReport(1).csv,835,2024-06,False,Other Computer Services,Design Tools,Design Tools
,2024-06-05,8400/000 : FNB,24000774155000010909888,Account Payment,540.00 AIRTABLE.COM 4910505225 03 JUN 24000774155000010909888,10417.77,,1465070.94,AccountTransactionsReport(1).csv,836,2024-06,False,Other Computer Services,Collaboration Tools,Collaboration Tools
,2024-06-05,8400/000 : FNB,24011344156000025400525,Account Payment,249.00 STABLE 4910505191 04 JUN 24011344156000025400525,4799.64,,1469870.58,AccountTransactionsReport(1).csv,837,2024-06,False,Other Computer Services,Other Computer Services,Other Computer Services
,2024-06-05,8400/000 : FNB,24011344155000068856634,Account Payment,207.00 FIGMA ANNUAL 4910505191 03 JUN 24011344155000068856634,3993.47,,1473864.05,AccountTransactionsReport(1).csv,838,2024-06,False,Other Computer Services,Design Tools,Design Tools
,2024-06-05,8400/000 : FNB,24011344155000066202807,Account Payment,143.20 MOZSEOHELP@ 4910505191 03 JUN 24011344155000066202807,2762.64,,1476626.69,AccountTransactionsReport(1).csv,839,2024-06,False,Other Computer Services,Other Computer Services,Other Computer Services
,2024-06-05,8400/000 : FNB,74609054156000002097250,Account Payment,99.00 DMNS.APP BUSI 4910505191 04 JUN 74609054156000002097250,1908.29,,1478534.98,AccountTransactionsReport(1).csv,840,2024-06,False,Other Computer Services,Other Computer Services,Other Computer Services
,2024-06-05,8400/000 : FNB,74083424156000001395804,Account Payment,60.00 INSOMNIA TEAM 4910505191 03 JUN 74083424156000001395804,1156.54,,1479691.52,AccountTransactionsReport(1).csv,841,2024-06,False,Other Computer Services,Other Computer Services,Other Computer Services
,2024-06-05,8400/000 : FNB,74389244155000000016363,Account Payment,49.91 FRAPPE CLOUD 4910505191 03 JUN 74389244155000000016363,962.87,,1480654.39,AccountTransactionsReport(1).csv,842,2024-06,False,Other Computer Services,Other Computer Services,Other Computer Services
,2024-06-05,8400/000 : FNB,24000774156000006360582,Account Payment,4.95 SHELLS.COM 4910505191 04 JUN 24000774156000006360582,95.41,,1480749.8,AccountTransactionsReport(1).csv,843,2024-06,False,Other Computer Services,Other Computer Services,Other Computer Services
,2024-06-05,8400/000 : FNB,24492164156000013664793,Account Payment,1499.00 APPDIRECT 4910505225 04 JUN 24492164156000013664793,28894.2,,1509644.0,AccountTransactionsReport(1).csv,844,2024-06,False,Other Computer Services,Other Computer Services,Other Computer Services
,2024-06-06,8400/000 : FNB,74548584157002809006970,Account Payment,SAGE ACC 4910505225 04 JUN 74548584157002809006970,3160.0,,1512804.0,AccountTransactionsReport(1).csv,845,2024-06,False,Other Computer Services,Other Computer Services,Other Computer Services
,2024-06-06,8400/000 : FNB,24000774156000015299565,Account Payment,19.00 GITHUB INC. 4910505225 04 JUN 24000774156000015299565,366.24,,1513170.24,AccountTransactionsReport(1).csv,846,2024-06,False,Development Tools,Development Tools,Development Tools
,2024-06-06,8400/000 : FNB,24000774156000015452768,Account Payment,10.49 GITHUB INC. 4910505225 04 JUN 24000774156000015452768,202.2,,1513372.44,AccountTransactionsReport(1).csv,847,2024-06,False,Development Tools,Development Tools,Development Tools
,2024-06-06,8400/000 : FNB,74143614157000107143101,Account Payment,2058.98 SHOPIFY 23 4910505191 04 JUN 74143614157000107143101,39688.18,,1553060.62,AccountTransactionsReport(1).csv,848,2024-06,False,E-commerce Platforms,E-commerce Platforms,E-commerce Platforms
,2024-06-06,8400/000 : FNB,24011344157000000792416,Account Payment,599.00 TRIPLE WHALE 4910505191 04 JUN 24011344157000000792416,11546.11,,1564606.73,AccountTransactionsReport(1).csv,849,2024-06,False,Other Computer Services,Other Computer Services,Other Computer Services
,2024-06-06,The Courier Guy,WWI31387,Supplier Invoice,3300/020 : Computer - Platforms,935.0,,1565541.73,AccountTransactionsReport(1).csv,850,2024-06,False,Other Computer Services,Other Computer Services,Other Computer Services
,2024-06-07,8400/000 : FNB,74987504158000233798050,Account Payment,332.35 1xAll Produc 4910505191 04 JUN 74987504158000233798050,6406.26,,1571947.99,AccountTransactionsReport(1).csv,851,2024-06,False,Other Computer Services,Other Computer Services,Other Computer Services
,2024-06-07,8400/000 : FNB,74878464157422820403862,Account Payment,126.50 MICROSOFTG0 4910505191 05 JUN 74878464157422820403862,2424.46,,1574372.45,AccountTransactionsReport(1).csv,852,2024-06,False,Productivity Software,Productivity Software,Productivity Software
,2024-06-07,8400/000 : FNB,24000774157000009270118,Account Payment,120.75 MANAGEWP 4910505225 05 JUN 24000774157000009270118,2314.26,,1576686.71,AccountTransactionsReport(1).csv,853,2024-06,False,Other Computer Services,Other Computer Services,Other Computer Services
,2024-06-07,8400/000 : FNB,24000774157000009076614,Account Payment,120.75 MANAGEWP 4910505225 05 JUN 24000774157000009076614,2314.26,,1579000.97,AccountTransactionsReport(1).csv,854,2024-06,False,Other Computer Services,Other Computer Services,Other Computer Services
,2024-06-07,8400/000 : FNB,74007484158259435200304,Account Payment,77.05 CBAPlesk 4910505191 05 JUN 74007484158259435200304,1476.72,,1580477.69,AccountTransactionsReport(1).csv,855,2024-06,False,Domain & Hosting,Domain & Hosting,Domain & Hosting
,2024-06-07,8400/000 : FNB,24011344158000024665134,Account Payment,20.00 VERCEL INC. 4910505225 06 JUN 24011344158000024665134,387.56,,1580865.25,AccountTransactionsReport(1).csv,856,2024-06,False,Cloud Services,Cloud Services,Cloud Services
,2024-06-07,8400/000 : FNB,24011344158000023905069,Account Payment,20.00 VERCEL INC. 4910505225 06 JUN 24011344158000023905069,387.56,,1581252.81,AccountTransactionsReport(1).csv,857,2024-06,False,Cloud Services,Cloud Services,Cloud Services
,2024-06-07,8400/000 : FNB,24011344158000020822796,Account Payment,15.00 HIGHTAIL 4910505191 06 JUN 24011344158000020822796,290.67,,1581543.48,AccountTransactionsReport(1).csv,858,2024-06,False,Other Computer Services,Other Computer Services,Other Computer Services
,2024-06-08,8400/000 : FNB,74922134158038240013950,Account Payment,BOB GROUP 4910505191 01 JUN 74922134158038240013950,2298.85,,1583842.33,AccountTransactionsReport(1).csv,859,2024-06,False,Other Computer Services,Other Computer Services,Other Computer Services
,2024-06-08,8400/000 : FNB,74922134158038240013117,Account Payment,BOB GROUP 4910505191 01 JUN 74922134158038240013117,2298.85,,1586141.18,AccountTransactionsReport(1).csv,860,2024-06,False,Other Computer Services,Other Computer Services,Other Computer Services
,2024-06-08,8400/000 : FNB,74922134158038240012721,Account Payment,BOB GROUP 4910505191 01 JUN 74922134158038240012721,2298.85,,1588440.03,AccountTransactionsReport(1).csv,861,2024-06,False,Other Computer Services,Other Computer Services,Other Computer Services
,2024-06-08,8400/000 : FNB,74609054158000009733186,Account Payment,19.99 WOOCOMMERCE S 4910505225 06 JUN 74609054158000009733186,387.37,,1588827.4,AccountTransactionsReport(1).csv,862,2024-06,False,Other Computer Services,Other Computer Services,Other Computer Services
,2024-06-08,8400/000 : FNB,24000774158000016545964,Account Payment,11.07 HEROKU MAY-9 4910505191 06 JUN 24000774158000016545964,214.52,,1589041.92,AccountTransactionsReport(1).csv,863,2024-06,False,Cloud Services,Cloud Services,Cloud Services
,2024-06-08,8400/000 : FNB,74609054159000005022781,Account Payment,9.00 GITPOD.IO 4910505191 07 JUN 74609054159000005022781,174.66,,1589216.58,AccountTransactionsReport(1).csv,864,2024-06,False,Development Tools,Development Tools,Development Tools
,2024-06-08,8400/000 : FNB,24000774158000008633562,Account Payment,9.00 TWENTY.COM 4910505191 06 JUN 24000774158000008633562,174.4,,1589390.98,AccountTransactionsReport(1).csv,865,2024-06,False,Other Computer Services,Other Computer Services,Other Computer Services
,2024-06-08,8400/000 : FNB,24492164159000011257332,Account Payment,7.00 NPM INC. 4910505191 07 JUN 24492164159000011257332,135.85,,1589526.83,AccountTransactionsReport(1).csv,866,2024-06,False,Other Computer Services,Other Computer Services,Other Computer Services
,2024-06-08,8400/000 : FNB,24492164159000011228564,Account Payment,7.00 NPM INC. 4910505191 07 JUN 24492164159000011228564,135.85,,1589662.68,AccountTransactionsReport(1).csv,867,2024-06,False,Other Computer Services,Other Computer Services,Other Computer Services
,2024-06-08,8400/000 : FNB,24492164159000011216007,Account Payment,7.00 NPM INC. 4910505191 07 JUN 24492164159000011216007,135.85,,1589798.53,AccountTransactionsReport(1).csv,868,2024-06,False,Other Computer Services,Other Computer Services,Other Computer Services
,2024-06-08,8400/000 : FNB,24492164159000011081476,Account Payment,7.00 NPM INC. 4910505191 07 JUN 24492164159000011081476,135.85,,1589934.38,AccountTransactionsReport(1).csv,869,2024-06,False,Other Computer Services,Other Computer Services,Other Computer Services
,2024-06-08,8400/000 : FNB,74208474159000012491578,Account Payment,3.60 GETADDRESS.IO 4910505225 07 JUN 74208474159000012491578,89.27,,1590023.65,AccountTransactionsReport(1).csv,870,2024-06,False,Other Computer Services,Other Computer Services,Other Computer Services
,2024-06-10,8400/000 : FNB,24021214160024509495980,Account Payment,171.35 PADDLE.NET 4910505191 08 JUN 24021214160024509495980,3325.33,,1593348.98,AccountTransactionsReport(1).csv,871,2024-06,False,Other Computer Services,Subscription Management,Subscription Management
,2024-06-10,8400/000 : FNB,24492164160000000066154,Account Payment,99.00 MIOSALON.COM 4910505225 07 JUN 24492164160000000066154,1921.34,,1595270.32,AccountTransactionsReport(1).csv,872,2024-06,False,Other Computer Services,Other Computer Services,Other Computer Services
,2024-06-10,8400/000 : FNB,24492164160000000041223,Account Payment,99.00 MIOSALON.COM 4910505225 07 JUN 24492164160000000041223,1921.34,,1597191.66,AccountTransactionsReport(1).csv,873,2024-06,False,Other Computer Services,Other Computer Services,Other Computer Services
,2024-06-10,8400/000 : FNB,24168884159102974641688,Account Payment,546.25 INTUIT QBoo 4910505225 07 JUN 24168884159102974641688,546.25,,1597737.91,AccountTransactionsReport(1).csv,874,2024-06,False,Productivity Software,Productivity Software,Productivity Software
,2024-06-10,8400/000 : FNB,74609054159000020097776,Account Payment,12.00 CODESANDBOX 4910505191 07 JUN 74609054159000020097776,232.89,,1597970.8,AccountTransactionsReport(1).csv,875,2024-06,False,Other Computer Services,Other Computer Services,Other Computer Services
,2024-06-11,8400/000 : FNB,24492164161000013963859,Account Payment,1499.00 APPDIRECT 4910505191 09 JUN 24492164161000013963859,29090.62,,1627061.42,AccountTransactionsReport(1).csv,876,2024-06,False,Other Computer Services,Other Computer Services,Other Computer Services
,2024-06-11,8400/000 : FNB,74609054161000009047327,Account Payment,695.00 WWW.W3SCHOOL 4910505191 09 JUN 74609054161000009047327,13487.64,,1640549.06,AccountTransactionsReport(1).csv,877,2024-06,False,Other Computer Services,Other Computer Services,Other Computer Services
,2024-06-11,8400/000 : FNB,24492164160000031620052,Account Payment,150.00 AUTH0.COM 4910505191 08 JUN 24492164160000031620052,2911.0,,1643460.06,AccountTransactionsReport(1).csv,878,2024-06,False,Security Services,Security Services,Security Services
,2024-06-11,8400/000 : FNB,24000774161000017789400,Account Payment,149.00 CASSIDYAI.CO 4910505191 09 JUN 24000774161000017789400,2891.6,,1646351.66,AccountTransactionsReport(1).csv,879,2024-06,False,Other Computer Services,Other Computer Services,Other Computer Services
,2024-06-11,8400/000 : FNB,24492164161000015748621,Account Payment,60.00 OPENAI CHATG 4910505191 09 JUN 24492164161000015748621,1164.4,,1647516.06,AccountTransactionsReport(1).csv,880,2024-06,False,AI Services,AI Services,AI Services
,2024-06-11,8400/000 : FNB,74143254161000002244540,Account Payment,49.00 SKRAPP.IO STA 4910505191 09 JUN 74143254161000002244540,950.93,,1648466.99,AccountTransactionsReport(1).csv,881,2024-06,False,Other Computer Services,Other Computer Services,Other Computer Services
,2024-06-11,8400/000 : FNB,24000774160000009424272,Account Payment,28.75 CLOUDFLARE 4910505191 08 JUN 24000774160000009424272,557.94,,1649024.93,AccountTransactionsReport(1).csv,882,2024-06,False,Cloud Services,Cloud Services,Cloud Services
,2024-06-11,8400/000 : FNB,74389244161000000030382,Account Payment,25.00 BEECEPTOR 4910505191 09 JUN 74389244161000000030382,485.16,,1649510.09,AccountTransactionsReport(1).csv,883,2024-06,False,Other Computer Services,Other Computer Services,Other Computer Services
,2024-06-11,8400/000 : FNB,74389244161000000030234,Account Payment,25.00 BEECEPTOR 4910505191 09 JUN 74389244161000000030234,485.16,,1649995.25,AccountTransactionsReport(1).csv,884,2024-06,False,Other Computer Services,Other Computer Services,Other Computer Services
,2024-06-11,8400/000 : FNB,24492164160000037893646,Account Payment,25.00 NOTION LABS 4910505191 08 JUN 24492164160000037893646,485.16,,1650480.41,AccountTransactionsReport(1).csv,885,2024-06,False,Other Computer Services,Collaboration Tools,Collaboration Tools
,2024-06-12,8400/000 : FNB,74143614163000099954822,Account Payment,3001.45 SHOPIFY 24 4910505225 10 JUN 74143614163000099954822,58248.2,,1708728.61,AccountTransactionsReport(1).csv,886,2024-06,False,E-commerce Platforms,E-commerce Platforms,E-commerce Platforms
,2024-06-12,8400/000 : FNB,74609054162000014412432,Account Payment,10.06 SLACK T0740DV 4910505191 10 JUN 74609054162000014412432,195.23,,1708923.84,AccountTransactionsReport(1).csv,887,2024-06,False,Communication,Communication,Communication
,2024-06-13,8400/000 : FNB,24000774163000015863965,Account Payment,189.00 GITHUB INC. 4910505225 11 JUN 24000774163000015863965,3651.17,,1712575.01,AccountTransactionsReport(1).csv,888,2024-06,False,Development Tools,Development Tools,Development Tools
,2024-06-13,8400/000 : FNB,24000774163000015956553,Account Payment,63.00 GITHUB INC. 4910505225 11 JUN 24000774163000015956553,1217.05,,1713792.06,AccountTransactionsReport(1).csv,889,2024-06,False,Development Tools,Development Tools,Development Tools
,2024-06-13,8400/000 : FNB,24000774163000015777827,Account Payment,57.94 GITHUB INC. 4910505225 11 JUN 24000774163000015777827,1119.31,,1714911.37,AccountTransactionsReport(1).csv,890,2024-06,False,Development Tools,Development Tools,Development Tools
,2024-06-13,8400/000 : FNB,24168884163106363257265,Account Payment,546.25 INTUIT QBoo 4910505225 11 JUN 24168884163106363257265,546.25,,1715457.62,AccountTransactionsReport(1).csv,891,2024-06,False,Productivity Software,Productivity Software,Productivity Software
,2024-06-13,8400/000 : FNB,24168884163106363257182,Account Payment,546.25 INTUIT QBoo 4910505225 11 JUN 24168884163106363257182,546.25,,1716003.87,AccountTransactionsReport(1).csv,892,2024-06,False,Productivity Software,Productivity Software,Productivity Software
,2024-06-13,8400/000 : FNB,74609054164000005612428,Account Payment,11.12 SLACK T0740DV 4910505191 12 JUN 74609054164000005612428,212.93,,1716216.8,AccountTransactionsReport(1).csv,893,2024-06,False,Communication,Communication,Communication
,2024-06-14,8400/000 : FNB,74987504164001009598080,Account Payment,1124.99 LinkedIn SN 4910505191 12 JUN 74987504164001009598080,1124.99,,1717341.79,AccountTransactionsReport(1).csv,894,2024-06,False,Other Computer Services,Other Computer Services,Other Computer Services
,2024-06-14,8400/000 : FNB,24000774164000016869838,Account Payment,23.80 GITHUB INC. 4910505191 12 JUN 24000774164000016869838,455.73,,1717797.52,AccountTransactionsReport(1).csv,895,2024-06,False,Development Tools,Development Tools,Development Tools
,2024-06-14,8400/000 : FNB,24000774164000018066680,Account Payment,15.00 TABNINE 4910505191 12 JUN 24000774164000018066680,287.22,,1718084.74,AccountTransactionsReport(1).csv,896,2024-06,False,Other Computer Services,Other Computer Services,Other Computer Services
,2024-06-15,8400/000 : FNB,24492164165000018818666,Account Payment,70.00 NOTION LABS 4910505191 13 JUN 24492164165000018818666,1333.94,,1719418.68,AccountTransactionsReport(1).csv,897,2024-06,False,Other Computer Services,Collaboration Tools,Collaboration Tools
,2024-06-15,8400/000 : FNB,74247284165820129430070,Account Payment,180.00 AGENCYANALYT 4910505225 13 JUN 74247284165820129430070,3430.12,,1722848.8,AccountTransactionsReport(1).csv,898,2024-06,False,Other Computer Services,Other Computer Services,Other Computer Services
,2024-06-15,8400/000 : FNB,24492164165000021905674,Account Payment,105.40 NOTION LABS 4910505191 13 JUN 24492164165000021905674,2008.52,,1724857.32,AccountTransactionsReport(1).csv,899,2024-06,False,Other Computer Services,Collaboration Tools,Collaboration Tools
,2024-06-15,8400/000 : FNB,24011344166000027075232,Account Payment,99.00 DYNAMIC.XYZ 4910505191 14 JUN 24011344166000027075232,1872.68,,1726730.0,AccountTransactionsReport(1).csv,900,2024-06,False,Other Computer Services,Other Computer Services,Other Computer Services
,2024-06-18,8400/000 : FNB,74796314169000800006053,Account Payment,26415.96 MSFT E07 4910505225 17 JUN 74796314169000800006053,26415.96,,1753145.96,AccountTransactionsReport(1).csv,901,2024-06,False,Other Computer Services,Other Computer Services,Other Computer Services
,2024-06-18,8400/000 : FNB,24492164167000009040575,Account Payment,780.00 ACQUIRE.COM 4910505191 15 JUN 24492164167000009040575,14726.55,,1767872.51,AccountTransactionsReport(1).csv,902,2024-06,False,Other Computer Services,Other Computer Services,Other Computer Services
,2024-06-18,8400/000 : FNB,24000774168000004423966,Account Payment,588.00 POSTMAN ENTE 4910505191 16 JUN 24000774168000004423966,11101.55,,1778974.06,AccountTransactionsReport(1).csv,903,2024-06,False,Other Computer Services,API Services,API Services
,2024-06-18,8400/000 : FNB,74878464166423988439218,Account Payment,414.00 MICROSOFTG0 4910505225 13 JUN 74878464166423988439218,7889.28,,1786863.34,AccountTransactionsReport(1).csv,904,2024-06,False,Productivity Software,Productivity Software,Productivity Software
,2024-06-18,8400/000 : FNB,74796314169000200036049,Account Payment,5439.50 MSFT 3cE0 4910505225 17 JUN 74796314169000200036049,5439.5,,1792302.84,AccountTransactionsReport(1).csv,905,2024-06,False,Other Computer Services,Other Computer Services,Other Computer Services
,2024-06-18,8400/000 : FNB,24492164167000000388676,Account Payment,280.00 WIZA.CO 4910505191 14 JUN 24492164167000000388676,5296.47,,1797599.31,AccountTransactionsReport(1).csv,906,2024-06,False,Other Computer Services,Other Computer Services,Other Computer Services
,2024-06-18,8400/000 : FNB,24011344168000048555038,Account Payment,279.00 TRIPLE WHALE 4910505191 16 JUN 24011344168000048555038,5267.58,,1802866.89,AccountTransactionsReport(1).csv,907,2024-06,False,Other Computer Services,Other Computer Services,Other Computer Services
,2024-06-18,8400/000 : FNB,74609054167000004787749,Account Payment,179.76 SLACK T0MN3D 4910505225 15 JUN 74609054167000004787749,3393.9,,1806260.79,AccountTransactionsReport(1).csv,908,2024-06,False,Communication,Communication,Communication
,2024-06-18,8400/000 : FNB,74796314169000800026069,Account Payment,408.94 MSFT 3cE07 4910505225 17 JUN 74796314169000800026069,408.94,,1806669.73,AccountTransactionsReport(1).csv,909,2024-06,False,Other Computer Services,Other Computer Services,Other Computer Services
,2024-06-18,8400/000 : FNB,24000774166000020398467,Account Payment,14.00 GITHUB INC. 4910505225 14 JUN 24000774166000020398467,264.82,,1806934.55,AccountTransactionsReport(1).csv,910,2024-06,False,Development Tools,Development Tools,Development Tools
,2024-06-18,8400/000 : FNB,74987504168000425868065,Account Payment,1725.00 FACEBK YPH 4910505191 16 JUN 74987504168000425868065,1725.0,,1808659.55,AccountTransactionsReport(1).csv,911,2024-06,False,Other Computer Services,Other Computer Services,Other Computer Services
,2024-06-18,8400/000 : FNB,74389244167000000012145,Account Payment,75.00 WWW.VIDBOARD. 4910505191 15 JUN 74389244167000000012145,1416.02,,1810075.57,AccountTransactionsReport(1).csv,912,2024-06,False,Other Computer Services,Other Computer Services,Other Computer Services
,2024-06-18,8400/000 : FNB,74143614167000108278482,Account Payment,74.75 SHOPIFY 2421 4910505225 14 JUN 74143614167000108278482,1413.96,,1811489.53,AccountTransactionsReport(1).csv,913,2024-06,False,E-commerce Platforms,E-commerce Platforms,E-commerce Platforms
,2024-06-18,8400/000 : FNB,74313294168100735957716,Account Payment,1152.20 FACEBK EEK 4910505191 16 JUN 74313294168100735957716,1152.2,,1812641.73,AccountTransactionsReport(1).csv,914,2024-06,False,Other Computer Services,Other Computer Services,Other Computer Services
,2024-06-18,8400/000 : FNB,24011344169000023725720,Account Payment,1150.00 SQUARESPACE 4910505191 17 JUN 24011344169000023725720,1150.0,,1813791.73,AccountTransactionsReport(1).csv,915,2024-06,False,Payment Processing,Payment Processing,Payment Processing
,2024-06-18,8400/000 : FNB,24492164166000023649634,Account Payment,60.00 OPENAI CHATG 4910505191 14 JUN 24492164166000023649634,1134.95,,1814926.68,AccountTransactionsReport(1).csv,916,2024-06,False,AI Services,AI Services,AI Services
,2024-06-18,8400/000 : FNB,24492164168000014252495,Account Payment,32.00 BUBBLE STARTE 4910505191 16 JUN 24492164168000014252495,604.17,,1815530.85,AccountTransactionsReport(1).csv,917,2024-06,False,Other Computer Services,Other Computer Services,Other Computer Services
,2024-06-18,8400/000 : FNB,24168884166109086602707,Account Payment,546.25 INTUIT QBoo 4910505225 14 JUN 24168884166109086602707,546.25,,1816077.1,AccountTransactionsReport(1).csv,918,2024-06,False,Productivity Software,Productivity Software,Productivity Software
,2024-06-19,8400/000 : FNB,24011344169000033874005,Account Payment,19.99 CHRISKING ME 4910505191 17 JUN 24011344169000033874005,377.41,,1816454.51,AccountTransactionsReport(1).csv,919,2024-06,False,Other Computer Services,Other Computer Services,Other Computer Services
,2024-06-19,8400/000 : FNB,24492164170000010444563,Account Payment,9.00 EMMA AI 4910505191 18 JUN 24492164170000010444563,169.02,,1816623.53,AccountTransactionsReport(1).csv,920,2024-06,False,Other Computer Services,Other Computer Services,Other Computer Services
,2024-06-20,8400/000 : FNB,74609054171000004326633,Account Payment,17.25 SLACK T4ENT13 4910505225 19 JUN 74609054171000004326633,322.19,,1816945.72,AccountTransactionsReport(1).csv,921,2024-06,False,Communication,Communication,Communication
,2024-06-20,8400/000 : FNB,24000774171000006184058,Account Payment,100.00 NAMEBIO 4910505191 19 JUN 24000774171000006184058,1867.75,,1818813.47,AccountTransactionsReport(1).csv,922,2024-06,False,Other Computer Services,Other Computer Services,Other Computer Services
,2024-06-20,8400/000 : FNB,24064664170000000424283,Account Payment,99.00 PLAYFAB INC. 4910505191 18 JUN 24064664170000000424283,1859.28,,1820672.75,AccountTransactionsReport(1).csv,923,2024-06,False,Other Computer Services,Other Computer Services,Other Computer Services
,2024-06-21,8400/000 : FNB,24011344171000054800315,Account Payment,248.40 WIX.COM 1121 4910505191 19 JUN 24011344171000054800315,4689.84,,1825362.59,AccountTransactionsReport(1).csv,924,2024-06,False,E-commerce Platforms,E-commerce Platforms,E-commerce Platforms
,2024-06-21,8400/000 : FNB,24000774172000006957940,Account Payment,149.00 AI PDF MYAID 4910505191 20 JUN 24000774172000006957940,2746.94,,1828109.53,AccountTransactionsReport(1).csv,925,2024-06,False,Other Computer Services,Other Computer Services,Other Computer Services
,2024-06-21,8400/000 : FNB,24011344171000055072971,Account Payment,66.47 WIX.COM 11218 4910505191 19 JUN 24011344171000055072971,1254.97,,1829364.5,AccountTransactionsReport(1).csv,926,2024-06,False,E-commerce Platforms,E-commerce Platforms,E-commerce Platforms
,2024-06-21,8400/000 : FNB,24492164171000017121080,Account Payment,59.00 GREENBACK.COM 4910505225 19 JUN 24492164171000017121080,1101.98,,1830466.48,AccountTransactionsReport(1).csv,927,2024-06,False,Other Computer Services,Other Computer Services,Other Computer Services
,2024-06-21,8400/000 : FNB,24168884171103036623742,Account Payment,546.25 INTUIT QBoo 4910505225 19 JUN 24168884171103036623742,546.25,,1831012.73,AccountTransactionsReport(1).csv,928,2024-06,False,Productivity Software,Productivity Software,Productivity Software
,2024-06-21,8400/000 : FNB,24168884171103034621235,Account Payment,546.25 INTUIT QBoo 4910505225 19 JUN 24168884171103034621235,546.25,,1831558.98,AccountTransactionsReport(1).csv,929,2024-06,False,Productivity Software,Productivity Software,Productivity Software
,2024-06-21,8400/000 : FNB,24168884171103033880147,Account Payment,546.25 INTUIT QBoo 4910505225 19 JUN 24168884171103033880147,546.25,,1832105.23,AccountTransactionsReport(1).csv,930,2024-06,False,Productivity Software,Productivity Software,Productivity Software
,2024-06-21,8400/000 : FNB,24168884171103036623718,Account Payment,264.50 INTUIT QBoo 4910505225 19 JUN 24168884171103036623718,264.5,,1832369.73,AccountTransactionsReport(1).csv,931,2024-06,False,Productivity Software,Productivity Software,Productivity Software
,2024-06-22,8400/000 : FNB,"20.0 REPLIT, INC",Account Payment,"20.0 REPLIT, INC",368.72,,1832738.45,AccountTransactionsReport(1).csv,932,2024-06,False,Other Computer Services,Other Computer Services,Other Computer Services
,2024-06-22,8400/000 : FNB,54.00 AIRTABLE.COM,Account Payment,54.00 AIRTABLE.COM,1001.58,,1833740.03,AccountTransactionsReport(1).csv,933,2024-06,False,Other Computer Services,Collaboration Tools,Collaboration Tools
,2024-06-22,8400/000 : FNB,"74.00 PIPEDREAM, IN",Account Payment,"74.00 PIPEDREAM, IN",1364.25,,1835104.28,AccountTransactionsReport(1).csv,934,2024-06,False,Other Computer Services,Other Computer Services,Other Computer Services
,2024-06-25,8400/000 : FNB,60.00 OPENAI *CHATG,Account Payment,60.00 OPENAI *CHATG,1102.84,,1836207.12,AccountTransactionsReport(1).csv,935,2024-06,False,AI Services,AI Services,AI Services
,2024-06-26,8400/000 : FNB,10.00 MATTERMOST,Account Payment,10.00 MATTERMOST,186.11,,1836393.23,AccountTransactionsReport(1).csv,936,2024-06,False,Other Computer Services,Other Computer Services,Other Computer Services
,2024-06-26,8400/000 : FNB,100.00 OPENAI,Account Payment,100.00 OPENAI,1838.08,,1838231.31,AccountTransactionsReport(1).csv,937,2024-06,False,AI Services,AI Services,AI Services
,2024-06-26,8400/000 : FNB,231.95 HOLASPIRIT,Account Payment,231.95 HOLASPIRIT,4633.27,,1842864.58,AccountTransactionsReport(1).csv,938,2024-06,False,Other Computer Services,Other Computer Services,Other Computer Services
,2024-06-26,8400/000 : FNB,376.40 HOLASPIRIT,Account Payment,376.40 HOLASPIRIT,7518.7,,1850383.28,AccountTransactionsReport(1).csv,939,2024-06,False,Other Computer Services,Other Computer Services,Other Computer Services
,2024-06-27,8400/000 : FNB,30.00 HASURA,Account Payment,30.00 HASURA,558.34,,1850941.62,AccountTransactionsReport(1).csv,940,2024-06,False,Other Computer Services,Other Computer Services,Other Computer Services
,2024-06-27,8400/000 : FNB,34.12 WWW.MAKE.COM,Account Payment,34.12 WWW.MAKE.COM,636.26,,1851577.88,AccountTransactionsReport(1).csv,941,2024-06,False,Other Computer Services,API Services,API Services
,2024-06-27,8400/000 : FNB,150.00 AUTH0.COM,Account Payment,150.00 AUTH0.COM,2797.13,,1854375.01,AccountTransactionsReport(1).csv,942,2024-06,False,Security Services,Security Services,Security Services
,2024-06-27,8400/000 : FNB,24.14 ILLUSTRATOR,Account Payment,24.14 ILLUSTRATOR,449.28,,1854824.29,AccountTransactionsReport(1).csv,943,2024-06,False,Other Computer Services,Other Computer Services,Other Computer Services
,2024-06-27,8400/000 : FNB,27.60 LEMSQZY *CODE,Account Payment,27.60 LEMSQZY *CODE,513.67,,1855337.96,AccountTransactionsReport(1).csv,944,2024-06,False,AI Services,AI Services,AI Services
,2024-06-28,8400/000 : FNB,Facebk,Account Payment,697.89 fACEBK,697.89,,1856035.85,AccountTransactionsReport(1).csv,945,2024-06,False,Other Computer Services,Other Computer Services,Other Computer Services
,2024-06-29,8400/000 : FNB,34.99 Google,Account Payment,34.99 GOOGLE,34.99,,1856070.84,AccountTransactionsReport(1).csv,946,2024-06,False,Other Computer Services,Analytics & Monitoring,Analytics & Monitoring
,2024-06-29,8400/000 : FNB,22.99 Adobe,Account Payment,22.99 Adobe,430.45,,1856501.29,AccountTransactionsReport(1).csv,947,2024-06,False,Productivity Software,Productivity Software,Productivity Software
,2024-07-01,8400/000 : FNB,141.99 CANVA,Account Payment,141.99 CANVA,141.99,,1856643.28,AccountTransactionsReport(1).csv,948,2024-07,False,Other Computer Services,Design Tools,Design Tools
,2024-07-01,8400/000 : FNB,546.25 INTUIT,Account Payment,546.25 INTUIT,546.25,,1857189.53,AccountTransactionsReport(1).csv,949,2024-07,False,Productivity Software,Productivity Software,Productivity Software
,2024-07-01,8400/000 : FNB,546.25 INTUIT,Account Payment,546.25 INTUIT,546.25,,1857735.78,AccountTransactionsReport(1).csv,950,2024-07,True,Productivity Software,Productivity Software,Productivity Software
,2024-07-01,8400/000 : FNB,2846.17 Shopify,Account Payment,2846.17 Shopify,53758.0,,1911493.78,AccountTransactionsReport(1).csv,951,2024-07,False,E-commerce Platforms,E-commerce Platforms,E-commerce Platforms
,2024-07-02,8400/000 : FNB,119.94 CLINICSOFTWARE,Account Payment,119.94 CLINICSOFTWARE,2867.03,,1914360.81,AccountTransactionsReport(1).csv,952,2024-07,False,Other Computer Services,Other Computer Services,Other Computer Services
,2024-07-02,8400/000 : FNB,5050.80 FRESHWORKS,Account Payment,5050.80 FRESHWORKS,5050.8,,1919411.61,AccountTransactionsReport(1).csv,953,2024-07,False,Productivity Software,Productivity Software,Productivity Software
,2024-07-02,8400/000 : FNB,13.80 SHOPIFY,Account Payment,13.80 HOPIFY,260.96,,1919672.57,AccountTransactionsReport(1).csv,954,2024-07,False,E-commerce Platforms,E-commerce Platforms,E-commerce Platforms
,2024-07-02,8400/000 : FNB,18.40 SHOPIFY,Account Payment,18.40 SHOPIFY,347.94,,1920020.51,AccountTransactionsReport(1).csv,955,2024-07,False,E-commerce Platforms,E-commerce Platforms,E-commerce Platforms
,2024-07-02,8400/000 : FNB,47.84 DIGITAL OCEAN,Account Payment,47.84 DIGITAL OCEAN,904.64,,1920925.15,AccountTransactionsReport(1).csv,956,2024-07,False,Other Computer Services,Other Computer Services,Other Computer Services
,2024-07-02,8400/000 : FNB,102.8 CASSIDY AI,Account Payment,102.8 CASSIDY AI,1943.92,,1922869.07,AccountTransactionsReport(1).csv,957,2024-07,False,Other Computer Services,Other Computer Services,Other Computer Services
,2024-07-03,8400/000 : FNB,134.00 SQSP,Account Payment,134.00 SQSP,134.0,,1923003.07,AccountTransactionsReport(1).csv,958,2024-07,False,Other Computer Services,Other Computer Services,Other Computer Services
,2024-07-03,8400/000 : FNB,9.20 FACEBOOK,Account Payment,9.20 FACEBOOK,173.97,,1923177.04,AccountTransactionsReport(1).csv,959,2024-07,False,Marketing Tools,Marketing Tools,Marketing Tools
,2024-07-03,8400/000 : FNB,12.00 GOOGLE GSUITE,Account Payment,12.00 GOOGLE GSUITE,286.84,,1923463.88,AccountTransactionsReport(1).csv,960,2024-07,False,Other Computer Services,Analytics & Monitoring,Analytics & Monitoring
,2024-07-03,8400/000 : FNB,7.00 Glassfrog,Account Payment,7.00 Glassfrog,132.37,,1923596.25,AccountTransactionsReport(1).csv,961,2024-07,False,Other Computer Services,Other Computer Services,Other Computer Services
,2024-07-03,8400/000 : FNB,546.25 INTUIT,Account Payment,546.25 INTUIT,546.25,,1924142.5,AccountTransactionsReport(1).csv,962,2024-07,False,Productivity Software,Productivity Software,Productivity Software
,2024-07-03,8400/000 : FNB,"29.00 ECM, A LEGALZ",Account Payment,"29.00 ECM, A LEGALZ",548.38,,1924690.88,AccountTransactionsReport(1).csv,963,2024-07,False,Other Computer Services,Other Computer Services,Other Computer Services
,2024-07-03,8400/000 : FNB,39.82 Google GSUITE,Account Payment,39.82 Google GSUITE,804.84,,1925495.72,AccountTransactionsReport(1).csv,964,2024-07,False,Other Computer Services,Analytics & Monitoring,Analytics & Monitoring
,2024-07-03,8400/000 : FNB,46.00 FACEBK,Account Payment,46.00 FACEBK,869.85,,1926365.57,AccountTransactionsReport(1).csv,965,2024-07,False,Other Computer Services,Other Computer Services,Other Computer Services
,2024-07-03,8400/000 : FNB,83.96 Google GSUITE,Account Payment,83.96 Google GSUITE,1696.99,,1928062.56,AccountTransactionsReport(1).csv,966,2024-07,False,Other Computer Services,Analytics & Monitoring,Analytics & Monitoring
,2024-07-03,8400/000 : FNB,134.00 SINC MAILGU,Account Payment,134.00 SINC MAILGU,2515.18,,1930577.74,AccountTransactionsReport(1).csv,967,2024-07,False,Other Computer Services,Other Computer Services,Other Computer Services
,2024-07-03,8400/000 : FNB,182.85 WIX.COM,Account Payment,182.85 WIX.COM,3432.1,,1934009.84,AccountTransactionsReport(1).csv,968,2024-07,False,E-commerce Platforms,E-commerce Platforms,E-commerce Platforms
,2024-07-03,8400/000 : FNB,298.08 GSUITE_ZONE,Account Payment,298.08 GSUITE_ZONE,5636.59,,1939646.43,AccountTransactionsReport(1).csv,969,2024-07,False,Other Computer Services,Other Computer Services,Other Computer Services
,2024-07-03,8400/000 : FNB,391.60 Google GSuit,Account Payment,391.60 Google GSuit,7915.02,,1947561.45,AccountTransactionsReport(1).csv,970,2024-07,False,Other Computer Services,Analytics & Monitoring,Analytics & Monitoring
,2024-07-03,8400/000 : FNB,17.25 SLACK,Account Payment,17.25 SLACK,326.2,,1947887.65,AccountTransactionsReport(1).csv,971,2024-07,False,Communication,Communication,Communication
,2024-07-03,8400/000 : FNB,DROPBOX,Account Payment,DROPBOX,347.55,,1948235.2,AccountTransactionsReport(1).csv,972,2024-07,False,Other Computer Services,Other Computer Services,Other Computer Services
,2024-07-03,8400/000 : FNB,20.00 YOU.COM,Account Payment,20.00 YOU.COM,375.4,,1948610.6,AccountTransactionsReport(1).csv,973,2024-07,False,Other Computer Services,Other Computer Services,Other Computer Services
,2024-07-03,8400/000 : FNB,27.60 FACEBK,Account Payment,27.60 FACEBK,521.9,,1949132.5,AccountTransactionsReport(1).csv,974,2024-07,False,Other Computer Services,Other Computer Services,Other Computer Services
,2024-07-03,8400/000 : FNB,SWIFT,Account Payment,SWIFT,550.0,,1949682.5,AccountTransactionsReport(1).csv,975,2024-07,False,Other Computer Services,Other Computer Services,Other Computer Services
,2024-07-03,8400/000 : FNB,1103.24 GOOGLE CLOU,Account Payment,1103.24 GOOGLE CLOU,20861.89,,1970544.39,AccountTransactionsReport(1).csv,976,2024-07,False,Other Computer Services,Analytics & Monitoring,Analytics & Monitoring
,2024-07-04,8400/000 : FNB,BEENVERIFIED,Account Payment,BEENVERIFIED,571.37,,1971115.76,AccountTransactionsReport(1).csv,977,2024-07,False,Other Computer Services,Other Computer Services,Other Computer Services
,2024-07-04,8400/000 : FNB,WAPPALYZER,Account Payment,WAPPALYSER,8446.51,,1979562.27,AccountTransactionsReport(1).csv,978,2024-07,False,Other Computer Services,Other Computer Services,Other Computer Services
,2024-07-04,8400/000 : FNB,392.45 MICROSOFT,Account Receipt,392.45 MICROSOFT,,7033.36,1972528.91,AccountTransactionsReport(1).csv,979,2024-07,False,Productivity Software,Productivity Software,Productivity Software
,2024-07-05,8400/000 : FNB,4.95 Shells.com,Account Payment,4.95 Shells.com,94.14,,1972623.05,AccountTransactionsReport(1).csv,980,2024-07,False,Other Computer Services,Other Computer Services,Other Computer Services
,2024-07-05,8400/000 : FNB,148.44 Enhancer swa,Account Payment,148.44 Enhancer swa,148.44,,1972771.49,AccountTransactionsReport(1).csv,981,2024-07,False,Other Computer Services,Other Computer Services,Other Computer Services
,2024-07-05,8400/000 : FNB,50.10 Frappe Cloud,Account Payment,50.10 Frappe Cloud,952.74,,1973724.23,AccountTransactionsReport(1).csv,982,2024-07,False,Other Computer Services,Other Computer Services,Other Computer Services
,2024-07-05,8400/000 : FNB,60.00 Imsomnia Team,Account Payment,60.00 Insomnia Team,1141.0,,1974865.23,AccountTransactionsReport(1).csv,983,2024-07,False,Other Computer Services,Other Computer Services,Other Computer Services
,2024-07-05,8400/000 : FNB,99.00 DMNS.APP BUSI,Account Payment,99.00 DMNS.APP BUSI,1882.65,,1976747.88,AccountTransactionsReport(1).csv,984,2024-07,False,Other Computer Services,Other Computer Services,Other Computer Services
,2024-07-05,8400/000 : FNB,143.20 MOZSEO:HELP@,Account Payment,143.20 MOZSEO:HELP@,2728.29,,1979476.17,AccountTransactionsReport(1).csv,985,2024-07,False,Other Computer Services,Other Computer Services,Other Computer Services
,2024-07-05,8400/000 : FNB,299.00 TIME IS LTD,Account Payment,299.00 TIME IS LTD,5696.62,,1985172.79,AccountTransactionsReport(1).csv,986,2024-07,False,Other Computer Services,Other Computer Services,Other Computer Services
,2024-07-06,8400/000 : FNB,2058.98 SHOPIFY,Account Payment,2058.98 SHOPIFY,39155.13,,2024327.92,AccountTransactionsReport(1).csv,987,2024-07,False,E-commerce Platforms,E-commerce Platforms,E-commerce Platforms
,2024-07-06,8400/000 : FNB,1499.00 APPDIRECTG,Account Payment,1499.00 APPDIRECT,28506.12,,2052834.04,AccountTransactionsReport(1).csv,988,2024-07,False,Other Computer Services,Other Computer Services,Other Computer Services
,2024-07-06,8400/000 : FNB,TRIPLE WHALE,Account Payment,599.00 TRIPLE WHALE,11391.03,,2064225.07,AccountTransactionsReport(1).csv,989,2024-07,False,Other Computer Services,Other Computer Services,Other Computer Services
,2024-07-06,8400/000 : FNB,5.00 COMPONENTS.STU,Account Payment,5.00 COMPONENTS.STU,95.08,,2064320.15,AccountTransactionsReport(1).csv,990,2024-07,False,Other Computer Services,Other Computer Services,Other Computer Services
,2024-07-06,8400/000 : FNB,Github,Account Payment,11.64GitHub,221.35,,2064541.5,AccountTransactionsReport(1).csv,991,2024-07,False,Development Tools,Development Tools,Development Tools
,2024-07-06,8400/000 : FNB,19.00 Github,Account Payment,19.00 Github,361.31,,2064902.81,AccountTransactionsReport(1).csv,992,2024-07,False,Development Tools,Development Tools,Development Tools
,2024-07-06,8400/000 : FNB,DNH DOMANI/HO,Account Payment,DNH DOMANI/HO,805.47,,2065708.28,AccountTransactionsReport(1).csv,993,2024-07,False,Other Computer Services,Other Computer Services,Other Computer Services
,2024-07-06,8400/000 : FNB,1410.60 FACEBK,Account Payment,1410.60 FACEBK,1410.6,,2067118.88,AccountTransactionsReport(1).csv,994,2024-07,False,Other Computer Services,Other Computer Services,Other Computer Services
,2024-07-06,8400/000 : FNB,120.75 MANAGEWP,Account Payment,120.75 MANAGEWP,2277.16,,2069396.04,AccountTransactionsReport(1).csv,995,2024-07,False,Other Computer Services,Other Computer Services,Other Computer Services
,2024-07-06,8400/000 : FNB,120.75 MANAGEWP,Account Payment,120.75 MANAGEWP,2277.16,,2071673.2,AccountTransactionsReport(1).csv,996,2024-07,True,Other Computer Services,Other Computer Services,Other Computer Services
,2024-07-06,8400/000 : FNB,249.00 STABLE,Account Payment,249.00 STABLE,4735.18,,2076408.38,AccountTransactionsReport(1).csv,997,2024-07,False,Other Computer Services,Other Computer Services,Other Computer Services
,2024-07-08,8400/000 : FNB,126.50 MICROSOFT,Account Payment,126.50 MICROSOFT,2385.6,,2078793.98,AccountTransactionsReport(1).csv,998,2024-07,False,Productivity Software,Productivity Software,Productivity Software
,2024-07-08,8400/000 : FNB,15.00 HIGHTAIL,Account Payment,15.00 HIGHTAIL,280.49,,2079074.47,AccountTransactionsReport(1).csv,999,2024-07,False,Other Computer Services,Other Computer Services,Other Computer Services
,2024-07-08,8400/000 : FNB,77.05 CBA PLESK,Account Payment,77.05 CBA PLESK,1453.04,,2080527.51,AccountTransactionsReport(1).csv,1000,2024-07,False,Domain & Hosting,Domain & Hosting,Domain & Hosting
,2024-07-08,8400/000 : FNB,187.94 PADDLE.NET,Account Payment,"187.94 PADDLE,NET",187.94,,2080715.45,AccountTransactionsReport(1).csv,1001,2024-07,False,Other Computer Services,Subscription Management,Subscription Management
,2024-07-09,8400/000 : FNB,99.00 MIOSALON,Account Payment,99.00 MIOSALON,1851.22,,2082566.67,AccountTransactionsReport(1).csv,1002,2024-07,False,Other Computer Services,Other Computer Services,Other Computer Services
,2024-07-09,8400/000 : FNB,99.00 MIOSALON,Account Payment,99.00 MIOSALON,1851.22,,2084417.89,AccountTransactionsReport(1).csv,1003,2024-07,True,Other Computer Services,Other Computer Services,Other Computer Services
,2024-07-09,8400/000 : FNB,171.35 PADDLE.NET,Account Payment,171.35 PADDLE.NET,3204.1,,2087621.99,AccountTransactionsReport(1).csv,1004,2024-07,False,Other Computer Services,Subscription Management,Subscription Management
,2024-07-09,8400/000 : FNB,12.00 CODESANDBOX,Account Payment,12.00 CODESANDBOX,224.39,,2087846.38,AccountTransactionsReport(1).csv,1005,2024-07,False,Other Computer Services,Other Computer Services,Other Computer Services
,2024-07-09,8400/000 : FNB,19.99 WOOCOMMERCE,Account Payment,19.99 WOOCOMMERCE,373.8,,2088220.18,AccountTransactionsReport(1).csv,1006,2024-07,False,Other Computer Services,Other Computer Services,Other Computer Services
,2024-07-09,8400/000 : FNB,20.00 VERCEL,Account Payment,20.00 VERCEL INC,373.98,,2088594.16,AccountTransactionsReport(1).csv,1007,2024-07,False,Cloud Services,Cloud Services,Cloud Services
,2024-07-09,8400/000 : FNB,20.00 VERCEL IMC,Account Payment,20.00 VERCEL INC,373.98,,2088968.14,AccountTransactionsReport(1).csv,1008,2024-07,True,Cloud Services,Cloud Services,Cloud Services
,2024-07-09,8400/000 : FNB,546.25 INTUIT,Account Payment,546.25 INTUIT,546.25,,2089514.39,AccountTransactionsReport(1).csv,1009,2024-07,False,Productivity Software,Productivity Software,Productivity Software
,2024-07-09,8400/000 : FNB,7.00NPM,Account Payment,7.00 NPM,130.9,,2089645.29,AccountTransactionsReport(1).csv,1010,2024-07,False,Other Computer Services,Other Computer Services,Other Computer Services
,2024-07-09,8400/000 : FNB,7.00NPM,Account Payment,7.00NPM,130.9,,2089776.19,AccountTransactionsReport(1).csv,1011,2024-07,False,Other Computer Services,Other Computer Services,Other Computer Services
,2024-07-09,8400/000 : FNB,7.00NPM,Account Payment,7.00NPM,130.9,,2089907.09,AccountTransactionsReport(1).csv,1012,2024-07,True,Other Computer Services,Other Computer Services,Other Computer Services
,2024-07-09,8400/000 : FNB,3.60 GETADDRESS,Account Payment,3.60 GETADDRESS,86.09,,2089993.18,AccountTransactionsReport(1).csv,1013,2024-07,False,Other Computer Services,Other Computer Services,Other Computer Services
,2024-07-09,8400/000 : FNB,9.00 TWENTY.COM,Account Payment,9.00 TWENTY.COM,168.29,,2090161.47,AccountTransactionsReport(1).csv,1014,2024-07,False,Other Computer Services,Other Computer Services,Other Computer Services
,2024-07-09,8400/000 : FNB,9.00 GITPOD,Account Payment,9.00 GITPOD,168.29,,2090329.76,AccountTransactionsReport(1).csv,1015,2024-07,False,Development Tools,Development Tools,Development Tools
,2024-07-09,8400/000 : FNB,7.00NPM,Account Payment,7.00NPM,130.9,,2090460.66,AccountTransactionsReport(1).csv,1016,2024-07,True,Other Computer Services,Other Computer Services,Other Computer Services
,2024-07-10,8400/000 : FNB,20.00 HEROKO,Account Payment,20.00 HEROKU,373.98,,2090834.64,AccountTransactionsReport(1).csv,1017,2024-07,False,Cloud Services,Cloud Services,Cloud Services
,2024-07-10,8400/000 : FNB,25.00 NOTION LABS,Account Payment,25.00 NOTION LABS,467.48,,2091302.12,AccountTransactionsReport(1).csv,1018,2024-07,False,Other Computer Services,Collaboration Tools,Collaboration Tools
,2024-07-10,8400/000 : FNB,28.75 CLOUDFLARE,Account Payment,28.75 CLOUDFLARE,537.6,,2091839.72,AccountTransactionsReport(1).csv,1019,2024-07,False,Cloud Services,Cloud Services,Cloud Services
,2024-07-10,8400/000 : FNB,150.00 AUTH0.COM,Account Payment,150.00 AUTH0.COM,2804.87,,2094644.59,AccountTransactionsReport(1).csv,1020,2024-07,False,Security Services,Security Services,Security Services
,2024-07-11,8400/000 : FNB,41.40 SHOPIFY,Account Payment,41.40 SHOPIFY,770.53,,2095415.12,AccountTransactionsReport(1).csv,1021,2024-07,False,E-commerce Platforms,E-commerce Platforms,E-commerce Platforms
,2024-07-11,8400/000 : FNB,49.00 SKRAPP,Account Payment,49.00 SKRAPP,911.98,,2096327.1,AccountTransactionsReport(1).csv,1022,2024-07,False,Other Computer Services,Other Computer Services,Other Computer Services
,2024-07-11,8400/000 : FNB,21.56 SLACK,Account Payment,21.56 SLACK,401.03,,2096728.13,AccountTransactionsReport(1).csv,1023,2024-07,False,Communication,Communication,Communication
,2024-07-11,8400/000 : FNB,25.00 BEECEPTOR,Account Payment,25.00 BEECEPTOR,465.29,,2097193.42,AccountTransactionsReport(1).csv,1024,2024-07,False,Other Computer Services,Other Computer Services,Other Computer Services
,2024-07-11,8400/000 : FNB,25.00 BEECEPTOR,Account Payment,25.00 BEECEPTOR,465.29,,2097658.71,AccountTransactionsReport(1).csv,1025,2024-07,True,Other Computer Services,Other Computer Services,Other Computer Services
,2024-07-11,8400/000 : FNB,41.40 SHOPIFY,Account Payment,41.40 SHOPIFY,770.53,,2098429.24,AccountTransactionsReport(1).csv,1026,2024-07,True,E-commerce Platforms,E-commerce Platforms,E-commerce Platforms
,2024-07-11,8400/000 : FNB,13.80 SHOPIFY,Account Payment,13.80 SHOPIFY,256.85,,2098686.09,AccountTransactionsReport(1).csv,1027,2024-07,False,E-commerce Platforms,E-commerce Platforms,E-commerce Platforms
,2024-07-11,8400/000 : FNB,13.80 SHOPIFY,Account Payment,13.80 SHOPIFY,256.85,,2098942.94,AccountTransactionsReport(1).csv,1028,2024-07,True,E-commerce Platforms,E-commerce Platforms,E-commerce Platforms
,2024-07-11,8400/000 : FNB,13.80 SHOPIFY,Account Payment,13.80 SHOPIFY,256.85,,2099199.79,AccountTransactionsReport(1).csv,1029,2024-07,True,E-commerce Platforms,E-commerce Platforms,E-commerce Platforms
,2024-07-11,8400/000 : FNB,60.00 OPENAI CHATG,Account Payment,60.00 OPENAI CHATG,1116.72,,2100316.51,AccountTransactionsReport(1).csv,1030,2024-07,False,AI Services,AI Services,AI Services
,2024-07-11,8400/000 : FNB,70.00 NOTION LABS,Account Payment,70.00 NOTION LABS,1302.07,,2101618.58,AccountTransactionsReport(1).csv,1031,2024-07,False,Other Computer Services,Collaboration Tools,Collaboration Tools
,2024-07-11,8400/000 : FNB,499.00 CASSIDYAI,Account Payment,499.00 CASSIDYAI,9287.34,,2110905.92,AccountTransactionsReport(1).csv,1032,2024-07,False,Other Computer Services,Other Computer Services,Other Computer Services
,2024-07-11,8400/000 : FNB,1499 APPDIRECT,Account Payment,1499 APPDIRECT,27899.26,,2138805.18,AccountTransactionsReport(1).csv,1033,2024-07,False,Other Computer Services,Other Computer Services,Other Computer Services
,2024-07-12,8400/000 : FNB,99.00 DYNAMIC,Account Payment,99.00 DYNAMIC,1837.33,,2140642.51,AccountTransactionsReport(1).csv,1034,2024-07,False,Other Computer Services,Other Computer Services,Other Computer Services
,2024-07-12,8400/000 : FNB,43.70 SHOPIFY,Account Payment,43.70 SHOPIFY,812.87,,2141455.38,AccountTransactionsReport(1).csv,1035,2024-07,False,E-commerce Platforms,E-commerce Platforms,E-commerce Platforms
,2024-07-12,8400/000 : FNB,3058 SHOPIFY,Account Payment,3058.95 SHOPIFY,56899.59,,2198354.97,AccountTransactionsReport(1).csv,1036,2024-07,False,E-commerce Platforms,E-commerce Platforms,E-commerce Platforms
,2024-07-12,8400/000 : FNB,13.80 SHOPIFY,Account Payment,13.80 SHOPIFY,256.69,,2198611.66,AccountTransactionsReport(1).csv,1037,2024-07,False,E-commerce Platforms,E-commerce Platforms,E-commerce Platforms
,2024-07-12,8400/000 : FNB,71.30 SHOPIFY,Account Payment,71.30 SHOPIFY,1326.26,,2199937.92,AccountTransactionsReport(1).csv,1038,2024-07,False,E-commerce Platforms,E-commerce Platforms,E-commerce Platforms
,2024-07-12,8400/000 : FNB,90.85 SHOPIFY,Account Payment,90.85 SHOPIFY,1689.91,,2201627.83,AccountTransactionsReport(1).csv,1039,2024-07,False,E-commerce Platforms,E-commerce Platforms,E-commerce Platforms
,2024-07-12,8400/000 : FNB,13.80S SHOPIFY,Account Payment,13.80 SHOPIFY,256.69,,2201884.52,AccountTransactionsReport(1).csv,1040,2024-07,True,E-commerce Platforms,E-commerce Platforms,E-commerce Platforms
,2024-07-12,8400/000 : FNB,13.80 SHOPIFY,Account Payment,13.80 SHOPIFY,256.69,,2202141.21,AccountTransactionsReport(1).csv,1041,2024-07,True,E-commerce Platforms,E-commerce Platforms,E-commerce Platforms
,2024-07-12,8400/000 : FNB,13.80 SHOPIFY,Account Payment,13.80 SHOPIFY,256.69,,2202397.9,AccountTransactionsReport(1).csv,1042,2024-07,True,E-commerce Platforms,E-commerce Platforms,E-commerce Platforms
,2024-07-12,8400/000 : FNB,32.00 BUBBLE STARTE,Account Payment,32.00 BUBBLE STARTE,593.88,,2202991.78,AccountTransactionsReport(1).csv,1043,2024-07,False,Other Computer Services,Other Computer Services,Other Computer Services
,2024-07-12,8400/000 : FNB,41.40 SHOPIFY,Account Payment,41.40 SHOPIFY,770.08,,2203761.86,AccountTransactionsReport(1).csv,1044,2024-07,False,E-commerce Platforms,E-commerce Platforms,E-commerce Platforms
,2024-07-13,8400/000 : FNB,1.00 NOMIC ATLAS,Account Payment,1.00 NOMIC ATLAS,18.52,,2203780.38,AccountTransactionsReport(1).csv,1045,2024-07,False,Other Computer Services,Other Computer Services,Other Computer Services
,2024-07-13,8400/000 : FNB,20.00 HUGGINGFACE,Account Payment,20.00 HUGGINGFACE,371.18,,2204151.56,AccountTransactionsReport(1).csv,1046,2024-07,False,AI Services,AI Services,AI Services
,2024-07-13,8400/000 : FNB,189.00 GITHUB,Account Payment,189.00 GITHUB,3507.63,,2207659.19,AccountTransactionsReport(1).csv,1047,2024-07,False,Development Tools,Development Tools,Development Tools
,2024-07-13,8400/000 : FNB,21.00 GITHUB,Account Payment,21.00 GITHUB,389.73,,2208048.92,AccountTransactionsReport(1).csv,1048,2024-07,False,Development Tools,Development Tools,Development Tools
,2024-07-13,8400/000 : FNB,546.25 INTUIT,Account Payment,546.25 INTUIT,546.25,,2208595.17,AccountTransactionsReport(1).csv,1049,2024-07,False,Productivity Software,Productivity Software,Productivity Software
,2024-07-13,8400/000 : FNB,546.25 INTUIT,Account Payment,546.25 INTUIT,546.25,,2209141.42,AccountTransactionsReport(1).csv,1050,2024-07,True,Productivity Software,Productivity Software,Productivity Software
,2024-07-13,8400/000 : FNB,61.00 GITHUB,Account Payment,61.00 GITHUB,1132.09,,2210273.51,AccountTransactionsReport(1).csv,1051,2024-07,False,Development Tools,Development Tools,Development Tools
,2024-07-13,8400/000 : FNB,63.00 GITHUB,Account Payment,63.00 GITHUB,1169.21,,2211442.72,AccountTransactionsReport(1).csv,1052,2024-07,False,Development Tools,Development Tools,Development Tools
,2024-07-15,8400/000 : FNB,1150.00 FACEBK,Account Payment,1150.00 FACEBK,1150.0,,2212592.72,AccountTransactionsReport(1).csv,1053,2024-07,False,Other Computer Services,Other Computer Services,Other Computer Services
,2024-07-15,8400/000 : FNB,15.00 TABNINE,Account Payment,15.00 TABNINE,277.89,,2212870.61,AccountTransactionsReport(1).csv,1054,2024-07,False,Other Computer Services,Other Computer Services,Other Computer Services
,2024-07-15,8400/000 : FNB,19.19 OPENAI CHATG,Account Payment,19.19 OPENAI CHATG,355.51,,2213226.12,AccountTransactionsReport(1).csv,1055,2024-07,False,AI Services,AI Services,AI Services
,2024-07-16,8400/000 : FNB,120.00 OPENAI CHAT,Account Payment,120.00 OPENAI CHAT,2209.63,,2215435.75,AccountTransactionsReport(1).csv,1056,2024-07,False,AI Services,AI Services,AI Services
,2024-07-16,8400/000 : FNB,175.00 NOTION LABS,Account Payment,175.00 NOTION LABS,3222.37,,2218658.12,AccountTransactionsReport(1).csv,1057,2024-07,False,Other Computer Services,Collaboration Tools,Collaboration Tools
,2024-07-16,8400/000 : FNB,180.00 AGENCY ANALYT,Account Payment,180.00 AGENCY ANALYT,3314.44,,2221972.56,AccountTransactionsReport(1).csv,1058,2024-07,False,Other Computer Services,Other Computer Services,Other Computer Services
,2024-07-16,8400/000 : FNB,280.00 WIZA.CO,Account Payment,280.00 WIZA.CO,5155.79,,2227128.35,AccountTransactionsReport(1).csv,1059,2024-07,False,Other Computer Services,Other Computer Services,Other Computer Services
,2024-07-16,8400/000 : FNB,14.00 GITHUB,Account Payment,14.00 GITHUB,257.78,,2227386.13,AccountTransactionsReport(1).csv,1060,2024-07,False,Development Tools,Development Tools,Development Tools
,2024-07-16,8400/000 : FNB,20.00 RAILWAY,Account Payment,20.00 RAILWAY,368.27,,2227754.4,AccountTransactionsReport(1).csv,1061,2024-07,False,Other Computer Services,Other Computer Services,Other Computer Services
,2024-07-16,8400/000 : FNB,20.00 RAILWAY,Account Payment,20.00 RAILWAY,368.27,,2228122.67,AccountTransactionsReport(1).csv,1062,2024-07,True,Other Computer Services,Other Computer Services,Other Computer Services
,2024-07-16,8400/000 : FNB,546.25 INTUIT,Account Payment,546.25 INTUIT,546.25,,2228668.92,AccountTransactionsReport(1).csv,1063,2024-07,False,Productivity Software,Productivity Software,Productivity Software
,2024-07-16,8400/000 : FNB,735.00 SQSP,Account Payment,735.00 SQSP,735.0,,2229403.92,AccountTransactionsReport(1).csv,1064,2024-07,False,Other Computer Services,Other Computer Services,Other Computer Services
,2024-07-16,8400/000 : FNB,915.00 SQSP,Account Payment,915.00 SQSP,915.0,,2230318.92,AccountTransactionsReport(1).csv,1065,2024-07,False,Other Computer Services,Other Computer Services,Other Computer Services
,2024-07-16,8400/000 : FNB,74.75 SHOPIFY,Account Payment,74.75 SHOPIFY,1376.41,,2231695.33,AccountTransactionsReport(1).csv,1066,2024-07,False,E-commerce Platforms,E-commerce Platforms,E-commerce Platforms
,2024-07-16,8400/000 : FNB,99.00 PLAYFAB,Account Payment,99.00 PLAYFAB,1822.94,,2233518.27,AccountTransactionsReport(1).csv,1067,2024-07,False,Other Computer Services,Other Computer Services,Other Computer Services
,2024-07-17,8400/000 : FNB,"40.00REPLIT, INC",Account Payment,"40.00REPLIT, INC",736.54,,2234254.81,AccountTransactionsReport(1).csv,1068,2024-07,False,Other Computer Services,Other Computer Services,Other Computer Services
,2024-07-17,8400/000 : FNB,191.48 SLACK,Account Payment,191.48 SLACK,3525.82,,2237780.63,AccountTransactionsReport(1).csv,1069,2024-07,False,Communication,Communication,Communication
,2024-07-18,8400/000 : FNB,MSFT,Account Payment,MSFT,408.94,,2238189.57,AccountTransactionsReport(1).csv,1070,2024-07,False,Other Computer Services,Other Computer Services,Other Computer Services
,2024-07-18,8400/000 : FNB,SQSP,Account Payment,SQSP,1150.0,,2239339.57,AccountTransactionsReport(1).csv,1071,2024-07,False,Other Computer Services,Other Computer Services,Other Computer Services
,2024-07-18,8400/000 : FNB,Triple Whale,Account Payment,tRIPLE WHALE,5203.51,,2244543.08,AccountTransactionsReport(1).csv,1072,2024-07,False,Other Computer Services,Other Computer Services,Other Computer Services
,2024-07-18,8400/000 : FNB,MSFT,Account Payment,MSFT,5439.5,,2249982.58,AccountTransactionsReport(1).csv,1073,2024-07,False,Other Computer Services,Other Computer Services,Other Computer Services
,2024-07-18,8400/000 : FNB,MSFT,Account Payment,MSFT,26415.96,,2276398.54,AccountTransactionsReport(1).csv,1074,2024-07,False,Other Computer Services,Other Computer Services,Other Computer Services
,2024-07-19,8400/000 : FNB,EMMA AI,Account Payment,EMMA AI,167.8,,2276566.34,AccountTransactionsReport(1).csv,1075,2024-07,False,Other Computer Services,Other Computer Services,Other Computer Services
,2024-07-20,8400/000 : FNB,NAMEBIO,Account Payment,NAMEBIO,1866.28,,2278432.62,AccountTransactionsReport(1).csv,1076,2024-07,False,Other Computer Services,Other Computer Services,Other Computer Services
,2024-07-22,8400/000 : FNB,264.50 INTUIT,Account Payment,264.50 INTUIT,264.5,,2278697.12,AccountTransactionsReport(1).csv,1077,2024-07,False,Productivity Software,Productivity Software,Productivity Software
,2024-07-22,8400/000 : FNB,59.00 GREENBACK.COM,Account Payment,59.00 GREENBACK.COM,1101.11,,2279798.23,AccountTransactionsReport(1).csv,1078,2024-07,False,Other Computer Services,Other Computer Services,Other Computer Services
,2024-07-22,8400/000 : FNB,550.00 SQSP,Account Payment,550.00 SQSP,550.0,,2280348.23,AccountTransactionsReport(1).csv,1079,2024-07,False,Other Computer Services,Other Computer Services,Other Computer Services
,2024-07-22,8400/000 : FNB,660.00 SQSP,Account Payment,660.00 SQSP,660.0,,2281008.23,AccountTransactionsReport(1).csv,1080,2024-07,False,Other Computer Services,Other Computer Services,Other Computer Services
,2024-07-22,8400/000 : FNB,17.25 SLACK T4ENT13,Account Payment,17.25 SLACK T4ENT13,321.93,,2281330.16,AccountTransactionsReport(1).csv,1081,2024-07,False,Communication,Communication,Communication
,2024-07-22,8400/000 : FNB,1320.00 SQSP,Account Payment,1320.00 SQSP,1320.0,,2282650.16,AccountTransactionsReport(1).csv,1082,2024-07,False,Other Computer Services,Other Computer Services,Other Computer Services
,2024-07-22,8400/000 : FNB,1725.00 FACEBOOK,Account Payment,1725.00FACEBOOK,1725.0,,2284375.16,AccountTransactionsReport(1).csv,1083,2024-07,False,Marketing Tools,Marketing Tools,Marketing Tools
,2024-07-22,8400/000 : FNB,1835.00,Account Payment,1835.00 SQSP,1835.0,,2286210.16,AccountTransactionsReport(1).csv,1084,2024-07,False,Other Computer Services,Other Computer Services,Other Computer Services
,2024-07-22,8400/000 : FNB,365.00 SQSP,Account Payment,365.00 SQSP,365.0,,2286575.16,AccountTransactionsReport(1).csv,1085,2024-07,False,Other Computer Services,Other Computer Services,Other Computer Services
,2024-07-22,8400/000 : FNB,1320.00 SQSP,Account Payment,1320.00 SQSP,1320.0,,2287895.16,AccountTransactionsReport(1).csv,1086,2024-07,True,Other Computer Services,Other Computer Services,Other Computer Services
,2024-07-22,8400/000 : FNB,1100.00 SQSP,Account Payment,1100.00 SQSP,1100.0,,2288995.16,AccountTransactionsReport(1).csv,1087,2024-07,False,Other Computer Services,Other Computer Services,Other Computer Services
,2024-07-22,8400/000 : FNB,1835.00 SQSP,Account Payment,1835.00 SQSP,1835.0,,2290830.16,AccountTransactionsReport(1).csv,1088,2024-07,True,Other Computer Services,Other Computer Services,Other Computer Services
,2024-07-22,8400/000 : FNB,3960.00 SQSP,Account Payment,3960.00 SQSP,3960.0,,2294790.16,AccountTransactionsReport(1).csv,1089,2024-07,False,Other Computer Services,Other Computer Services,Other Computer Services
,2024-07-22,8400/000 : FNB,546.25 INTUIT,Account Payment,546.25 INTUIT,546.25,,2295336.41,AccountTransactionsReport(1).csv,1090,2024-07,False,Productivity Software,Productivity Software,Productivity Software
,2024-07-22,8400/000 : FNB,546.25 INTUIT,Account Payment,546.25 INTUIT,546.25,,2295882.66,AccountTransactionsReport(1).csv,1091,2024-07,True,Productivity Software,Productivity Software,Productivity Software
,2024-07-22,8400/000 : FNB,546.25 INTUIT,Account Payment,546.25 INTUIT,546.25,,2296428.91,AccountTransactionsReport(1).csv,1092,2024-07,True,Productivity Software,Productivity Software,Productivity Software
,2024-07-23,8400/000 : FNB,100.00 APPDIRECT,Account Payment,100.00 APPDIRECT,1874.76,,2298303.67,AccountTransactionsReport(1).csv,1093,2024-07,False,Other Computer Services,Other Computer Services,Other Computer Services
,2024-07-23,8400/000 : FNB,74.00 PIPEDEAM,Account Payment,74.00 PIPEDREAM,1387.32,,2299690.99,AccountTransactionsReport(1).csv,1094,2024-07,False,Other Computer Services,Other Computer Services,Other Computer Services
,2024-07-23,8400/000 : FNB,54.00 AIRTABLE.COM,Account Payment,54.00 AIRTABLE.COM,1012.37,,2300703.36,AccountTransactionsReport(1).csv,1095,2024-07,False,Other Computer Services,Collaboration Tools,Collaboration Tools
,2024-07-23,8400/000 : FNB,"20.00 REPLIT, INC",Account Payment,"20.00 REPLIT, INC",374.95,,2301078.31,AccountTransactionsReport(1).csv,1096,2024-07,False,Other Computer Services,Other Computer Services,Other Computer Services
,2024-07-23,8400/000 : FNB,134.00 SQSP,Account Payment,134.00 SQSP,134.0,,2301212.31,AccountTransactionsReport(1).csv,1097,2024-07,False,Other Computer Services,Other Computer Services,Other Computer Services
,2024-07-24,8400/000 : FNB,299.00 TIME IS LTD,Account Payment,299.00 TIME IS LTD,5591.44,,2306803.75,AccountTransactionsReport(1).csv,1098,2024-07,False,Other Computer Services,Other Computer Services,Other Computer Services
,2024-07-24,8400/000 : FNB,35.95 SHELLS.COM,Account Payment,35.95 SHELLS.COM,673.98,,2307477.73,AccountTransactionsReport(1).csv,1099,2024-07,False,Other Computer Services,Other Computer Services,Other Computer Services
,2024-07-24,8400/000 : FNB,60.00 OPENAI,Account Payment,60.00 OPENAI,1124.86,,2308602.59,AccountTransactionsReport(1).csv,1100,2024-07,False,AI Services,AI Services,AI Services
,2024-07-24,8400/000 : FNB,99.00 WWW.WOLFRAMAL,Account Payment,99.00 WWW.WOLFRAMAL,1851.35,,2310453.94,AccountTransactionsReport(1).csv,1101,2024-07,False,Other Computer Services,Other Computer Services,Other Computer Services
,2024-07-25,8400/000 : FNB,30.00 HASURA,Account Payment,30.00 HASURA,565.63,,2311019.57,AccountTransactionsReport(1).csv,1102,2024-07,False,Other Computer Services,Other Computer Services,Other Computer Services
,2024-07-25,8400/000 : FNB,34.50 SLACK,Account Payment,34.50 SLACK,645.17,,2311664.74,AccountTransactionsReport(1).csv,1103,2024-07,False,Communication,Communication,Communication
,2024-07-25,8400/000 : FNB,6.00 DOCKER INC,Account Payment,6.00 DOCKER INC,113.13,,2311777.87,AccountTransactionsReport(1).csv,1104,2024-07,False,Other Computer Services,Other Computer Services,Other Computer Services
,2024-07-25,8400/000 : FNB,30.00 NETTICA CORPO,Account Payment,30.00 NETTICA CORPO,565.63,,2312343.5,AccountTransactionsReport(1).csv,1105,2024-07,False,Other Computer Services,Other Computer Services,Other Computer Services
,2024-07-26,8400/000 : FNB,89.00 SENTRY,Account Payment,89.00 SENTRY,1678.04,,2314021.54,AccountTransactionsReport(1).csv,1106,2024-07,False,Other Computer Services,Analytics & Monitoring,Analytics & Monitoring
,2024-07-26,8400/000 : FNB,1960 SQSP,Account Payment,1960 SQSP,1960.0,,2315981.54,AccountTransactionsReport(1).csv,1107,2024-07,False,Other Computer Services,Other Computer Services,Other Computer Services
,2024-07-26,8400/000 : FNB,3336.00 HOLASPIRIT,Account Payment,3336.00 HOLASPIRIT,68210.19,,2384191.73,AccountTransactionsReport(1).csv,1108,2024-07,False,Other Computer Services,Other Computer Services,Other Computer Services
,2024-07-26,8400/000 : FNB,3336.00 HOLASPIRIT,Account Payment,3336.00 HOLASPIRIT,68210.19,,2452401.92,AccountTransactionsReport(1).csv,1109,2024-07,True,Other Computer Services,Other Computer Services,Other Computer Services
,2024-07-26,8400/000 : FNB,MATTERMOST,Account Payment,10.00 MATTERMOST,188.2,,2452590.12,AccountTransactionsReport(1).csv,1110,2024-07,False,Other Computer Services,Other Computer Services,Other Computer Services
,2024-07-26,8400/000 : FNB,18.38 DROPBOX,Account Payment,18.38 DROPBOX,346.55,,2452936.67,AccountTransactionsReport(1).csv,1111,2024-07,False,Other Computer Services,Other Computer Services,Other Computer Services
,2024-07-26,8400/000 : FNB,24.14 ILLUSTRATOR,Account Payment,24.14 ILLUSTRATOR,455.14,,2453391.81,AccountTransactionsReport(1).csv,1112,2024-07,False,Other Computer Services,Other Computer Services,Other Computer Services
,2024-07-26,8400/000 : FNB,550.00 SQSP,Account Payment,550.00 SQSP,550.0,,2453941.81,AccountTransactionsReport(1).csv,1113,2024-07,False,Other Computer Services,Other Computer Services,Other Computer Services
,2024-07-26,8400/000 : FNB,560.00 SQSP,Account Payment,560.00 SQSP,560.0,,2454501.81,AccountTransactionsReport(1).csv,1114,2024-07,False,Other Computer Services,Other Computer Services,Other Computer Services
,2024-07-26,8400/000 : FNB,34.12 WWW.MAKE.COM,Account Payment,34.12 WWW.MAKE.COM,643.31,,2455145.12,AccountTransactionsReport(1).csv,1115,2024-07,False,Other Computer Services,API Services,API Services
,2024-07-26,8400/000 : FNB,1320.00 SQSP,Account Payment,1320.00 SQSP,1320.0,,2456465.12,AccountTransactionsReport(1).csv,1116,2024-07,False,Other Computer Services,Other Computer Services,Other Computer Services
,2024-07-27,8400/000 : FNB,27.60 LEMSQZY,Account Payment,27.60 LEMSQZY,519.45,,2456984.57,AccountTransactionsReport(1).csv,1117,2024-07,False,AI Services,AI Services,AI Services
,2024-07-27,8400/000 : FNB,850.46 FACEBOOK,Account Payment,850.46 FACEBOOK,850.46,,2457835.03,AccountTransactionsReport(1).csv,1118,2024-07,False,Marketing Tools,Marketing Tools,Marketing Tools
,2024-07-27,8400/000 : FNB,150.00 AUTH0.COM,Account Payment,150.00 AUTH0.COM,2836.25,,2460671.28,AccountTransactionsReport(1).csv,1119,2024-07,False,Security Services,Security Services,Security Services
,2024-07-29,8400/000 : FNB,69.39 Facebook,Account Payment,69.39 Facebook,69.39,,2460740.67,AccountTransactionsReport(1).csv,1120,2024-07,False,Marketing Tools,Marketing Tools,Marketing Tools
,2024-07-30,8400/000 : FNB,4.95 SHELLS.COM,Account Payment,4.95 SHELLS.COM,93.05,,2460833.72,AccountTransactionsReport(1).csv,1121,2024-07,False,Other Computer Services,Other Computer Services,Other Computer Services
,2024-07-30,8400/000 : FNB,141.99 CANVA,Account Payment,141.99 CANVA,141.99,,2460975.71,AccountTransactionsReport(1).csv,1122,2024-07,False,Other Computer Services,Design Tools,Design Tools
,2024-07-30,8400/000 : FNB,34.99 GOOGLE,Account Payment,34.99 GOOGLE,34.99,,2461010.7,AccountTransactionsReport(1).csv,1123,2024-07,False,Other Computer Services,Analytics & Monitoring,Analytics & Monitoring
,2024-07-30,8400/000 : FNB,20.00 WWW.PERPLEXIT,Account Payment,20.00 WWW.PERPLEXIT,375.96,,2461386.66,AccountTransactionsReport(1).csv,1124,2024-07,False,Other Computer Services,Other Computer Services,Other Computer Services
,2024-07-30,8400/000 : FNB,20.00 HUGGINGFACE,Account Payment,20.00 HUGGINGFACE,375.96,,2461762.62,AccountTransactionsReport(1).csv,1125,2024-07,False,AI Services,AI Services,AI Services
,2024-07-30,8400/000 : FNB,22.99 ADOBE,Account Payment,22.99 ADOBE,432.17,,2462194.79,AccountTransactionsReport(1).csv,1126,2024-07,False,Productivity Software,Productivity Software,Productivity Software
,2024-07-30,8400/000 : FNB,531.62 2CO.COM TEAM,Account Payment,531.62 2CO.COM TEAM,531.62,,2462726.41,AccountTransactionsReport(1).csv,1127,2024-07,False,Other Computer Services,Other Computer Services,Other Computer Services
,2024-07-30,8400/000 : FNB,INTUIT,Account Payment,INTUIT,546.25,,2463272.66,AccountTransactionsReport(1).csv,1128,2024-07,False,Productivity Software,Productivity Software,Productivity Software
,2024-07-30,8400/000 : FNB,INTUIT,Account Payment,INTUIT,546.25,,2463818.91,AccountTransactionsReport(1).csv,1129,2024-07,True,Productivity Software,Productivity Software,Productivity Software
,2024-07-30,8400/000 : FNB,182.85 wix.com,Account Payment,182.85 wix.com,3437.27,,2467256.18,AccountTransactionsReport(1).csv,1130,2024-07,False,E-commerce Platforms,E-commerce Platforms,E-commerce Platforms
,2024-07-30,8400/000 : FNB,2846.17 SHOPIFY,Account Payment,2846.17 SHOPIFY,53503.08,,2520759.26,AccountTransactionsReport(1).csv,1131,2024-07,False,E-commerce Platforms,E-commerce Platforms,E-commerce Platforms
,2024-07-30,8400/000 : FNB,35.95 SHELLS.COM,Account Payment,35.95 SHELLS.COM,675.8,,2521435.06,AccountTransactionsReport(1).csv,1132,2024-07,False,Other Computer Services,Other Computer Services,Other Computer Services
,2024-07-30,8400/000 : FNB,40.00 CURSOR AI,Account Payment,40.00 CURSOR AI PO,751.93,,2522186.99,AccountTransactionsReport(1).csv,1133,2024-07,False,Other Computer Services,Other Computer Services,Other Computer Services
,2024-07-30,8400/000 : FNB,BEENVERIFIED,Account Payment,BEENVERIFIED,563.76,,2522750.75,AccountTransactionsReport(1).csv,1134,2024-07,False,Other Computer Services,Other Computer Services,Other Computer Services
,2024-07-31,8400/000 : FNB,5.00 COMPONENTS,Account Payment,5.00 COMPONENTS,93.99,,2522844.74,AccountTransactionsReport(1).csv,1135,2024-07,False,Other Computer Services,Other Computer Services,Other Computer Services
,2024-07-31,8400/000 : FNB,20.00 YOU.COM,Account Payment,20.00 YOU.COM,375.96,,2523220.7,AccountTransactionsReport(1).csv,1136,2024-07,False,Other Computer Services,Other Computer Services,Other Computer Services
,2024-07-31,8400/000 : FNB,735.00SQSP,Account Payment,735.00 SQSP,735.0,,2523955.7,AccountTransactionsReport(1).csv,1137,2024-07,False,Other Computer Services,Other Computer Services,Other Computer Services
,2024-07-31,8400/000 : FNB,33.32 DNH*DOMAIN/HO,Account Payment,33.32 DNH,806.92,,2524762.62,AccountTransactionsReport(1).csv,1138,2024-07,False,Domain & Hosting,Domain & Hosting,Domain & Hosting
,2024-07-31,8400/000 : FNB,1100.00 SQSP,Account Payment,1100.00 SQSP INV14,1100.0,,2525862.62,AccountTransactionsReport(1).csv,1139,2024-07,False,Other Computer Services,Other Computer Services,Other Computer Services
,2024-07-31,8400/000 : FNB,5050.80 FRESHWORKS,Account Payment,5050.80 FRESHWORKS,5050.8,,2530913.42,AccountTransactionsReport(1).csv,1140,2024-07,False,Productivity Software,Productivity Software,Productivity Software
,2024-08-02,8400/000 : FNB,546.25 INTUIT,Account Payment,546.25 INTUIT,546.25,,2531459.67,AccountTransactionsReport(1).csv,1141,2024-08,False,Productivity Software,Productivity Software,Productivity Software
,2024-08-02,8400/000 : FNB,47.84 DIGITAL OCEAN,Account Payment,47.84 DIGITAL OCEAN,895.82,,2532355.49,AccountTransactionsReport(1).csv,1142,2024-08,False,Other Computer Services,Other Computer Services,Other Computer Services
,2024-08-02,8400/000 : FNB,49.91 FRAPPE CLOUD,Account Payment,49.91 FRAPPE CLOUD,941.91,,2533297.4,AccountTransactionsReport(1).csv,1143,2024-08,False,Other Computer Services,Other Computer Services,Other Computer Services
,2024-08-03,8400/000 : FNB,134.00 Sinc MAILGU,Account Payment,134.00 Sinch Mailgu,2509.18,,2535806.58,AccountTransactionsReport(1).csv,1144,2024-08,False,Other Computer Services,Other Computer Services,Other Computer Services
,2024-08-03,8400/000 : FNB,298.08 gOOGLE gsUITE,Account Payment,298.08 gOOGLE gsUITE,5581.62,,2541388.2,AccountTransactionsReport(1).csv,1145,2024-08,False,Other Computer Services,Analytics & Monitoring,Analytics & Monitoring
,2024-08-03,8400/000 : FNB,391.60 Google GSuit,Account Payment,391.60 Google GSuit,7954.51,,2549342.71,AccountTransactionsReport(1).csv,1146,2024-08,False,Other Computer Services,Analytics & Monitoring,Analytics & Monitoring
,2024-08-03,8400/000 : FNB,46.00 Facebook,Account Payment,46.00 Facebook,861.36,,2550204.07,AccountTransactionsReport(1).csv,1147,2024-08,False,Marketing Tools,Marketing Tools,Marketing Tools
,2024-08-03,8400/000 : FNB,1256.50 Facebook,Account Payment,1256.50 Facebook,1256.5,,2551460.57,AccountTransactionsReport(1).csv,1148,2024-08,False,Marketing Tools,Marketing Tools,Marketing Tools
,2024-08-03,8400/000 : FNB,7.00 Glassfrog,Account Payment,7.00 Glassfrog,131.08,,2551591.65,AccountTransactionsReport(1).csv,1149,2024-08,False,Other Computer Services,Other Computer Services,Other Computer Services
,2024-08-03,8400/000 : FNB,9.20 Facebook,Account Payment,9.20 Facebook,172.27,,2551763.92,AccountTransactionsReport(1).csv,1150,2024-08,False,Marketing Tools,Marketing Tools,Marketing Tools
,2024-08-03,8400/000 : FNB,12.00 Google GSuite,Account Payment,12.00 Google GSuite,289.06,,2552052.98,AccountTransactionsReport(1).csv,1151,2024-08,False,Other Computer Services,Analytics & Monitoring,Analytics & Monitoring
,2024-08-03,8400/000 : FNB,17.25 Slack,Account Payment,17.25 Slack,323.01,,2552375.99,AccountTransactionsReport(1).csv,1152,2024-08,False,Communication,Communication,Communication
,2024-08-03,8400/000 : FNB,27.60 Facebook,Account Payment,27.60 Facebook,516.81,,2552892.8,AccountTransactionsReport(1).csv,1153,2024-08,False,Marketing Tools,Marketing Tools,Marketing Tools
,2024-08-03,8400/000 : FNB,29.000 ECM A LEGALZ,Account Payment,29.000 ECM A LEGALZ,543.03,,2553435.83,AccountTransactionsReport(1).csv,1154,2024-08,False,Other Computer Services,Other Computer Services,Other Computer Services
,2024-08-03,8400/000 : FNB,83.96 Google Gsuite,Account Payment,83.96 Google Gsuite,1705.47,,2555141.3,AccountTransactionsReport(1).csv,1155,2024-08,False,Other Computer Services,Analytics & Monitoring,Analytics & Monitoring
,2024-08-03,8400/000 : FNB,1755.42 Google Cloud,Account Payment,1755.42 Google Cloud,32870.68,,2588011.98,AccountTransactionsReport(1).csv,1156,2024-08,False,Other Computer Services,Analytics & Monitoring,Analytics & Monitoring
,2024-08-03,8400/000 : FNB,39.82 Google Gsuite,Account Payment,39.82 Google GSuite,808.86,,2588820.84,AccountTransactionsReport(1).csv,1157,2024-08,False,Other Computer Services,Analytics & Monitoring,Analytics & Monitoring
,2024-08-05,8400/000 : FNB,BOB GROUP,Account Payment,BOB GROUP,2298.85,,2591119.69,AccountTransactionsReport(1).csv,1158,2024-08,False,Other Computer Services,Other Computer Services,Other Computer Services
,2024-08-05,8400/000 : FNB,BOB GROUP,Account Payment,BOB GROUP,2298.85,,2593418.54,AccountTransactionsReport(1).csv,1159,2024-08,True,Other Computer Services,Other Computer Services,Other Computer Services
,2024-08-05,8400/000 : FNB,450.0 WAPPALYZER,Account Payment,450.0 WAPPALYZER,8408.65,,2601827.19,AccountTransactionsReport(1).csv,1160,2024-08,False,Other Computer Services,Other Computer Services,Other Computer Services
,2024-08-06,8400/000 : FNB,179.00 MOZSEO;HELP@,Account Payment,179.00 MOZSEO;HELP@,3350.81,,2605178.0,AccountTransactionsReport(1).csv,1161,2024-08,False,Other Computer Services,Other Computer Services,Other Computer Services
,2024-08-06,8400/000 : FNB,"222.75 GITHUB, INC",Account Payment,"222.75 GITHUB, INC",4169.8,,2609347.8,AccountTransactionsReport(1).csv,1162,2024-08,False,Development Tools,Development Tools,Development Tools
,2024-08-06,8400/000 : FNB,249.00 STABLE,Account Payment,249.00 STABLE,4661.2,,2614009.0,AccountTransactionsReport(1).csv,1163,2024-08,False,Other Computer Services,Other Computer Services,Other Computer Services
,2024-08-06,8400/000 : FNB,253.00 WWW.WOLFRAM,Account Payment,253.00 WWW.WOLFRAM,4736.07,,2618745.07,AccountTransactionsReport(1).csv,1164,2024-08,False,Other Computer Services,Other Computer Services,Other Computer Services
,2024-08-06,8400/000 : FNB,4.95 SHELLS.COM,Account Payment,4.95 SHELLS.COM,92.67,,2618837.74,AccountTransactionsReport(1).csv,1165,2024-08,False,Other Computer Services,Other Computer Services,Other Computer Services
,2024-08-06,8400/000 : FNB,15.00 CAL.COM,Account Payment,15.00 CAL.COM,280.8,,2619118.54,AccountTransactionsReport(1).csv,1166,2024-08,False,Other Computer Services,Other Computer Services,Other Computer Services
,2024-08-06,8400/000 : FNB,19.00 GITHUB INC,Account Payment,19.00 GITHUB INC,355.67,,2619474.21,AccountTransactionsReport(1).csv,1167,2024-08,False,Development Tools,Development Tools,Development Tools
,2024-08-06,8400/000 : FNB,29.00 CAL.COM,Account Payment,29.00 CAL.COM,542.87,,2620017.08,AccountTransactionsReport(1).csv,1168,2024-08,False,Other Computer Services,Other Computer Services,Other Computer Services
,2024-08-06,8400/000 : FNB,57.48 PADDLE.NET,Account Payment,57.48 PADDLE.NET,1076.01,,2621093.09,AccountTransactionsReport(1).csv,1169,2024-08,False,Other Computer Services,Subscription Management,Subscription Management
,2024-08-06,8400/000 : FNB,IMSOMNIA TEAM,Account Payment,IMSOMNIA TEAM,1123.18,,2622216.27,AccountTransactionsReport(1).csv,1170,2024-08,False,Other Computer Services,Other Computer Services,Other Computer Services
,2024-08-06,8400/000 : FNB,99.00 DMNS.APP.BUSI,Account Payment,99.00 DMNS.APP.BUSI,1853.25,,2624069.52,AccountTransactionsReport(1).csv,1171,2024-08,False,Other Computer Services,Other Computer Services,Other Computer Services
,2024-08-06,8400/000 : FNB,99.99 JINA AI,Account Payment,99.99 JINA.AI,1871.78,,2625941.3,AccountTransactionsReport(1).csv,1172,2024-08,False,Other Computer Services,Other Computer Services,Other Computer Services
,2024-08-06,8400/000 : FNB,2098.98 SHOPIFY,Account Payment,2098.98 SHOPIFY,39292.16,,2665233.46,AccountTransactionsReport(1).csv,1173,2024-08,False,E-commerce Platforms,E-commerce Platforms,E-commerce Platforms
,2024-08-06,8400/000 : FNB,Triple Whale,Account Payment,Triple Whale,11213.07,,2676446.53,AccountTransactionsReport(1).csv,1174,2024-08,False,Other Computer Services,Other Computer Services,Other Computer Services
,2024-08-06,8400/000 : FNB,1499.00 APPDIRECT,Account Payment,1499.00 APPDIRECT,28060.75,,2704507.28,AccountTransactionsReport(1).csv,1175,2024-08,False,Other Computer Services,Other Computer Services,Other Computer Services
,2024-08-07,8400/000 : FNB,Sage Acc,Account Payment,Sage Acc,3160.0,,2707667.28,AccountTransactionsReport(1).csv,1176,2024-08,False,Other Computer Services,Other Computer Services,Other Computer Services
,2024-08-07,8400/000 : FNB,15.00Hightail,Account Payment,15.00 hIGHTAIL,286.06,,2707953.34,AccountTransactionsReport(1).csv,1177,2024-08,False,Other Computer Services,Other Computer Services,Other Computer Services
,2024-08-07,8400/000 : FNB,77.05 CBA Plesk,Account Payment,77.05 CBA Plesk,1442.35,,2709395.69,AccountTransactionsReport(1).csv,1178,2024-08,False,Domain & Hosting,Domain & Hosting,Domain & Hosting
,2024-08-07,8400/000 : FNB,99.00 Chatbase,Account Payment,99.00 Chatbase,1853.25,,2711248.94,AccountTransactionsReport(1).csv,1179,2024-08,False,Other Computer Services,Other Computer Services,Other Computer Services
,2024-08-07,8400/000 : FNB,"187.94 Paddle,Net",Account Payment,"187.94 Paddle,Net",187.94,,2711436.88,AccountTransactionsReport(1).csv,1180,2024-08,False,Other Computer Services,Subscription Management,Subscription Management
,2024-08-08,8400/000 : FNB,19.99 WOODCOMMERCE,Account Payment,19.99 WOODCOMMERCE,381.23,,2711818.11,AccountTransactionsReport(1).csv,1181,2024-08,False,Other Computer Services,Other Computer Services,Other Computer Services
,2024-08-08,8400/000 : FNB,20.00 VERCEL INC,Account Payment,20.00 VERCEL INC,381.42,,2712199.53,AccountTransactionsReport(1).csv,1182,2024-08,False,Cloud Services,Cloud Services,Cloud Services
,2024-08-08,8400/000 : FNB,"7.00 NPM, INC",Account Payment,"7.00 NPM, INC",132.76,,2712332.29,AccountTransactionsReport(1).csv,1183,2024-08,False,Other Computer Services,Other Computer Services,Other Computer Services
,2024-08-08,8400/000 : FNB,"7.00 NPM, INC",Account Payment,"7.00 NPM, INC",132.76,,2712465.05,AccountTransactionsReport(1).csv,1184,2024-08,True,Other Computer Services,Other Computer Services,Other Computer Services
,2024-08-08,8400/000 : FNB,18.40 SHOPIFY 2604,Account Payment,18.40 SHOPIFY 2604,350.9,,2712815.95,AccountTransactionsReport(1).csv,1185,2024-08,False,E-commerce Platforms,E-commerce Platforms,E-commerce Platforms
,2024-08-08,8400/000 : FNB,BOB GROUP,Account Payment,BOB GROUP,2298.85,,2715114.8,AccountTransactionsReport(1).csv,1186,2024-08,False,Other Computer Services,Other Computer Services,Other Computer Services
,2024-08-08,8400/000 : FNB,3.60 GETADDRESS IO,Account Payment,3.60 GETADDRESS IO,87.42,,2715202.22,AccountTransactionsReport(1).csv,1187,2024-08,False,Other Computer Services,Other Computer Services,Other Computer Services
,2024-08-08,8400/000 : FNB,"7.00 NPM, INC",Account Payment,"7.00 NPM, INC",132.76,,2715334.98,AccountTransactionsReport(1).csv,1188,2024-08,True,Other Computer Services,Other Computer Services,Other Computer Services
,2024-08-08,8400/000 : FNB,9.00 GITPOD,Account Payment,9.00 GITPOD,170.7,,2715505.68,AccountTransactionsReport(1).csv,1189,2024-08,False,Development Tools,Development Tools,Development Tools
,2024-08-08,8400/000 : FNB,9.00 TWENTY.COM,Account Payment,9.00 TWENTY.COM,171.64,,2715677.32,AccountTransactionsReport(1).csv,1190,2024-08,False,Other Computer Services,Other Computer Services,Other Computer Services
,2024-08-08,8400/000 : FNB,13.80 SHOPIFY,Account Payment,13.80 SHOPIFY,263.18,,2715940.5,AccountTransactionsReport(1).csv,1191,2024-08,False,E-commerce Platforms,E-commerce Platforms,E-commerce Platforms
,2024-08-08,8400/000 : FNB,13.80 SHOPIFY,Account Payment,13.80 SHOPIFY,263.18,,2716203.68,AccountTransactionsReport(1).csv,1192,2024-08,True,E-commerce Platforms,E-commerce Platforms,E-commerce Platforms
,2024-08-08,8400/000 : FNB,"7.00 NPM, INC",Account Payment,"7.00 NPM, INC",132.76,,2716336.44,AccountTransactionsReport(1).csv,1193,2024-08,True,Other Computer Services,Other Computer Services,Other Computer Services
,2024-08-10,8400/000 : FNB,35.00 NOTION LABS,Account Payment,35.00 NOTION LABS,663.84,,2717000.28,AccountTransactionsReport(1).csv,1194,2024-08,False,Other Computer Services,Collaboration Tools,Collaboration Tools
,2024-08-10,8400/000 : FNB,99.00 STACKBLITZ,Account Payment,99.00 STACKBLITZ,1863.08,,2718863.36,AccountTransactionsReport(1).csv,1195,2024-08,False,Other Computer Services,Other Computer Services,Other Computer Services
,2024-08-10,8400/000 : FNB,20.00 HUGGINGFACE,Account Payment,20.00 HUGGINGFACE,376.38,,2719239.74,AccountTransactionsReport(1).csv,1196,2024-08,False,AI Services,AI Services,AI Services
,2024-08-10,8400/000 : FNB,20.00 VERCEL INC,Account Payment,20.00 VERCEL INC,377.77,,2719617.51,AccountTransactionsReport(1).csv,1197,2024-08,False,Cloud Services,Cloud Services,Cloud Services
,2024-08-10,8400/000 : FNB,20.00 HEROKU,Account Payment,20.00 HEROKU,379.34,,2719996.85,AccountTransactionsReport(1).csv,1198,2024-08,False,Cloud Services,Cloud Services,Cloud Services
,2024-08-10,8400/000 : FNB,25.00 NOTION LABS,Account Payment,25.00 NOTION LABS,472.21,,2720469.06,AccountTransactionsReport(1).csv,1199,2024-08,False,Other Computer Services,Collaboration Tools,Collaboration Tools
,2024-08-10,8400/000 : FNB,28.75 CLOUDFLARE,Account Payment,28.75 CLOUDFLARE,543.04,,2721012.1,AccountTransactionsReport(1).csv,1200,2024-08,False,Cloud Services,Cloud Services,Cloud Services
,2024-08-10,8400/000 : FNB,12.00 CODESANDBOX,Account Payment,12.00 CODESANDBOX,227.6,,2721239.7,AccountTransactionsReport(1).csv,1201,2024-08,False,Other Computer Services,Other Computer Services,Other Computer Services
,2024-08-10,8400/000 : FNB,171.35 PADDLE.NET,Account Payment,171.35 PADDLE.NET,3236.51,,2724476.21,AccountTransactionsReport(1).csv,1202,2024-08,False,Other Computer Services,Subscription Management,Subscription Management
,2024-08-10,8400/000 : FNB,99.00 MIOSALON,Account Payment,99.00 MIOSALON,1877.72,,2726353.93,AccountTransactionsReport(1).csv,1203,2024-08,False,Other Computer Services,Other Computer Services,Other Computer Services
,2024-08-10,8400/000 : FNB,150.00 AUTH0.COM,Account Payment,150.00 AUTH0.COM,2833.25,,2729187.18,AccountTransactionsReport(1).csv,1204,2024-08,False,Security Services,Security Services,Security Services
,2024-08-10,8400/000 : FNB,13.8 SHOPIFY,Account Payment,13.8 SHOPIFY,261.74,,2729448.92,AccountTransactionsReport(1).csv,1205,2024-08,False,E-commerce Platforms,E-commerce Platforms,E-commerce Platforms
,2024-08-10,8400/000 : FNB,20.00 CLAUDE.AI SUB,Account Payment,20.00 CLAUDE.AI SUB,376.38,,2729825.3,AccountTransactionsReport(1).csv,1206,2024-08,False,AI Services,AI Services,AI Services
,2024-08-10,8400/000 : FNB,99.00 MIOSALON,Account Payment,99.00 MIOSALON,1877.72,,2731703.02,AccountTransactionsReport(1).csv,1207,2024-08,True,Other Computer Services,Other Computer Services,Other Computer Services
,2024-08-10,8400/000 : FNB,546.25 INTUIT,Account Payment,546.25 INTUIT,546.25,,2732249.27,AccountTransactionsReport(1).csv,1208,2024-08,False,Productivity Software,Productivity Software,Productivity Software
,2024-08-12,8400/000 : FNB,25.00 BEECEPTOR,Account Payment,25.00 BEECEPTOR,470.48,,2732719.75,AccountTransactionsReport(1).csv,1209,2024-08,False,Other Computer Services,Other Computer Services,Other Computer Services
,2024-08-12,8400/000 : FNB,25.00 BEECEPTOR,Account Payment,25.00 BEECEPTOR,470.48,,2733190.23,AccountTransactionsReport(1).csv,1210,2024-08,True,Other Computer Services,Other Computer Services,Other Computer Services
,2024-08-12,8400/000 : FNB,47.88 ELEMENTOR,Account Payment,47.88 ELEMENTOR,901.06,,2734091.29,AccountTransactionsReport(1).csv,1211,2024-08,False,Other Computer Services,Other Computer Services,Other Computer Services
,2024-08-12,8400/000 : FNB,49.00 SKRAPP.IO,Account Payment,49.00 SKRAPP.IO,922.13,,2735013.42,AccountTransactionsReport(1).csv,1212,2024-08,False,Other Computer Services,Other Computer Services,Other Computer Services
,2024-08-12,8400/000 : FNB,60.00 OPENAI* CHATG,Account Payment,60.00 OPENAI* CHATG,1129.14,,2736142.56,AccountTransactionsReport(1).csv,1213,2024-08,False,AI Services,AI Services,AI Services
,2024-08-12,8400/000 : FNB,70.00 NOTION LABS,Account Payment,70.00 NOTION LABS,1313.67,,2737456.23,AccountTransactionsReport(1).csv,1214,2024-08,False,Other Computer Services,Collaboration Tools,Collaboration Tools
,2024-08-12,8400/000 : FNB,399.00 ELEMENTOR,Account Payment,399.00 ELEMENTOR,7508.77,,2744965.0,AccountTransactionsReport(1).csv,1215,2024-08,False,Other Computer Services,Other Computer Services,Other Computer Services
,2024-08-12,8400/000 : FNB,1499.00 APPDIRECT,Account Payment,1499.00 APPDIRECT,28209.65,,2773174.65,AccountTransactionsReport(1).csv,1216,2024-08,False,Other Computer Services,Other Computer Services,Other Computer Services
,2024-08-12,8400/000 : FNB,5.20 SLACK T1AS3LCE,Account Payment,5.20 SLACK T1AS3LCE,97.86,,2773272.51,AccountTransactionsReport(1).csv,1217,2024-08,False,Communication,Communication,Communication
,2024-08-12,8400/000 : FNB,10.00 SUNO INC,Account Payment,10.00 SUNO INC,188.19,,2773460.7,AccountTransactionsReport(1).csv,1218,2024-08,False,Other Computer Services,Other Computer Services,Other Computer Services
,2024-08-13,8400/000 : FNB,1150.00 FACEBK,Account Payment,1150.00 FACEBK,1150.0,,2774610.7,AccountTransactionsReport(1).csv,1219,2024-08,False,Other Computer Services,Other Computer Services,Other Computer Services
,2024-08-13,8400/000 : FNB,6300 GITHUB,Account Payment,63.00 GITHUB,1182.3,,2775793.0,AccountTransactionsReport(1).csv,1220,2024-08,False,Development Tools,Development Tools,Development Tools
,2024-08-13,8400/000 : FNB,80.36 GITHUB,Account Payment,80.36 GITHUB,1508.09,,2777301.09,AccountTransactionsReport(1).csv,1221,2024-08,False,Development Tools,Development Tools,Development Tools
,2024-08-13,8400/000 : FNB,99.00 DYNAMIC XYZ,Account Payment,99.00 DYNAMIC XYZ,1857.9,,2779158.99,AccountTransactionsReport(1).csv,1222,2024-08,False,Other Computer Services,Other Computer Services,Other Computer Services
,2024-08-13,8400/000 : FNB,99.00 PLAYFAB,Account Payment,99.00 PLAYFAB,1857.9,,2781016.89,AccountTransactionsReport(1).csv,1223,2024-08,False,Other Computer Services,Other Computer Services,Other Computer Services
,2024-08-13,8400/000 : FNB,21.00 GITHUB,Account Payment,21.00 GITHUB,394.1,,2781410.99,AccountTransactionsReport(1).csv,1224,2024-08,False,Development Tools,Development Tools,Development Tools
,2024-08-13,8400/000 : FNB,21.56 SLACK,Account Payment,21.56 SLACK,404.61,,2781815.6,AccountTransactionsReport(1).csv,1225,2024-08,False,Communication,Communication,Communication
,2024-08-13,8400/000 : FNB,546.25 INTUIT,Account Payment,546.25 INTUIT,546.25,,2782361.85,AccountTransactionsReport(1).csv,1226,2024-08,False,Productivity Software,Productivity Software,Productivity Software
,2024-08-13,8400/000 : FNB,546.25 INTUIT,Account Payment,546.25 INTUIT,546.25,,2782908.1,AccountTransactionsReport(1).csv,1227,2024-08,True,Productivity Software,Productivity Software,Productivity Software
,2024-08-13,8400/000 : FNB,32.00 BUBBLE STARTE,Account Payment,32.00 BUBBLE STARTE,600.54,,2783508.64,AccountTransactionsReport(1).csv,1228,2024-08,False,Other Computer Services,Other Computer Services,Other Computer Services
,2024-08-13,8400/000 : FNB,120.75 MANAGEWP,Account Payment,120.75 MANAGEWP,2266.07,,2785774.71,AccountTransactionsReport(1).csv,1229,2024-08,False,Other Computer Services,Other Computer Services,Other Computer Services
,2024-08-13,8400/000 : FNB,120.75 MANAGEWP,Account Payment,120.75 MANAGEWP,2266.07,,2788040.78,AccountTransactionsReport(1).csv,1230,2024-08,True,Other Computer Services,Other Computer Services,Other Computer Services
,2024-08-13,8400/000 : FNB,189.00 GITHUB,Account Payment,189.00 GITHUB,3546.9,,2791587.68,AccountTransactionsReport(1).csv,1231,2024-08,False,Development Tools,Development Tools,Development Tools
,2024-08-13,8400/000 : FNB,499.00 CASSIDYAI.CO,Account Payment,499.00 CASSIDYAI.CO,9390.67,,2800978.35,AccountTransactionsReport(1).csv,1232,2024-08,False,Other Computer Services,Other Computer Services,Other Computer Services
,2024-08-13,8400/000 : FNB,3633.95 SHOPIFY,Account Payment,3633.95 SHOPIFY,68197.11,,2869175.46,AccountTransactionsReport(1).csv,1233,2024-08,False,E-commerce Platforms,E-commerce Platforms,E-commerce Platforms
,2024-08-14,8400/000 : FNB,15.00 TABNINE,Account Payment,15.00 Tabnine,281.5,,2869456.96,AccountTransactionsReport(1).csv,1234,2024-08,False,Other Computer Services,Other Computer Services,Other Computer Services
,2024-08-15,8400/000 : FNB,5.00 WWW.FLUX,Account Payment,5.00 WWW.FLUX,93.51,,2869550.47,AccountTransactionsReport(1).csv,1235,2024-08,False,Other Computer Services,Other Computer Services,Other Computer Services
,2024-08-15,8400/000 : FNB,74.75 SHOPIFY,Account Payment,74.75 SHOPIFY,1397.99,,2870948.46,AccountTransactionsReport(1).csv,1236,2024-08,False,E-commerce Platforms,E-commerce Platforms,E-commerce Platforms
,2024-08-15,8400/000 : FNB,180.00 AGENCY ANALYT,Account Payment,180.00 AGENCY ANALYT,3366.39,,2874314.85,AccountTransactionsReport(1).csv,1237,2024-08,False,Other Computer Services,Other Computer Services,Other Computer Services
,2024-08-16,8400/000 : FNB,20.00 RAILWAY,Account Payment,20.00 RAILWAY,370.52,,2874685.37,AccountTransactionsReport(1).csv,1238,2024-08,False,Other Computer Services,Other Computer Services,Other Computer Services
,2024-08-16,8400/000 : FNB,20.00 RAILWAY,Account Payment,20.00 RAILWAY,370.52,,2875055.89,AccountTransactionsReport(1).csv,1239,2024-08,True,Other Computer Services,Other Computer Services,Other Computer Services
,2024-08-16,8400/000 : FNB,14.00 GITHUB,Account Payment,14.00 GITHUB,261.05,,2875316.94,AccountTransactionsReport(1).csv,1240,2024-08,False,Development Tools,Development Tools,Development Tools
,2024-08-16,8400/000 : FNB,546.25 INTUIT,Account Payment,546.25 INTUIT,546.25,,2875863.19,AccountTransactionsReport(1).csv,1241,2024-08,False,Productivity Software,Productivity Software,Productivity Software
,2024-08-17,8400/000 : FNB,40.00 REPLIT,Account Payment,40.00 REPLIT,741.02,,2876604.21,AccountTransactionsReport(1).csv,1242,2024-08,False,Other Computer Services,Other Computer Services,Other Computer Services
,2024-08-17,8400/000 : FNB,120.00 OPENAI,Account Payment,120.00 OPENAI,2223.06,,2878827.27,AccountTransactionsReport(1).csv,1243,2024-08,False,AI Services,AI Services,AI Services
,2024-08-17,8400/000 : FNB,219.80 SLACK,Account Payment,219.80 SLACK,4071.91,,2882899.18,AccountTransactionsReport(1).csv,1244,2024-08,False,Communication,Communication,Communication
,2024-08-17,8400/000 : FNB,25.00ANTHROPIC,Account Payment,25.00 ANTHROPIC,463.14,,2883362.32,AccountTransactionsReport(1).csv,1245,2024-08,False,AI Services,AI Services,AI Services
,2024-08-29,8400/000 : FNB,PURCH FIGMA,Account Payment,PURCH FIGMA,33959.72,,2917322.04,AccountTransactionsReport(1).csv,1246,2024-08,False,Other Computer Services,Design Tools,Design Tools
,2024-08-30,8400/000 : FNB,PURCH FIGMA ANNUAL,Account Payment,PURCH FIGMA ANUAL,3773.31,,2921095.35,AccountTransactionsReport(1).csv,1247,2024-08,False,Other Computer Services,Design Tools,Design Tools
,2024-09-04,8400/000 : FNB,BOB GROUP,Account Payment,BOB GROUP,2298.85,,2923394.2,AccountTransactionsReport(1).csv,1248,2024-09,False,Other Computer Services,Other Computer Services,Other Computer Services
,2024-09-05,8400/000 : FNB,54.00 AIRTABLE.COM,Account Payment,54.00 AIRTABLE.COM,992.17,,2924386.37,AccountTransactionsReport(1).csv,1249,2024-09,False,Other Computer Services,Collaboration Tools,Collaboration Tools
,2024-09-05,8400/000 : FNB,249.00 STABLE,Account Payment,249.00 STABLE,4575.02,,2928961.39,AccountTransactionsReport(1).csv,1250,2024-09,False,Other Computer Services,Other Computer Services,Other Computer Services
,2024-09-05,8400/000 : FNB,1499.00 APPDIRECT,Account Payment,1499.00 APPDIRECT,27541.95,,2956503.34,AccountTransactionsReport(1).csv,1251,2024-09,False,Other Computer Services,Other Computer Services,Other Computer Services
,2024-09-06,8400/000 : FNB,11.26 GITHUB,Account Payment,11.26 GITHUB,206.89,,2956710.23,AccountTransactionsReport(1).csv,1252,2024-09,False,Development Tools,Development Tools,Development Tools
,2024-09-06,8400/000 : FNB,2063.397 SHOPIFY,Account Payment,2063.397 SHOPIFY,37922.45,,2994632.68,AccountTransactionsReport(1).csv,1253,2024-09,False,E-commerce Platforms,E-commerce Platforms,E-commerce Platforms
,2024-09-06,8400/000 : FNB,1152.76 GOOGLE CLOUD,Account Payment,1152.76 GOOGLE CLOUD,21180.29,,3015812.97,AccountTransactionsReport(1).csv,1254,2024-09,False,Other Computer Services,Analytics & Monitoring,Analytics & Monitoring
,2024-09-06,8400/000 : FNB,450.00 WAPPALYZER,Account Payment,450.00 WAPPALYZER,8268.1,,3024081.07,AccountTransactionsReport(1).csv,1255,2024-09,False,Other Computer Services,Other Computer Services,Other Computer Services
,2024-09-06,8400/000 : FNB,599.00 TRIPLE WHALE,Account Payment,599.00 TRIPLE WHALE,11005.75,,3035086.82,AccountTransactionsReport(1).csv,1256,2024-09,False,Other Computer Services,Other Computer Services,Other Computer Services
,2024-09-06,8400/000 : FNB,74.00 PIPEDREAM,Account Payment,74.00 PIPEDREAM,1359.64,,3036446.46,AccountTransactionsReport(1).csv,1257,2024-09,False,Other Computer Services,Other Computer Services,Other Computer Services
,2024-09-06,8400/000 : FNB,77.05 CBA PLESK,Account Payment,77.05 CBA PLESK,1416.83,,3037863.29,AccountTransactionsReport(1).csv,1258,2024-09,False,Domain & Hosting,Domain & Hosting,Domain & Hosting
,2024-09-06,8400/000 : FNB,134.00 SINC MAILGU,Account Payment,134.00 SINC MAILGU,2462.06,,3040325.35,AccountTransactionsReport(1).csv,1259,2024-09,False,Other Computer Services,Other Computer Services,Other Computer Services
,2024-09-06,8400/000 : FNB,150.00 AUTH0.COM,Account Payment,150.00 AUT0.COM,2756.03,,3043081.38,AccountTransactionsReport(1).csv,1260,2024-09,False,Security Services,Security Services,Security Services
,2024-09-06,8400/000 : FNB,5050.80 FRESHWORKS,Account Payment,5050.80 FRESHWORKS,5050.8,,3048132.18,AccountTransactionsReport(1).csv,1261,2024-09,False,Productivity Software,Productivity Software,Productivity Software
,2024-09-06,8400/000 : FNB,280.00 WIZA.CO,Account Payment,280.00 WIZA.CO,5144.59,,3053276.77,AccountTransactionsReport(1).csv,1262,2024-09,False,Other Computer Services,Other Computer Services,Other Computer Services
,2024-09-06,8400/000 : FNB,99.99 JINA AI,Account Payment,99.99 JINA AI,1837.17,,3055113.94,AccountTransactionsReport(1).csv,1263,2024-09,False,Other Computer Services,Other Computer Services,Other Computer Services
,2024-09-06,8400/000 : FNB,17.25 SLACK,Account Payment,17.25 SLACK,316.94,,3055430.88,AccountTransactionsReport(1).csv,1264,2024-09,False,Communication,Communication,Communication
,2024-09-06,8400/000 : FNB,19.00 GITHUB,Account Payment,19.00 GITHUB,349.1,,3055779.98,AccountTransactionsReport(1).csv,1265,2024-09,False,Development Tools,Development Tools,Development Tools
,2024-09-06,8400/000 : FNB,20.00 HUGGINGTONFACE,Account Payment,20.00 HUGGINGTONFACE,367.48,,3056147.46,AccountTransactionsReport(1).csv,1266,2024-09,False,Other Computer Services,Other Computer Services,Other Computer Services
,2024-09-09,8400/000 : FNB,WOODCOMMERCE,Account Payment,WOODCOMMERCE,365.23,,3056512.69,AccountTransactionsReport(1).csv,1267,2024-09,False,Other Computer Services,Other Computer Services,Other Computer Services
,2024-09-09,8400/000 : FNB,20.00 VERCEL INC,Account Payment,20.00 VERCEL INC,365.42,,3056878.11,AccountTransactionsReport(1).csv,1268,2024-09,False,Cloud Services,Cloud Services,Cloud Services
,2024-09-09,8400/000 : FNB,20.00 VERCEL INC,Account Payment,20.00 VERCEL INC,365.42,,3057243.53,AccountTransactionsReport(1).csv,1269,2024-09,True,Cloud Services,Cloud Services,Cloud Services
,2024-09-10,8400/000 : FNB,7.00 NPN,Account Payment,7.00 NPN,127.84,,3057371.37,AccountTransactionsReport(1).csv,1270,2024-09,False,Other Computer Services,Other Computer Services,Other Computer Services
,2024-09-10,8400/000 : FNB,7.00 NPN,Account Payment,7.00 NPN,127.84,,3057499.21,AccountTransactionsReport(1).csv,1271,2024-09,True,Other Computer Services,Other Computer Services,Other Computer Services
,2024-09-10,8400/000 : FNB,7.00 NPN,Account Payment,7.00 NPN,127.84,,3057627.05,AccountTransactionsReport(1).csv,1272,2024-09,True,Other Computer Services,Other Computer Services,Other Computer Services
,2024-09-10,8400/000 : FNB,187.94 PADDLE NET,Account Payment,187.94 PADDLE NET,187.94,,3057814.99,AccountTransactionsReport(1).csv,1273,2024-09,False,Other Computer Services,Subscription Management,Subscription Management
,2024-09-10,8400/000 : FNB,12.00 CODESANDBOX,Account Payment,12.00 CODESANDBOX,219.14,,3058034.13,AccountTransactionsReport(1).csv,1274,2024-09,False,Other Computer Services,Other Computer Services,Other Computer Services
,2024-09-10,8400/000 : FNB,99.00 CHATBASE,Account Payment,99.00 CHATBASE,1807.92,,3059842.05,AccountTransactionsReport(1).csv,1275,2024-09,False,Other Computer Services,Other Computer Services,Other Computer Services
,2024-09-10,8400/000 : FNB,7.00 NPN,Account Payment,7.00NPM,127.84,,3059969.89,AccountTransactionsReport(1).csv,1276,2024-09,False,Other Computer Services,Other Computer Services,Other Computer Services
,2024-09-10,8400/000 : FNB,6.00 DOCKER INC,Account Payment,6.00 DOCKER INC,109.57,,3060079.46,AccountTransactionsReport(1).csv,1277,2024-09,False,Other Computer Services,Other Computer Services,Other Computer Services
,2024-09-10,8400/000 : FNB,546.25 INTUIT,Account Payment,546.25INTUIT,546.25,,3060625.71,AccountTransactionsReport(1).csv,1278,2024-09,False,Productivity Software,Productivity Software,Productivity Software
,2024-09-10,8400/000 : FNB,10.00 MATTERMOST,Account Payment,10.00 MATTERMOST,182.62,,3060808.33,AccountTransactionsReport(1).csv,1279,2024-09,False,Other Computer Services,Other Computer Services,Other Computer Services
,2024-09-10,8400/000 : FNB,15.00 CAL.COM,Account Payment,15.00 CAL.COM,273.93,,3061082.26,AccountTransactionsReport(1).csv,1280,2024-09,False,Other Computer Services,Other Computer Services,Other Computer Services
,2024-09-10,8400/000 : FNB,15.00 HIGHTAIL,Account Payment,15.00 HIGHTAIL,273.93,,3061356.19,AccountTransactionsReport(1).csv,1281,2024-09,False,Other Computer Services,Other Computer Services,Other Computer Services
,2024-09-10,8400/000 : FNB,25.00 NOTION LABS,Account Payment,25.00 NOTION LABS,456.54,,3061812.73,AccountTransactionsReport(1).csv,1282,2024-09,False,Other Computer Services,Collaboration Tools,Collaboration Tools
,2024-09-10,8400/000 : FNB,27.60 LEMSQZY,Account Payment,27.60 LEMSQZY,504.02,,3062316.75,AccountTransactionsReport(1).csv,1283,2024-09,False,AI Services,AI Services,AI Services
,2024-09-10,8400/000 : FNB,171.35 PADDLE.NET,Account Payment,171.35 PADDLE.NET,3129.16,,3065445.91,AccountTransactionsReport(1).csv,1284,2024-09,False,Other Computer Services,Subscription Management,Subscription Management
,2024-09-10,8400/000 : FNB,150.00 AUTH0.COM,Account Payment,150.00 AUTH0.COM,2739.26,,3068185.17,AccountTransactionsReport(1).csv,1285,2024-09,False,Security Services,Security Services,Security Services
,2024-09-10,8400/000 : FNB,34.99 GOOGLE,Account Payment,34.99 GOOGLE,34.99,,3068220.16,AccountTransactionsReport(1).csv,1286,2024-09,False,Other Computer Services,Analytics & Monitoring,Analytics & Monitoring
,2024-09-10,8400/000 : FNB,3.60 GETADDRRESS,Account Payment,3.60 GETADDRESS,86.23,,3068306.39,AccountTransactionsReport(1).csv,1287,2024-09,False,Other Computer Services,Other Computer Services,Other Computer Services
,2024-09-10,8400/000 : FNB,52.91 WONDERSHARE,Account Payment,52.91 WONDERHARE,966.23,,3069272.62,AccountTransactionsReport(1).csv,1288,2024-09,False,Other Computer Services,Other Computer Services,Other Computer Services
,2024-09-10,8400/000 : FNB,99.00 MIOSALON,Account Payment,99.00 MIOSALON,1807.92,,3071080.54,AccountTransactionsReport(1).csv,1289,2024-09,False,Other Computer Services,Other Computer Services,Other Computer Services
,2024-09-10,8400/000 : FNB,253.00 WWW.WOLFRAM,Account Payment,253.00 WWW.WOLFRAM,4620.22,,3075700.76,AccountTransactionsReport(1).csv,1290,2024-09,False,Other Computer Services,Other Computer Services,Other Computer Services
,2024-09-10,8400/000 : FNB,MIOSALON,Account Payment,MIOSALON,1807.92,,3077508.68,AccountTransactionsReport(1).csv,1291,2024-09,False,Other Computer Services,Other Computer Services,Other Computer Services
,2024-09-10,8400/000 : FNB,111.77 NOTION LABS,Account Payment,111.77 NOTION LABS,2041.12,,3079549.8,AccountTransactionsReport(1).csv,1292,2024-09,False,Other Computer Services,Collaboration Tools,Collaboration Tools
,2024-09-10,8400/000 : FNB,120.75 MANAGEWP,Account Payment,120.75 MANAGEWP,2205.11,,3081754.91,AccountTransactionsReport(1).csv,1293,2024-09,False,Other Computer Services,Other Computer Services,Other Computer Services
,2024-09-10,8400/000 : FNB,120.75 MANAGEWP,Account Payment,120.75 MANAGEWP,2205.11,,3083960.02,AccountTransactionsReport(1).csv,1294,2024-09,True,Other Computer Services,Other Computer Services,Other Computer Services
,2024-09-10,8400/000 : FNB,59.00 GREENBACK.COM,Account Payment,59.00 GREENBACK.COM,1077.45,,3085037.47,AccountTransactionsReport(1).csv,1295,2024-09,False,Other Computer Services,Other Computer Services,Other Computer Services
,2024-09-10,8400/000 : FNB,89.00 SENTRY,Account Payment,89.00 SENTRY,1625.3,,3086662.77,AccountTransactionsReport(1).csv,1296,2024-09,False,Other Computer Services,Analytics & Monitoring,Analytics & Monitoring
,2024-09-10,8400/000 : FNB,28.75 CLOUDFARE,Account Payment,28.75 CLOUDFARE,525.02,,3087187.79,AccountTransactionsReport(1).csv,1297,2024-09,False,Other Computer Services,Other Computer Services,Other Computer Services
,2024-09-10,8400/000 : FNB,29.00 CAL.COM,Account Payment,29.00 CAL.COM,529.59,,3087717.38,AccountTransactionsReport(1).csv,1298,2024-09,False,Other Computer Services,Other Computer Services,Other Computer Services
,2024-09-11,8400/000 : FNB,GLASS FROG,Account Payment,GLASSFROG,127.84,,3087845.22,AccountTransactionsReport(1).csv,1299,2024-09,False,Other Computer Services,Other Computer Services,Other Computer Services
,2024-09-11,8400/000 : FNB,30.00 ISHRAQ LLC,Account Payment,30.00 ISHRAQ LLC,547.85,,3088393.07,AccountTransactionsReport(1).csv,1300,2024-09,False,Other Computer Services,Other Computer Services,Other Computer Services
,2024-09-11,8400/000 : FNB,18.38 DROPBOX,Account Payment,18.38 DROPBOX,335.65,,3088728.72,AccountTransactionsReport(1).csv,1301,2024-09,False,Other Computer Services,Other Computer Services,Other Computer Services
,2024-09-11,8400/000 : FNB,20.00 HEROKU,Account Payment,20.00 HEROKU,365.23,,3089093.95,AccountTransactionsReport(1).csv,1302,2024-09,False,Cloud Services,Cloud Services,Cloud Services
,2024-09-11,8400/000 : FNB,20.00 VERCEL,Account Payment,20.00 VERCEL,365.23,,3089459.18,AccountTransactionsReport(1).csv,1303,2024-09,False,Cloud Services,Cloud Services,Cloud Services
,2024-09-11,8400/000 : FNB,GITPOD,Account Payment,GITPOD,164.91,,3089624.09,AccountTransactionsReport(1).csv,1304,2024-09,False,Development Tools,Development Tools,Development Tools
,2024-09-11,8400/000 : FNB,FACEBOOK,Account Payment,FACEBOOK,168.0,,3089792.09,AccountTransactionsReport(1).csv,1305,2024-09,False,Marketing Tools,Marketing Tools,Marketing Tools
,2024-09-11,8400/000 : FNB,10.00 SUNO INC,Account Payment,10.00 SUNO INC,182.62,,3089974.71,AccountTransactionsReport(1).csv,1306,2024-09,False,Other Computer Services,Other Computer Services,Other Computer Services
,2024-09-11,8400/000 : FNB,ADOBE,Account Payment,ADOBE,419.84,,3090394.55,AccountTransactionsReport(1).csv,1307,2024-09,False,Productivity Software,Productivity Software,Productivity Software
,2024-09-11,8400/000 : FNB,BEECEPTOR,Account Payment,BEECEPTOR,456.54,,3090851.09,AccountTransactionsReport(1).csv,1308,2024-09,False,Other Computer Services,Other Computer Services,Other Computer Services
,2024-09-11,8400/000 : FNB,BEECEPTOR,Account Payment,BEECEPTOR,456.54,,3091307.63,AccountTransactionsReport(1).csv,1309,2024-09,True,Other Computer Services,Other Computer Services,Other Computer Services
,2024-09-11,8400/000 : FNB,27.60 FACEBOOK,Account Payment,27.60 FACEBOOK,504.02,,3091811.65,AccountTransactionsReport(1).csv,1310,2024-09,False,Marketing Tools,Marketing Tools,Marketing Tools
,2024-09-11,8400/000 : FNB,REPLIT,Account Payment,REPLIT,732.97,,3092544.62,AccountTransactionsReport(1).csv,1311,2024-09,False,Other Computer Services,Other Computer Services,Other Computer Services
,2024-09-11,8400/000 : FNB,20.00 HUGGINGFACE,Account Payment,20.00 HUGGINGFACE,366.49,,3092911.11,AccountTransactionsReport(1).csv,1312,2024-09,False,AI Services,AI Services,AI Services
,2024-09-11,8400/000 : FNB,46.00 FACEBOOK EMMQ9,Account Payment,46.00 FACEBOOK EMMQ9,840.04,,3093751.15,AccountTransactionsReport(1).csv,1313,2024-09,False,Marketing Tools,Marketing Tools,Marketing Tools
,2024-09-11,8400/000 : FNB,60.00 OPENAI,Account Payment,60.00 OPENAI,1095.7,,3094846.85,AccountTransactionsReport(1).csv,1314,2024-09,False,AI Services,AI Services,AI Services
,2024-09-11,8400/000 : FNB,70.00 NOTION LABS,Account Payment,70.00 NOTION LABS,1282.7,,3096129.55,AccountTransactionsReport(1).csv,1315,2024-09,False,Other Computer Services,Collaboration Tools,Collaboration Tools
,2024-09-11,8400/000 : FNB,179.00 MOZSEO:HELP,Account Payment,179.00 MOZSEO:HELP,3268.86,,3099398.41,AccountTransactionsReport(1).csv,1316,2024-09,False,Other Computer Services,Other Computer Services,Other Computer Services
,2024-09-11,8400/000 : FNB,47.84 DIGITAL OCEAN,Account Payment,47.84 DIGITAL OCEAN,873.64,,3100272.05,AccountTransactionsReport(1).csv,1317,2024-09,False,Other Computer Services,Other Computer Services,Other Computer Services
,2024-09-11,8400/000 : FNB,49.00 SKRAPP.IO,Account Payment,49.00 SKRAPP.IO,894.83,,3101166.88,AccountTransactionsReport(1).csv,1318,2024-09,False,Other Computer Services,Other Computer Services,Other Computer Services
,2024-09-11,8400/000 : FNB,BEENVERIFIED,Account Payment,BEENVERIFIED,547.67,,3101714.55,AccountTransactionsReport(1).csv,1319,2024-09,False,Other Computer Services,Other Computer Services,Other Computer Services
,2024-09-11,8400/000 : FNB,499.00 CASSIDY AI,Account Payment,499.00 CASSIDY AI,9112.62,,3110827.17,AccountTransactionsReport(1).csv,1320,2024-09,False,Other Computer Services,Other Computer Services,Other Computer Services
,2024-09-11,8400/000 : FNB,1499 APPDIRECT,Account Payment,1499 APPDIRECT,27374.38,,3138201.55,AccountTransactionsReport(1).csv,1321,2024-09,False,Other Computer Services,Other Computer Services,Other Computer Services
,2024-09-12,8400/000 : FNB,21.00 GITHUB,Account Payment,21.00 GITHUB,384.81,,3138586.36,AccountTransactionsReport(1).csv,1322,2024-09,False,Development Tools,Development Tools,Development Tools
,2024-09-12,8400/000 : FNB,21.56 SLACK,Account Payment,21.56 SLACK,395.08,,3138981.44,AccountTransactionsReport(1).csv,1323,2024-09,False,Communication,Communication,Communication
,2024-09-12,8400/000 : FNB,5.00 COMPONENTS.STU,Account Payment,5.00 COMPONENTS.STU,91.62,,3139073.06,AccountTransactionsReport(1).csv,1324,2024-09,False,Other Computer Services,Other Computer Services,Other Computer Services
,2024-09-12,8400/000 : FNB,6.00 WWW.DEVIANTART,Account Payment,6.00 WWW.DEVIANTART,109.95,,3139183.01,AccountTransactionsReport(1).csv,1325,2024-09,False,Other Computer Services,Other Computer Services,Other Computer Services
,2024-09-12,8400/000 : FNB,74.97 WWW.DEVINTAR,Account Payment,74.97 WWW.DEVINTAR,1373.78,,3140556.79,AccountTransactionsReport(1).csv,1326,2024-09,False,Other Computer Services,Other Computer Services,Other Computer Services
,2024-09-12,8400/000 : FNB,99.00 DYNAMICS,Account Payment,99.00 DYNAMICS,1815.67,,3142372.46,AccountTransactionsReport(1).csv,1327,2024-09,False,Other Computer Services,Other Computer Services,Other Computer Services
,2024-09-12,8400/000 : FNB,3783.47 SHOPIFY,Account Payment,3783.47 SHOPIFY,69329.43,,3211701.89,AccountTransactionsReport(1).csv,1328,2024-09,False,E-commerce Platforms,E-commerce Platforms,E-commerce Platforms
,2024-09-12,8400/000 : FNB,32.00 BUBBLE STARTE,Account Payment,32.00 BUBBLE STARTE,586.89,,3212288.78,AccountTransactionsReport(1).csv,1329,2024-09,False,Other Computer Services,Other Computer Services,Other Computer Services
,2024-09-13,8400/000 : FNB,189 GITHUB,Account Payment,189 GITHUB,3466.28,,3215755.06,AccountTransactionsReport(1).csv,1330,2024-09,False,Development Tools,Development Tools,Development Tools
,2024-09-13,8400/000 : FNB,63.00 GITHUB,Account Payment,63.00 GITHUB,1155.43,,3216910.49,AccountTransactionsReport(1).csv,1331,2024-09,False,Development Tools,Development Tools,Development Tools
,2024-09-13,8400/000 : FNB,99.00 DMNS APP,Account Payment,99.00 DMNS APP,1815.67,,3218726.16,AccountTransactionsReport(1).csv,1332,2024-09,False,Other Computer Services,Other Computer Services,Other Computer Services
,2024-09-13,8400/000 : FNB,9.00 Twenty.com,Account Payment,9.00 Twenty.com,165.06,,3218891.22,AccountTransactionsReport(1).csv,1333,2024-09,False,Other Computer Services,Other Computer Services,Other Computer Services
,2024-09-13,8400/000 : FNB,21.00 GITHUB,Account Payment,21.00 GITHUB,385.14,,3219276.36,AccountTransactionsReport(1).csv,1334,2024-09,False,Development Tools,Development Tools,Development Tools
,2024-09-13,8400/000 : FNB,546.25 INTUIT,Account Payment,546.25 INTUIT,546.25,,3219822.61,AccountTransactionsReport(1).csv,1335,2024-09,False,Productivity Software,Productivity Software,Productivity Software
,2024-09-13,8400/000 : FNB,546.25 INTUIT,Account Payment,546.25 INTUIT,546.25,,3220368.86,AccountTransactionsReport(1).csv,1336,2024-09,True,Productivity Software,Productivity Software,Productivity Software
,2024-09-13,8400/000 : FNB,60.00 IMSOMNIA TEAM,Account Payment,60.00 INSOMNIA TEAM,1101.47,,3221470.33,AccountTransactionsReport(1).csv,1337,2024-09,False,Other Computer Services,Other Computer Services,Other Computer Services
,2024-09-14,8400/000 : FNB,9.00 GITPOD,Account Payment,9.00 GITPOD,165.22,,3221635.55,AccountTransactionsReport(1).csv,1338,2024-09,False,Development Tools,Development Tools,Development Tools
,2024-09-14,8400/000 : FNB,15.00 TABNINE,Account Payment,15.00 TABNINE,275.37,,3221910.92,AccountTransactionsReport(1).csv,1339,2024-09,False,Other Computer Services,Other Computer Services,Other Computer Services
,2024-09-14,8400/000 : FNB,20.00 CLAUDE AI SUB,Account Payment,20.00 CLAUDE AI SUB,367.83,,3222278.75,AccountTransactionsReport(1).csv,1340,2024-09,False,AI Services,AI Services,AI Services
,2024-09-14,8400/000 : FNB,67.85 LEMSQZY,Account Payment,67.85 LEMSQZY,1247.87,,3223526.62,AccountTransactionsReport(1).csv,1341,2024-09,False,AI Services,AI Services,AI Services
,2024-09-14,8400/000 : FNB,74.75 SHOPIFY,Account Payment,74.75 SHOPIFY,1372.24,,3224898.86,AccountTransactionsReport(1).csv,1342,2024-09,False,E-commerce Platforms,E-commerce Platforms,E-commerce Platforms
,2024-09-14,8400/000 : FNB,182.85 Wix.Com,Account Payment,182.85 Wix.Com,3350.6,,3228249.46,AccountTransactionsReport(1).csv,1343,2024-09,False,E-commerce Platforms,E-commerce Platforms,E-commerce Platforms
,2024-09-14,8400/000 : FNB,TIME IS LD,Account Payment,TIME IS LTD,5499.09,,3233748.55,AccountTransactionsReport(1).csv,1344,2024-09,False,Other Computer Services,Other Computer Services,Other Computer Services
,2024-09-16,8400/000 : FNB,5.00 WWW.FLUX.AI 4XX*5191 13 SEP XX2545 5.00 WWW.FLUX.AI 4XXXXX*5191 13 SEP XXXXXXXXXXXXXXXXXXX2545,Account Payment,5.00 WWW.FLUX.AI 4XX*5191 13 SEP XX2545 5.00 WWW.FLUX.AI 4XXXXX*5191 13 SEP XXXXXXXXXXXXXXXXXXX2545,91.95,,3233840.5,AccountTransactionsReport(1).csv,1345,2024-09,False,Other Computer Services,Other Computer Services,Other Computer Services
,2024-09-16,8400/000 : FNB,180.00 AGENCYANALYT 4XX*5225 13 SEP XX3287 180.00 AGENCYANALYT 4XXXXX*5225 13 SEP XXXXXXXXXXXXXXXXXX,Account Payment,180.00 AGENCYANALYT 4XX*5225 13 SEP XX3287 180.00 AGENCYANALYT 4XXXXX*5225 13 SEP XXXXXXXXXXXXXXXXX,3310.49,,3237150.99,AccountTransactionsReport(1).csv,1346,2024-09,False,Other Computer Services,Other Computer Services,Other Computer Services
,2024-09-16,8400/000 : FNB,59.13 PADDLE.NET* W 4XX*5191 14 SEP XX6854 59.13 PADDLE.NET* W 4XXXXX*5191 14 SEP XXXXXXXXXXXXXXXXXX,Account Payment,59.13 PADDLE.NET* W 4XX*5191 14 SEP XX6854 59.13 PADDLE.NET* W 4XXXXX*5191 14 SEP XXXXXXXXXXXXXXXXX,1075.61,,3238226.6,AccountTransactionsReport(1).csv,1347,2024-09,False,Other Computer Services,Subscription Management,Subscription Management
,2024-09-17,8400/000 : FNB,376.40 HOLASPIRIT 4XX*5225 15 SEP XX9821 376.40 HOLASPIRIT 4XXXXX*5225 15 SEP XXXXXXXXXXXXXXXXXXX982,Account Payment,376.40 HOLASPIRIT 4XX*5225 15 SEP XX9821 376.40 HOLASPIRIT 4XXXXX*5225 15 SEP XXXXXXXXXXXXXXXXXXX98,7580.82,,3245807.42,AccountTransactionsReport(1).csv,1348,2024-09,False,Other Computer Services,Other Computer Services,Other Computer Services
,2024-09-17,8400/000 : FNB,280.00 WIZA.CO 4XX*5191 14 SEP XX1231 280.00 WIZA.CO 4XXXXX*5191 14 SEP XXXXXXXXXXXXXXXXXXX1231,Account Payment,280.00 WIZA.CO 4XX*5191 14 SEP XX1231 280.00 WIZA.CO 4XXXXX*5191 14 SEP XXXXXXXXXXXXXXXXXXX1231,5093.39,,3250900.81,AccountTransactionsReport(1).csv,1349,2024-09,False,Other Computer Services,Other Computer Services,Other Computer Services
,2024-09-17,8400/000 : FNB,231.95 HOLASPIRIT 4XX*5225 15 SEP XX9445 231.95 HOLASPIRIT 4XXXXX*5225 15 SEP XXXXXXXXXXXXXXXXXXX944,Account Payment,231.95 HOLASPIRIT 4XX*5225 15 SEP XX9445 231.95 HOLASPIRIT 4XXXXX*5225 15 SEP XXXXXXXXXXXXXXXXXXX94,4671.56,,3255572.37,AccountTransactionsReport(1).csv,1350,2024-09,False,Other Computer Services,Other Computer Services,Other Computer Services
,2024-09-17,8400/000 : FNB,169.73 SLACK T0MN3D 4XX*5225 15 SEP XX5270 169.73 SLACK T0MN3D 4XXXXX*5225 15 SEP XXXXXXXXXXXXXXXXXX,Account Payment,169.73 SLACK T0MN3D 4XX*5225 15 SEP XX5270 169.73 SLACK T0MN3D 4XXXXX*5225 15 SEP XXXXXXXXXXXXXXXXX,3087.5,,3258659.87,AccountTransactionsReport(1).csv,1351,2024-09,False,Communication,Communication,Communication
,2024-09-17,8400/000 : FNB,120.00 OPENAI *CHAT 4XX*5191 14 SEP XX9868 120.00 OPENAI *CHAT 4XXXXX*5191 14 SEP XXXXXXXXXXXXXXXXXX,Account Payment,120.00 OPENAI *CHAT 4XX*5191 14 SEP XX9868 120.00 OPENAI *CHAT 4XXXXX*5191 14 SEP XXXXXXXXXXXXXXXXX,2182.88,,3260842.75,AccountTransactionsReport(1).csv,1352,2024-09,False,AI Services,AI Services,AI Services
,2024-09-17,8400/000 : FNB,20.00 RAILWAY 4XX*5191 14 SEP XX6380 20.00 RAILWAY 4XXXXX*5191 14 SEP XXXXXXXXXXXXXXXXXXX6380,Account Payment,20.00 RAILWAY 4XX*5191 14 SEP XX6380 20.00 RAILWAY 4XXXXX*5191 14 SEP XXXXXXXXXXXXXXXXXXX6380,363.81,,3261206.56,AccountTransactionsReport(1).csv,1353,2024-09,False,Other Computer Services,Other Computer Services,Other Computer Services
,2024-09-17,8400/000 : FNB,"Github Inc. 14.00 GITHUB, INC. 4XXXXX*5225 14 SEP XXXXXXXXXXXXXXXXXXX0544 Github Inc.",Account Payment,"Github Inc. 14.00 GITHUB, INC. 4XXXXX*5225 14 SEP XXXXXXXXXXXXXXXXXXX0544 Github Inc.",254.67,,3261461.23,AccountTransactionsReport(1).csv,1354,2024-09,False,Development Tools,Development Tools,Development Tools
,2024-09-17,8400/000 : FNB,Facebook 182.85 FACEBK *R9LP 4XXXXX*5191 15 SEP XXXXXXXXXXXXXXXXXXX4054 Facebook,Account Payment,Facebook 182.85 FACEBK *R9LP 4XXXXX*5191 15 SEP XXXXXXXXXXXXXXXXXXX4054 Facebook,182.85,,3261644.08,AccountTransactionsReport(1).csv,1355,2024-09,False,Marketing Tools,Marketing Tools,Marketing Tools
,2024-09-17,8400/000 : FNB,"59.38 REPLIT, INC. 4XX*5191 14 SEP XX1950 59.38 REPLIT, INC. 4XXXXX*5191 14 SEP XXXXXXXXXXXXXXXXXXX1",Account Payment,"59.38 REPLIT, INC. 4XX*5191 14 SEP XX1950 59.38 REPLIT, INC. 4XXXXX*5191 14 SEP XXXXXXXXXXXXXXXXXXX",1080.16,,3262724.24,AccountTransactionsReport(1).csv,1356,2024-09,False,Other Computer Services,Other Computer Services,Other Computer Services
,2024-09-17,8400/000 : FNB,49.91 FRAPPE CLOUD 4XX*5191 14 SEP XX5899 49.91 FRAPPE CLOUD 4XXXXX*5191 14 SEP XXXXXXXXXXXXXXXXXXX5,Account Payment,49.91 FRAPPE CLOUD 4XX*5191 14 SEP XX5899 49.91 FRAPPE CLOUD 4XXXXX*5191 14 SEP XXXXXXXXXXXXXXXXXXX,907.89,,3263632.13,AccountTransactionsReport(1).csv,1357,2024-09,False,Other Computer Services,Other Computer Services,Other Computer Services
,2024-09-17,8400/000 : FNB,Facebook 693.43 FACEBK *DT6B 4XXXXX*5191 15 SEP XXXXXXXXXXXXXXXXXXX2180 Facebook,Account Payment,Facebook 693.43 FACEBK *DT6B 4XXXXX*5191 15 SEP XXXXXXXXXXXXXXXXXXX2180 Facebook,693.43,,3264325.56,AccountTransactionsReport(1).csv,1358,2024-09,False,Marketing Tools,Marketing Tools,Marketing Tools
,2024-09-17,8400/000 : FNB,Intuit 546.25 INTUIT *QBoo 4XXXXX*5225 14 SEP XXXXXXXXXXXXXXXXXXX3895 Intuit,Account Payment,Intuit 546.25 INTUIT *QBoo 4XXXXX*5225 14 SEP XXXXXXXXXXXXXXXXXXX3895 Intuit,546.25,,3264871.81,AccountTransactionsReport(1).csv,1359,2024-09,False,Productivity Software,Productivity Software,Productivity Software
,2024-09-17,8400/000 : FNB,30.00 HASURA 4XX*5191 13 SEP XX6640 30.00 HASURA 4XXXXX*5191 13 SEP XXXXXXXXXXXXXXXXXXX6640,Account Payment,30.00 HASURA 4XX*5191 13 SEP XX6640 30.00 HASURA 4XXXXX*5191 13 SEP XXXXXXXXXXXXXXXXXXX6640,545.72,,3265417.53,AccountTransactionsReport(1).csv,1360,2024-09,False,Other Computer Services,Other Computer Services,Other Computer Services
,2024-09-17,8400/000 : FNB,20.00 RAILWAY 4XX*5191 14 SEP XX6503 20.00 RAILWAY 4XXXXX*5191 14 SEP XXXXXXXXXXXXXXXXXXX6503,Account Payment,20.00 RAILWAY 4XX*5191 14 SEP XX6503 20.00 RAILWAY 4XXXXX*5191 14 SEP XXXXXXXXXXXXXXXXXXX6503,363.81,,3265781.34,AccountTransactionsReport(1).csv,1361,2024-09,False,Other Computer Services,Other Computer Services,Other Computer Services
,2024-09-18,8400/000 : FNB,3336.00 HOLASPIRIT 4XXXXX*5225 15 SEP XXXXXXXXXXXXXXXXXXX3291 3336.00 HOLASPIRIT 4XXXXX*5225 15 SEP,Account Receipt,3336.00 HOLASPIRIT 4XXXXX*5225 15 SEP XXXXXXXXXXXXXXXXXXX3291 3336.00 HOLASPIRIT 4XXXXX*5225 15 SEP,,63849.88,3201931.46,AccountTransactionsReport(1).csv,1362,2024-09,False,Other Computer Services,Other Computer Services,Other Computer Services
,2024-09-18,8400/000 : FNB,3336.00 HOLASPIRIT 4XXXXX*5225 15 SEP XXXXXXXXXXXXXXXXXXX2408 3336.00 HOLASPIRIT 4XXXXX*5225 15 SEP,Account Receipt,3336.00 HOLASPIRIT 4XXXXX*5225 15 SEP XXXXXXXXXXXXXXXXXXX2408 3336.00 HOLASPIRIT 4XXXXX*5225 15 SEP,,63849.88,3138081.58,AccountTransactionsReport(1).csv,1363,2024-09,False,Other Computer Services,Other Computer Services,Other Computer Services
,2024-09-18,8400/000 : FNB,1028.82 HOLASPIRIT 4XX*5225 17 SEP XX2685 1028.82 HOLASPIRIT 4XXXXX*5225 17 SEP XXXXXXXXXXXXXXXXXXX2,Account Payment,1028.82 HOLASPIRIT 4XX*5225 17 SEP XX2685 1028.82 HOLASPIRIT 4XXXXX*5225 17 SEP XXXXXXXXXXXXXXXXXXX,20675.6,,3158757.18,AccountTransactionsReport(1).csv,1364,2024-09,False,Other Computer Services,Other Computer Services,Other Computer Services
,2024-09-18,8400/000 : FNB,633.99 HOLASPIRIT 4XX*5225 17 SEP XX9141 633.99 HOLASPIRIT 4XXXXX*5225 17 SEP XXXXXXXXXXXXXXXXXXX914,Account Payment,633.99 HOLASPIRIT 4XX*5225 17 SEP XX9141 633.99 HOLASPIRIT 4XXXXX*5225 17 SEP XXXXXXXXXXXXXXXXXXX91,12740.93,,3171498.11,AccountTransactionsReport(1).csv,1365,2024-09,False,Other Computer Services,Other Computer Services,Other Computer Services
,2024-09-19,8400/000 : FNB,"99.00 PLAYFAB, INC. 4XX*5191 17 SEP XX5490 99.00 PLAYFAB, INC. 4XXXXX*5191 17 SEP XXXXXXXXXXXXXXXXXX",Account Payment,"99.00 PLAYFAB, INC. 4XX*5191 17 SEP XX5490 99.00 PLAYFAB, INC. 4XXXXX*5191 17 SEP XXXXXXXXXXXXXXXXX",1794.78,,3173292.89,AccountTransactionsReport(1).csv,1366,2024-09,False,Other Computer Services,Other Computer Services,Other Computer Services
,2024-09-21,8400/000 : FNB,59.00 GREENBACK.COM 4XX*5225 19 SEP XX3462 59.00 GREENBACK.COM 4XXXXX*5225 19 SEP XXXXXXXXXXXXXXXXXX,Account Payment,59.00 GREENBACK.COM 4XX*5225 19 SEP XX3462 59.00 GREENBACK.COM 4XXXXX*5225 19 SEP XXXXXXXXXXXXXXXXX,1062.4,,3174355.29,AccountTransactionsReport(1).csv,1367,2024-09,False,Other Computer Services,Other Computer Services,Other Computer Services
,2024-09-23,8400/000 : FNB,"74.00 PIPEDREAM, IN 4XX*5191 20 SEP XX6096 74.00 PIPEDREAM, IN 4XXXXX*5191 20 SEP XXXXXXXXXXXXXXXXXX",Account Payment,"74.00 PIPEDREAM, IN 4XX*5191 20 SEP XX6096 74.00 PIPEDREAM, IN 4XXXXX*5191 20 SEP XXXXXXXXXXXXXXXXX",1331.28,,3175686.57,AccountTransactionsReport(1).csv,1368,2024-09,False,Other Computer Services,Other Computer Services,Other Computer Services
,2024-09-23,8400/000 : FNB,54.00 AIRTABLE.COM/ 4XX*5191 21 SEP XX6622 54.00 AIRTABLE.COM/ 4XXXXX*5191 21 SEP XXXXXXXXXXXXXXXXXX,Account Payment,54.00 AIRTABLE.COM/ 4XX*5191 21 SEP XX6622 54.00 AIRTABLE.COM/ 4XXXXX*5191 21 SEP XXXXXXXXXXXXXXXXX,969.41,,3176655.98,AccountTransactionsReport(1).csv,1369,2024-09,False,Other Computer Services,Collaboration Tools,Collaboration Tools
,2024-09-25,8400/000 : FNB,299.00 ORG CHART 4XX*5191 22 SEP XX3450 299.00 ORG CHART 4XXXXX*5191 22 SEP XXXXXXXXXXXXXXXXXXX3450,Account Payment,299.00 ORG CHART 4XX*5191 22 SEP XX3450 299.00 ORG CHART 4XXXXX*5191 22 SEP XXXXXXXXXXXXXXXXXXX3450,5367.65,,3182023.63,AccountTransactionsReport(1).csv,1370,2024-09,False,Other Computer Services,Other Computer Services,Other Computer Services
,2024-09-25,8400/000 : FNB,"140.00 NOTION LABS, 4XX*5191 23 SEP XX2354 140.00 NOTION LABS, 4XXXXX*5191 23 SEP XXXXXXXXXXXXXXXXXX",Account Payment,"140.00 NOTION LABS, 4XX*5191 23 SEP XX2354 140.00 NOTION LABS, 4XXXXX*5191 23 SEP XXXXXXXXXXXXXXXXX",2513.28,,3184536.91,AccountTransactionsReport(1).csv,1371,2024-09,False,Other Computer Services,Collaboration Tools,Collaboration Tools
,2024-09-25,8400/000 : FNB,89.00 SENTRY 4XX*5191 24 SEP XX9774 89.00 SENTRY 4XXXXX*5191 24 SEP XXXXXXXXXXXXXXXXXXX9774,Account Payment,89.00 SENTRY 4XX*5191 24 SEP XX9774 89.00 SENTRY 4XXXXX*5191 24 SEP XXXXXXXXXXXXXXXXXXX9774,1586.83,,3186123.74,AccountTransactionsReport(1).csv,1372,2024-09,False,Other Computer Services,Analytics & Monitoring,Analytics & Monitoring
,2024-09-25,8400/000 : FNB,Shopify 43.00 SHOPIFY* 2768 4XXXXX*5191 23 SEP XXXXXXXXXXXXXXXXXXX1524 Shopify,Account Payment,Shopify 43.00 SHOPIFY* 2768 4XXXXX*5191 23 SEP XXXXXXXXXXXXXXXXXXX1524 Shopify,771.94,,3186895.68,AccountTransactionsReport(1).csv,1373,2024-09,False,E-commerce Platforms,E-commerce Platforms,E-commerce Platforms
,2024-09-25,8400/000 : FNB,Shopify 37.00 SHOPIFY* 2764 4XXXXX*5191 23 SEP XXXXXXXXXXXXXXXXXXX8044 Shopify,Account Payment,Shopify 37.00 SHOPIFY* 2764 4XXXXX*5191 23 SEP XXXXXXXXXXXXXXXXXXX8044 Shopify,664.22,,3187559.9,AccountTransactionsReport(1).csv,1374,2024-09,False,E-commerce Platforms,E-commerce Platforms,E-commerce Platforms
,2024-09-25,8400/000 : FNB,Shopify 37.00 SHOPIFY* 2764 4XXXXX*5191 23 SEP XXXXXXXXXXXXXXXXXXX0114 Shopify,Account Payment,Shopify 37.00 SHOPIFY* 2764 4XXXXX*5191 23 SEP XXXXXXXXXXXXXXXXXXX0114 Shopify,664.22,,3188224.12,AccountTransactionsReport(1).csv,1375,2024-09,False,E-commerce Platforms,E-commerce Platforms,E-commerce Platforms
,2024-09-25,8400/000 : FNB,Shopify 37.00 SHOPIFY* 2764 4XXXXX*5191 23 SEP XXXXXXXXXXXXXXXXXXX6880 Shopify,Account Payment,Shopify 37.00 SHOPIFY* 2764 4XXXXX*5191 23 SEP XXXXXXXXXXXXXXXXXXX6880 Shopify,664.22,,3188888.34,AccountTransactionsReport(1).csv,1376,2024-09,False,E-commerce Platforms,E-commerce Platforms,E-commerce Platforms
,2024-09-25,8400/000 : FNB,Shopify 37.00 SHOPIFY* 2764 4XXXXX*5191 22 SEP XXXXXXXXXXXXXXXXXXX2271 Shopify,Account Payment,Shopify 37.00 SHOPIFY* 2764 4XXXXX*5191 22 SEP XXXXXXXXXXXXXXXXXXX2271 Shopify,664.22,,3189552.56,AccountTransactionsReport(1).csv,1377,2024-09,False,E-commerce Platforms,E-commerce Platforms,E-commerce Platforms
,2024-09-25,8400/000 : FNB,Shopify 37.00 SHOPIFY* 2765 4XXXXX*5191 23 SEP XXXXXXXXXXXXXXXXXXX0162 Shopify,Account Payment,Shopify 37.00 SHOPIFY* 2765 4XXXXX*5191 23 SEP XXXXXXXXXXXXXXXXXXX0162 Shopify,664.22,,3190216.78,AccountTransactionsReport(1).csv,1378,2024-09,False,E-commerce Platforms,E-commerce Platforms,E-commerce Platforms
,2024-09-25,8400/000 : FNB,Shopify 37.00 SHOPIFY* 2767 4XXXXX*5191 23 SEP XXXXXXXXXXXXXXXXXXX5317 Shopify,Account Payment,Shopify 37.00 SHOPIFY* 2767 4XXXXX*5191 23 SEP XXXXXXXXXXXXXXXXXXX5317 Shopify,664.22,,3190881.0,AccountTransactionsReport(1).csv,1379,2024-09,False,E-commerce Platforms,E-commerce Platforms,E-commerce Platforms
,2024-09-25,8400/000 : FNB,30.00 HASURA 4XX*5191 23 SEP XX0406 30.00 HASURA 4XXXXX*5191 23 SEP XXXXXXXXXXXXXXXXXXX0406,Account Payment,30.00 HASURA 4XX*5191 23 SEP XX0406 30.00 HASURA 4XXXXX*5191 23 SEP XXXXXXXXXXXXXXXXXXX0406,534.89,,3191415.89,AccountTransactionsReport(1).csv,1380,2024-09,False,Other Computer Services,Other Computer Services,Other Computer Services
,2024-09-25,8400/000 : FNB,Shopify 25.00 SHOPIFY* 2768 4XXXXX*5191 23 SEP XXXXXXXXXXXXXXXXXXX1313 Shopify,Account Payment,Shopify 25.00 SHOPIFY* 2768 4XXXXX*5191 23 SEP XXXXXXXXXXXXXXXXXXX1313 Shopify,448.8,,3191864.69,AccountTransactionsReport(1).csv,1381,2024-09,False,E-commerce Platforms,E-commerce Platforms,E-commerce Platforms
,2024-09-25,8400/000 : FNB,Shopify 15.00 SHOPIFY* 2764 4XXXXX*5191 22 SEP XXXXXXXXXXXXXXXXXXX1570 Shopify,Account Payment,Shopify 15.00 SHOPIFY* 2764 4XXXXX*5191 22 SEP XXXXXXXXXXXXXXXXXXX1570 Shopify,269.28,,3192133.97,AccountTransactionsReport(1).csv,1382,2024-09,False,E-commerce Platforms,E-commerce Platforms,E-commerce Platforms
,2024-09-25,8400/000 : FNB,"6.00 DOCKER, INC. 4XX*5191 24 SEP XX2274 6.00 DOCKER, INC. 4XXXXX*5191 24 SEP XXXXXXXXXXXXXXXXXXX227",Account Payment,"6.00 DOCKER, INC. 4XX*5191 24 SEP XX2274 6.00 DOCKER, INC. 4XXXXX*5191 24 SEP XXXXXXXXXXXXXXXXXXX22",106.98,,3192240.95,AccountTransactionsReport(1).csv,1383,2024-09,False,Other Computer Services,Other Computer Services,Other Computer Services
,2024-09-26,8400/000 : FNB,Dropbox 18.38 DROPBOX*8GVP6 4XXXXX*5191 24 SEP XXXXXXXXXXXXXXXXXXX0448 Dropbox,Account Payment,Dropbox 18.38 DROPBOX*8GVP6 4XXXXX*5191 24 SEP XXXXXXXXXXXXXXXXXXX0448 Dropbox,327.71,,3192568.66,AccountTransactionsReport(1).csv,1384,2024-09,False,Other Computer Services,Other Computer Services,Other Computer Services
,2024-09-26,8400/000 : FNB,10.00 MATTERMOST 4XX*5191 24 SEP XX1137 10.00 MATTERMOST 4XXXXX*5191 24 SEP XXXXXXXXXXXXXXXXXXX1137,Account Payment,10.00 MATTERMOST 4XX*5191 24 SEP XX1137 10.00 MATTERMOST 4XXXXX*5191 24 SEP XXXXXXXXXXXXXXXXXXX1137,177.4,,3192746.06,AccountTransactionsReport(1).csv,1385,2024-09,False,Other Computer Services,Other Computer Services,Other Computer Services
,2024-09-27,8400/000 : FNB,BT Group BOB GROUP 4XXXXX*5191 24 SEP XXXXXXXXXXXXXXXXXXX1518 BT Group,Account Payment,BT Group BOB GROUP 4XXXXX*5191 24 SEP XXXXXXXXXXXXXXXXXXX1518 BT Group,2298.85,,3195044.91,AccountTransactionsReport(1).csv,1386,2024-09,False,Other Computer Services,Other Computer Services,Other Computer Services
,2024-09-27,8400/000 : FNB,27.60 LEMSQZY* CODE 4XX*5191 25 SEP XX2974 27.60 LEMSQZY* CODE 4XXXXX*5191 25 SEP XXXXXXXXXXXXXXXXXX,Account Payment,27.60 LEMSQZY* CODE 4XX*5191 25 SEP XX2974 27.60 LEMSQZY* CODE 4XXXXX*5191 25 SEP XXXXXXXXXXXXXXXXX,489.62,,3195534.53,AccountTransactionsReport(1).csv,1387,2024-09,False,AI Services,AI Services,AI Services
,2024-09-27,8400/000 : FNB,399.99 POE.COM 4XX*5191 26 SEP XX1799 399.99 POE.COM 4XXXXX*5191 26 SEP XXXXXXXXXXXXXXXXXXX1799,Account Payment,399.99 POE.COM 4XX*5191 26 SEP XX1799 399.99 POE.COM 4XXXXX*5191 26 SEP XXXXXXXXXXXXXXXXXXX1799,399.99,,3195934.52,AccountTransactionsReport(1).csv,1388,2024-09,False,Other Computer Services,Other Computer Services,Other Computer Services
,2024-09-27,8400/000 : FNB,150.00 AUTH0.COM 4XX*5191 25 SEP XX2241 150.00 AUTH0.COM 4XXXXX*5191 25 SEP XXXXXXXXXXXXXXXXXXX2241,Account Payment,150.00 AUTH0.COM 4XX*5191 25 SEP XX2241 150.00 AUTH0.COM 4XXXXX*5191 25 SEP XXXXXXXXXXXXXXXXXXX2241,2660.99,,3198595.51,AccountTransactionsReport(1).csv,1389,2024-09,False,Security Services,Security Services,Security Services
,2024-09-28,8400/000 : FNB,20.00 HUGGINGFACE 4XX*5191 27 SEP XX9619 20.00 HUGGINGFACE 4XXXXX*5191 27 SEP XXXXXXXXXXXXXXXXXXX961,Account Payment,20.00 HUGGINGFACE 4XX*5191 27 SEP XX9619 20.00 HUGGINGFACE 4XXXXX*5191 27 SEP XXXXXXXXXXXXXXXXXXX96,353.55,,3198949.06,AccountTransactionsReport(1).csv,1390,2024-09,False,AI Services,AI Services,AI Services
,2024-09-30,8400/000 : FNB,Shopify 28.00 SHOPIFY* 2786 4XXXXX*5191 27 SEP XXXXXXXXXXXXXXXXXXX4554 Shopify,Account Payment,Shopify 28.00 SHOPIFY* 2786 4XXXXX*5191 27 SEP XXXXXXXXXXXXXXXXXXX4554 Shopify,494.97,,3199444.03,AccountTransactionsReport(1).csv,1391,2024-09,False,E-commerce Platforms,E-commerce Platforms,E-commerce Platforms
,2024-09-30,8400/000 : FNB,Adobe Systems 22.99 Adobe 4XXXXX*5191 28 SEP XXXXXXXXXXXXXXXXXXX9556 Adobe Systems,Account Payment,Adobe Systems 22.99 Adobe 4XXXXX*5191 28 SEP XXXXXXXXXXXXXXXXXXX9556 Adobe Systems,406.41,,3199850.44,AccountTransactionsReport(1).csv,1392,2024-09,False,Productivity Software,Productivity Software,Productivity Software
,2024-10-01,8400/000 : FNB,9.00 GITPOD.IO 4XX*5191 28 SEP XX4180 9.00 GITPOD.IO 4XXXXX*5191 28 SEP XXXXXXXXXXXXXXXXXXX4180,Account Payment,9.00 GITPOD.IO 4XX*5191 28 SEP XX4180 9.00 GITPOD.IO 4XXXXX*5191 28 SEP XXXXXXXXXXXXXXXXXXX4180,158.39,,3200008.83,AccountTransactionsReport(1).csv,1393,2024-10,False,Development Tools,Development Tools,Development Tools
,2024-10-01,8400/000 : FNB,Canva 141.99 CANVA* I0428 4XXXXX*5225 29 SEP XXXXXXXXXXXXXXXXXXX5982 Canva,Account Payment,Canva 141.99 CANVA* I0428 4XXXXX*5225 29 SEP XXXXXXXXXXXXXXXXXXX5982 Canva,141.99,,3200150.82,AccountTransactionsReport(1).csv,1394,2024-10,False,Other Computer Services,Design Tools,Design Tools
,2024-10-01,8400/000 : FNB,5.00 COMPONENTS.STU 4XX*5191 29 SEP XX8889 5.00 COMPONENTS.STU 4XXXXX*5191 29 SEP XXXXXXXXXXXXXXXXXX,Account Payment,5.00 COMPONENTS.STU 4XX*5191 29 SEP XX8889 5.00 COMPONENTS.STU 4XXXXX*5191 29 SEP XXXXXXXXXXXXXXXXX,88.0,,3200238.82,AccountTransactionsReport(1).csv,1395,2024-10,False,Other Computer Services,Other Computer Services,Other Computer Services
,2024-10-01,8400/000 : FNB,Google 298.08 GOOGLE*GSUIT 4XXXXX*5191 28 SEP XXXXXXXXXXXXXXXXXXX3509 Google,Account Payment,Google 298.08 GOOGLE*GSUIT 4XXXXX*5191 28 SEP XXXXXXXXXXXXXXXXXXX3509 Google,5245.84,,3205484.66,AccountTransactionsReport(1).csv,1396,2024-10,False,Other Computer Services,Analytics & Monitoring,Analytics & Monitoring
,2024-10-01,8400/000 : FNB,5050.80 FRESHWORKS 4XX*5225 29 SEP XX0394 5050.80 FRESHWORKS 4XXXXX*5225 29 SEP XXXXXXXXXXXXXXXXXXX0,Account Payment,5050.80 FRESHWORKS 4XX*5225 29 SEP XX0394 5050.80 FRESHWORKS 4XXXXX*5225 29 SEP XXXXXXXXXXXXXXXXXXX,5050.8,,3210535.46,AccountTransactionsReport(1).csv,1397,2024-10,False,Productivity Software,Productivity Software,Productivity Software
,2024-10-01,8400/000 : FNB,29.99 BEENVERIFIED 4XX*5191 28 SEP XX2017 29.99 BEENVERIFIED 4XXXXX*5191 28 SEP XXXXXXXXXXXXXXXXXXX2,Account Payment,29.99 BEENVERIFIED 4XX*5191 28 SEP XX2017 29.99 BEENVERIFIED 4XXXXX*5191 28 SEP XXXXXXXXXXXXXXXXXXX,527.79,,3211063.25,AccountTransactionsReport(1).csv,1398,2024-10,False,Other Computer Services,Other Computer Services,Other Computer Services
,2024-10-01,8400/000 : FNB,268.80 SQSP* INV151 4XX*5191 29 SEP XX7738 268.80 SQSP* INV151 4XXXXX*5191 29 SEP XXXXXXXXXXXXXXXXXX,Account Payment,268.80 SQSP* INV151 4XX*5191 29 SEP XX7738 268.80 SQSP* INV151 4XXXXX*5191 29 SEP XXXXXXXXXXXXXXXXX,268.8,,3211332.05,AccountTransactionsReport(1).csv,1399,2024-10,False,Other Computer Services,Other Computer Services,Other Computer Services
,2024-10-01,8400/000 : FNB,268.80 SQSP* INV151 4XX*5191 29 SEP XX7670 268.80 SQSP* INV151 4XXXXX*5191 29 SEP XXXXXXXXXXXXXXXXXX,Account Payment,268.80 SQSP* INV151 4XX*5191 29 SEP XX7670 268.80 SQSP* INV151 4XXXXX*5191 29 SEP XXXXXXXXXXXXXXXXX,268.8,,3211600.85,AccountTransactionsReport(1).csv,1400,2024-10,False,Other Computer Services,Other Computer Services,Other Computer Services
,2024-10-02,8400/000 : FNB,119.94 CLINICSOFTWA 4XX*5225 30 SEP XX7033 119.94 CLINICSOFTWA 4XXXXX*5225 30 SEP XXXXXXXXXXXXXXXXXX,Account Payment,119.94 CLINICSOFTWA 4XX*5225 30 SEP XX7033 119.94 CLINICSOFTWA 4XXXXX*5225 30 SEP XXXXXXXXXXXXXXXXX,2827.41,,3214428.26,AccountTransactionsReport(1).csv,1401,2024-10,False,Other Computer Services,Other Computer Services,Other Computer Services
,2024-10-02,8400/000 : FNB,Digitalocean 47.84 DIGITALOCEAN. 4XXXXX*5191 01 OCT XXXXXXXXXXXXXXXXXXX7200 Digitalocean,Account Payment,Digitalocean 47.84 DIGITALOCEAN. 4XXXXX*5191 01 OCT XXXXXXXXXXXXXXXXXXX7200 Digitalocean,844.99,,3215273.25,AccountTransactionsReport(1).csv,1402,2024-10,False,Cloud Services,Cloud Services,Cloud Services
,2024-10-02,8400/000 : FNB,45.09 FRAPPE CLOUD 4XX*5191 30 SEP XX0906 45.09 FRAPPE CLOUD 4XXXXX*5191 30 SEP XXXXXXXXXXXXXXXXXXX0,Account Payment,45.09 FRAPPE CLOUD 4XX*5191 30 SEP XX0906 45.09 FRAPPE CLOUD 4XXXXX*5191 30 SEP XXXXXXXXXXXXXXXXXXX,793.53,,3216066.78,AccountTransactionsReport(1).csv,1403,2024-10,False,Other Computer Services,Other Computer Services,Other Computer Services
,2024-10-02,8400/000 : FNB,28.88 KLINGAI.COM 4XX*5191 01 OCT XX9405 28.88 KLINGAI.COM 4XXXXX*5191 01 OCT XXXXXXXXXXXXXXXXXXX940,Account Payment,28.88 KLINGAI.COM 4XX*5191 01 OCT XX9405 28.88 KLINGAI.COM 4XXXXX*5191 01 OCT XXXXXXXXXXXXXXXXXXX94,510.1,,3216576.88,AccountTransactionsReport(1).csv,1404,2024-10,False,Other Computer Services,Other Computer Services,Other Computer Services
,2024-10-03,8400/000 : FNB,7.00 GLASSFROG 4XX*5191 01 OCT XX5608 7.00 GLASSFROG 4XXXXX*5191 01 OCT XXXXXXXXXXXXXXXXXXX5608,Account Payment,7.00 GLASSFROG 4XX*5191 01 OCT XX5608 7.00 GLASSFROG 4XXXXX*5191 01 OCT XXXXXXXXXXXXXXXXXXX5608,123.64,,3216700.52,AccountTransactionsReport(1).csv,1405,2024-10,False,Other Computer Services,Other Computer Services,Other Computer Services
,2024-10-03,8400/000 : FNB,7.00 GLASSFROG 4XX*5191 01 OCT XX8037 7.00 GLASSFROG 4XXXXX*5191 01 OCT XXXXXXXXXXXXXXXXXXX8037,Account Payment,7.00 GLASSFROG 4XX*5191 01 OCT XX8037 7.00 GLASSFROG 4XXXXX*5191 01 OCT XXXXXXXXXXXXXXXXXXX8037,123.64,,3216824.16,AccountTransactionsReport(1).csv,1406,2024-10,False,Other Computer Services,Other Computer Services,Other Computer Services
,2024-10-03,8400/000 : FNB,Facebook 4.60 FACEBK *84PL3B 4XXXXX*5191 01 OCT XXXXXXXXXXXXXXXXXXX9093 Facebook,Account Payment,Facebook 4.60 FACEBK *84PL3B 4XXXXX*5191 01 OCT XXXXXXXXXXXXXXXXXXX9093 Facebook,81.25,,3216905.41,AccountTransactionsReport(1).csv,1407,2024-10,False,Marketing Tools,Marketing Tools,Marketing Tools
,2024-10-03,8400/000 : FNB,134.00 SINCH MAILGU 4XX*5191 01 OCT XX6443 134.00 SINCH MAILGU 4XXXXX*5191 01 OCT XXXXXXXXXXXXXXXXXX,Account Payment,134.00 SINCH MAILGU 4XX*5191 01 OCT XX6443 134.00 SINCH MAILGU 4XXXXX*5191 01 OCT XXXXXXXXXXXXXXXXX,2366.82,,3219272.23,AccountTransactionsReport(1).csv,1408,2024-10,False,Other Computer Services,Other Computer Services,Other Computer Services
,2024-10-03,8400/000 : FNB,Google Store 79.64 Google GSUITE 4XXXXX*5191 02 OCT XXXXXXXXXXXXXXXXXXX1085 Google Store,Account Payment,Google Store 79.64 Google GSUITE 4XXXXX*5191 02 OCT XXXXXXXXXXXXXXXXXXX1085 Google Store,1569.68,,3220841.91,AccountTransactionsReport(1).csv,1409,2024-10,False,Other Computer Services,Analytics & Monitoring,Analytics & Monitoring
,2024-10-03,8400/000 : FNB,Google Store 79.64 Google GSUITE 4XXXXX*5225 02 OCT XXXXXXXXXXXXXXXXXXX3085 Google Store,Account Payment,Google Store 79.64 Google GSUITE 4XXXXX*5225 02 OCT XXXXXXXXXXXXXXXXXXX3085 Google Store,1569.68,,3222411.59,AccountTransactionsReport(1).csv,1410,2024-10,False,Other Computer Services,Analytics & Monitoring,Analytics & Monitoring
,2024-10-03,8400/000 : FNB,67.85 LEMSQZY* CHAT 4XX*5191 01 OCT XX0564 67.85 LEMSQZY* CHAT 4XXXXX*5191 01 OCT XXXXXXXXXXXXXXXXXX,Account Payment,67.85 LEMSQZY* CHAT 4XX*5191 01 OCT XX0564 67.85 LEMSQZY* CHAT 4XXXXX*5191 01 OCT XXXXXXXXXXXXXXXXX,1198.42,,3223610.01,AccountTransactionsReport(1).csv,1411,2024-10,False,AI Services,AI Services,AI Services
,2024-10-03,8400/000 : FNB,Facebook 23.00 FACEBK *5UG6E 4XXXXX*5191 01 OCT XXXXXXXXXXXXXXXXXXX4096 Facebook,Account Payment,Facebook 23.00 FACEBK *5UG6E 4XXXXX*5191 01 OCT XXXXXXXXXXXXXXXXXXX4096 Facebook,406.25,,3224016.26,AccountTransactionsReport(1).csv,1412,2024-10,False,Marketing Tools,Marketing Tools,Marketing Tools
,2024-10-03,8400/000 : FNB,Slack & Co 17.25 SLACK T06A3T4 4XXXXX*5191 01 OCT XXXXXXXXXXXXXXXXXXX8460 Slack & Co,Account Payment,Slack & Co 17.25 SLACK T06A3T4 4XXXXX*5191 01 OCT XXXXXXXXXXXXXXXXXXX8460 Slack & Co,304.68,,3224320.94,AccountTransactionsReport(1).csv,1413,2024-10,False,Communication,Communication,Communication
,2024-10-03,8400/000 : FNB,Facebook 13.80 FACEBK *YNGP7 4XXXXX*5191 01 OCT XXXXXXXXXXXXXXXXXXX8086 Facebook,Account Payment,Facebook 13.80 FACEBK *YNGP7 4XXXXX*5191 01 OCT XXXXXXXXXXXXXXXXXXX8086 Facebook,243.75,,3224564.69,AccountTransactionsReport(1).csv,1414,2024-10,False,Marketing Tools,Marketing Tools,Marketing Tools
,2024-10-03,8400/000 : FNB,1043.07 CLOUD WFZGW 4XX*5191 01 OCT XX8048 1043.07 CLOUD WFZGW 4XXXXX*5191 01 OCT XXXXXXXXXXXXXXXXXX,Account Payment,1043.07 CLOUD WFZGW 4XX*5191 01 OCT XX8048 1043.07 CLOUD WFZGW 4XXXXX*5191 01 OCT XXXXXXXXXXXXXXXXX,18423.57,,3242988.26,AccountTransactionsReport(1).csv,1415,2024-10,False,Other Computer Services,Other Computer Services,Other Computer Services
,2024-10-03,8400/000 : FNB,Google Store 391.60 Google GSUIT 4XXXXX*5225 01 OCT XXXXXXXXXXXXXXXXXXX3050 Google Store,Account Payment,Google Store 391.60 Google GSUIT 4XXXXX*5225 01 OCT XXXXXXXXXXXXXXXXXXX3050 Google Store,7717.62,,3250705.88,AccountTransactionsReport(1).csv,1416,2024-10,False,Other Computer Services,Analytics & Monitoring,Analytics & Monitoring
,2024-10-03,8400/000 : FNB,Google Store 298.08 GOOGLE*GSUIT 4XXXXX*5191 01 OCT XXXXXXXXXXXXXXXXXXX1094 Google Store,Account Payment,Google Store 298.08 GOOGLE*GSUIT 4XXXXX*5191 01 OCT XXXXXXXXXXXXXXXXXXX1094 Google Store,5264.93,,3255970.81,AccountTransactionsReport(1).csv,1417,2024-10,False,Other Computer Services,Analytics & Monitoring,Analytics & Monitoring
,2024-10-03,8400/000 : FNB,"Wix.com 182.85 Wix.Com, Inc 4XXXXX*5191 02 OCT XXXXXXXXXXXXXXXXXXX5073 Wix.com",Account Payment,"Wix.com 182.85 Wix.Com, Inc 4XXXXX*5191 02 OCT XXXXXXXXXXXXXXXXXXX5073 Wix.com",3217.94,,3259188.75,AccountTransactionsReport(1).csv,1418,2024-10,False,E-commerce Platforms,E-commerce Platforms,E-commerce Platforms
,2024-10-04,8400/000 : FNB,"Github Inc. 352.30 GITHUB, INC. 4XXXXX*5191 02 OCT XXXXXXXXXXXXXXXXXXX3863 Github Inc.",Account Payment,"Github Inc. 352.30 GITHUB, INC. 4XXXXX*5191 02 OCT XXXXXXXXXXXXXXXXXXX3863 Github Inc.",6289.27,,3265478.02,AccountTransactionsReport(1).csv,1419,2024-10,False,Development Tools,Development Tools,Development Tools
,2024-10-04,8400/000 : FNB,BT Group BOB GROUP 4XXXXX*5191 01 OCT XXXXXXXXXXXXXXXXXXX2741 BT Group,Account Payment,BT Group BOB GROUP 4XXXXX*5191 01 OCT XXXXXXXXXXXXXXXXXXX2741 BT Group,2298.85,,3267776.87,AccountTransactionsReport(1).csv,1420,2024-10,False,Other Computer Services,Other Computer Services,Other Computer Services
,2024-10-04,8400/000 : FNB,"Github Inc. 6.30 GITHUB, INC. 4XXXXX*5191 02 OCT XXXXXXXXXXXXXXXXXXX8712 Github Inc.",Account Payment,"Github Inc. 6.30 GITHUB, INC. 4XXXXX*5191 02 OCT XXXXXXXXXXXXXXXXXXX8712 Github Inc.",112.47,,3267889.34,AccountTransactionsReport(1).csv,1421,2024-10,False,Development Tools,Development Tools,Development Tools
,2024-10-04,8400/000 : FNB,450.00 WAPPALYZER 4XX*5191 02 OCT XX2731 450.00 WAPPALYZER 4XXXXX*5191 02 OCT XXXXXXXXXXXXXXXXXXX273,Account Payment,450.00 WAPPALYZER 4XX*5191 02 OCT XX2731 450.00 WAPPALYZER 4XXXXX*5191 02 OCT XXXXXXXXXXXXXXXXXXX27,8033.41,,3275922.75,AccountTransactionsReport(1).csv,1422,2024-10,False,Other Computer Services,Other Computer Services,Other Computer Services
,2024-10-05,8400/000 : FNB,920.00 AUTH0.COM 4XX*5191 03 OCT XX9940 920.00 AUTH0.COM 4XXXXX*5191 03 OCT XXXXXXXXXXXXXXXXXXX9940,Account Payment,920.00 AUTH0.COM 4XX*5191 03 OCT XX9940 920.00 AUTH0.COM 4XXXXX*5191 03 OCT XXXXXXXXXXXXXXXXXXX9940,16415.7,,3292338.45,AccountTransactionsReport(1).csv,1423,2024-10,False,Security Services,Security Services,Security Services
,2024-10-05,8400/000 : FNB,Stable 249.00 STABLE 4XXXXX*5191 04 OCT XXXXXXXXXXXXXXXXXXX3763 Stable,Account Payment,Stable 249.00 STABLE 4XXXXX*5191 04 OCT XXXXXXXXXXXXXXXXXXX3763 Stable,4462.52,,3296800.97,AccountTransactionsReport(1).csv,1424,2024-10,False,Other Computer Services,Other Computer Services,Other Computer Services
,2024-10-05,8400/000 : FNB,179.00 MOZSEO:HELP@ 4XX*5191 03 OCT XX5829 179.00 MOZSEO:HELP@ 4XXXXX*5191 03 OCT XXXXXXXXXXXXXXXXXX,Account Payment,179.00 MOZSEO:HELP@ 4XX*5191 03 OCT XX5829 179.00 MOZSEO:HELP@ 4XXXXX*5191 03 OCT XXXXXXXXXXXXXXXXX,3193.93,,3299994.9,AccountTransactionsReport(1).csv,1425,2024-10,False,Other Computer Services,Other Computer Services,Other Computer Services
,2024-10-05,8400/000 : FNB,99.00 DMNS.APP BUSI 4XX*5191 04 OCT XX9959 99.00 DMNS.APP BUSI 4XXXXX*5191 04 OCT XXXXXXXXXXXXXXXXXX,Account Payment,99.00 DMNS.APP BUSI 4XX*5191 04 OCT XX9959 99.00 DMNS.APP BUSI 4XXXXX*5191 04 OCT XXXXXXXXXXXXXXXXX,1774.26,,3301769.16,AccountTransactionsReport(1).csv,1426,2024-10,False,Other Computer Services,Other Computer Services,Other Computer Services
,2024-10-05,8400/000 : FNB,60.18 PADDLE.NET* W 4XX*5191 04 OCT XX1790 60.18 PADDLE.NET* W 4XXXXX*5191 04 OCT XXXXXXXXXXXXXXXXXX,Account Payment,60.18 PADDLE.NET* W 4XX*5191 04 OCT XX1790 60.18 PADDLE.NET* W 4XXXXX*5191 04 OCT XXXXXXXXXXXXXXXXX,1078.53,,3302847.69,AccountTransactionsReport(1).csv,1427,2024-10,False,Other Computer Services,Subscription Management,Subscription Management
,2024-10-05,8400/000 : FNB,60.00 INSOMNIA TEAM 4XX*5191 03 OCT XX6193 60.00 INSOMNIA TEAM 4XXXXX*5191 03 OCT XXXXXXXXXXXXXXXXXX,Account Payment,60.00 INSOMNIA TEAM 4XX*5191 03 OCT XX6193 60.00 INSOMNIA TEAM 4XXXXX*5191 03 OCT XXXXXXXXXXXXXXXXX,1075.3,,3303922.99,AccountTransactionsReport(1).csv,1428,2024-10,False,Other Computer Services,Other Computer Services,Other Computer Services
,2024-10-07,8400/000 : FNB,"Github Inc. 19.00 GITHUB, INC. 4XXXXX*5225 04 OCT XXXXXXXXXXXXXXXXXXX1311 Github Inc.",Account Payment,"Github Inc. 19.00 GITHUB, INC. 4XXXXX*5225 04 OCT XXXXXXXXXXXXXXXXXXX1311 Github Inc.",340.52,,3304263.51,AccountTransactionsReport(1).csv,1429,2024-10,False,Development Tools,Development Tools,Development Tools
,2024-10-07,8400/000 : FNB,"Github Inc. 11.08 GITHUB, INC. 4XXXXX*5225 04 OCT XXXXXXXXXXXXXXXXXXX7660 Github Inc.",Account Payment,"Github Inc. 11.08 GITHUB, INC. 4XXXXX*5225 04 OCT XXXXXXXXXXXXXXXXXXX7660 Github Inc.",198.57,,3304462.08,AccountTransactionsReport(1).csv,1430,2024-10,False,Development Tools,Development Tools,Development Tools
,2024-10-07,8400/000 : FNB,Shopify 2058.98 SHOPIFY* 28 4XXXXX*5191 04 OCT XXXXXXXXXXXXXXXXXXX2908 Shopify,Account Payment,Shopify 2058.98 SHOPIFY* 28 4XXXXX*5191 04 OCT XXXXXXXXXXXXXXXXXXX2908 Shopify,36900.58,,3341362.66,AccountTransactionsReport(1).csv,1431,2024-10,False,E-commerce Platforms,E-commerce Platforms,E-commerce Platforms
,2024-10-07,8400/000 : FNB,1499.00 APPDIRECT 4XX*5225 04 OCT XX6762 1499.00 APPDIRECT 4XXXXX*5225 04 OCT XXXXXXXXXXXXXXXXXXX676,Account Payment,1499.00 APPDIRECT 4XX*5225 04 OCT XX6762 1499.00 APPDIRECT 4XXXXX*5225 04 OCT XXXXXXXXXXXXXXXXXXX67,26864.74,,3368227.4,AccountTransactionsReport(1).csv,1432,2024-10,False,Other Computer Services,Other Computer Services,Other Computer Services
,2024-10-07,8400/000 : FNB,Google Store 167.92 Google GSUIT 4XXXXX*5225 05 OCT XXXXXXXXXXXXXXXXXXX3089 Google Store,Account Payment,Google Store 167.92 Google GSUIT 4XXXXX*5225 05 OCT XXXXXXXXXXXXXXXXXXX3089 Google Store,3314.48,,3371541.88,AccountTransactionsReport(1).csv,1433,2024-10,False,Other Computer Services,Analytics & Monitoring,Analytics & Monitoring
,2024-10-07,8400/000 : FNB,99.99 JINA.AI 4XX*5191 04 OCT XX8123 99.99 JINA.AI 4XXXXX*5191 04 OCT XXXXXXXXXXXXXXXXXXX8123,Account Payment,99.99 JINA.AI 4XX*5191 04 OCT XX8123 99.99 JINA.AI 4XXXXX*5191 04 OCT XXXXXXXXXXXXXXXXXXX8123,1792.0,,3373333.88,AccountTransactionsReport(1).csv,1434,2024-10,False,Other Computer Services,Other Computer Services,Other Computer Services
,2024-10-07,8400/000 : FNB,19.00 CHATBASE 4XX*5191 05 OCT XX6957 19.00 CHATBASE 4XXXXX*5191 05 OCT XXXXXXXXXXXXXXXXXXX6957,Account Payment,19.00 CHATBASE 4XX*5191 05 OCT XX6957 19.00 CHATBASE 4XXXXX*5191 05 OCT XXXXXXXXXXXXXXXXXXX6957,341.48,,3373675.36,AccountTransactionsReport(1).csv,1435,2024-10,False,Other Computer Services,Other Computer Services,Other Computer Services
,2024-10-08,8400/000 : FNB,#INT PYMT FEE-141.99 CANV #INT PYMT FEE-141.99 CANV,Account Payment,INT PYMT FEE-141.99 CANV INT PYMT FEE-141.99 CANV,2.84,,3373678.2,AccountTransactionsReport(1).csv,1436,2024-10,False,Other Computer Services,Other Computer Services,Other Computer Services
,2024-10-08,8400/000 : FNB,15.00 CAL.COM 4XX*5191 05 OCT XX3962 15.00 CAL.COM 4XXXXX*5191 05 OCT XXXXXXXXXXXXXXXXXXX3962,Account Payment,15.00 CAL.COM 4XX*5191 05 OCT XX3962 15.00 CAL.COM 4XXXXX*5191 05 OCT XXXXXXXXXXXXXXXXXXX3962,269.59,,3373947.79,AccountTransactionsReport(1).csv,1437,2024-10,False,Other Computer Services,Other Computer Services,Other Computer Services
,2024-10-08,8400/000 : FNB,Paddle 187.94 PADDLE.NET* 4XXXXX*5191 05 OCT XXXXXXXXXXXXXXXXXXX9722 Paddle,Account Payment,Paddle 187.94 PADDLE.NET* 4XXXXX*5191 05 OCT XXXXXXXXXXXXXXXXXXX9722 Paddle,187.94,,3374135.73,AccountTransactionsReport(1).csv,1438,2024-10,False,Other Computer Services,Subscription Management,Subscription Management
,2024-10-08,8400/000 : FNB,9.00 TWENTY.COM 4XX*5191 06 OCT XX6722 9.00 TWENTY.COM 4XXXXX*5191 06 OCT XXXXXXXXXXXXXXXXXXX6722,Account Payment,9.00 TWENTY.COM 4XX*5191 06 OCT XX6722 9.00 TWENTY.COM 4XXXXX*5191 06 OCT XXXXXXXXXXXXXXXXXXX6722,161.75,,3374297.48,AccountTransactionsReport(1).csv,1439,2024-10,False,Other Computer Services,Other Computer Services,Other Computer Services
,2024-10-08,8400/000 : FNB,3.60 GETADDRESS.IO 4XX*5225 07 OCT XX2430 3.60 GETADDRESS.IO 4XXXXX*5225 07 OCT XXXXXXXXXXXXXXXXXXX2,Account Payment,3.60 GETADDRESS.IO 4XX*5225 07 OCT XX2430 3.60 GETADDRESS.IO 4XXXXX*5225 07 OCT XXXXXXXXXXXXXXXXXXX,85.14,,3374382.62,AccountTransactionsReport(1).csv,1440,2024-10,False,Other Computer Services,Other Computer Services,Other Computer Services
,2024-10-08,8400/000 : FNB,77.05 CBA*Plesk 4XX*5191 05 OCT XX7601 77.05 CBA*Plesk 4XXXXX*5191 05 OCT XXXXXXXXXXXXXXXXXXX7601,Account Payment,77.05 CBA*Plesk 4XX*5191 05 OCT XX7601 77.05 CBA*Plesk 4XXXXX*5191 05 OCT XXXXXXXXXXXXXXXXXXX7601,1384.77,,3375767.39,AccountTransactionsReport(1).csv,1441,2024-10,False,Domain & Hosting,Domain & Hosting,Domain & Hosting
,2024-10-08,8400/000 : FNB,72.00 TERMIUS CORPO 4XX*5191 06 OCT XX5425 72.00 TERMIUS CORPO 4XXXXX*5191 06 OCT XXXXXXXXXXXXXXXXXX,Account Payment,72.00 TERMIUS CORPO 4XX*5191 06 OCT XX5425 72.00 TERMIUS CORPO 4XXXXX*5191 06 OCT XXXXXXXXXXXXXXXXX,1294.01,,3377061.4,AccountTransactionsReport(1).csv,1442,2024-10,False,Other Computer Services,Other Computer Services,Other Computer Services
,2024-10-08,8400/000 : FNB,29.00 CAL.COM 4XX*5191 05 OCT XX5534 29.00 CAL.COM 4XXXXX*5191 05 OCT XXXXXXXXXXXXXXXXXXX5534,Account Payment,29.00 CAL.COM 4XX*5191 05 OCT XX5534 29.00 CAL.COM 4XXXXX*5191 05 OCT XXXXXXXXXXXXXXXXXXX5534,521.2,,3377582.6,AccountTransactionsReport(1).csv,1443,2024-10,False,Other Computer Services,Other Computer Services,Other Computer Services
,2024-10-08,8400/000 : FNB,20.00 VERCEL INC. 4XX*5225 06 OCT XX5305 20.00 VERCEL INC. 4XXXXX*5225 06 OCT XXXXXXXXXXXXXXXXXXX530,Account Payment,20.00 VERCEL INC. 4XX*5225 06 OCT XX5305 20.00 VERCEL INC. 4XXXXX*5225 06 OCT XXXXXXXXXXXXXXXXXXX53,359.45,,3377942.05,AccountTransactionsReport(1).csv,1444,2024-10,False,Cloud Services,Cloud Services,Cloud Services
,2024-10-08,8400/000 : FNB,20.00 VERCEL INC. 4XX*5225 06 OCT XX6934 20.00 VERCEL INC. 4XXXXX*5225 06 OCT XXXXXXXXXXXXXXXXXXX693,Account Payment,20.00 VERCEL INC. 4XX*5225 06 OCT XX6934 20.00 VERCEL INC. 4XXXXX*5225 06 OCT XXXXXXXXXXXXXXXXXXX69,359.45,,3378301.5,AccountTransactionsReport(1).csv,1445,2024-10,False,Cloud Services,Cloud Services,Cloud Services
,2024-10-08,8400/000 : FNB,Woocommerce 19.99 WOOCOMMERCE S 4XXXXX*5225 06 OCT XXXXXXXXXXXXXXXXXXX0045 Woocommerce,Account Payment,Woocommerce 19.99 WOOCOMMERCE S 4XXXXX*5225 06 OCT XXXXXXXXXXXXXXXXXXX0045 Woocommerce,359.26,,3378660.76,AccountTransactionsReport(1).csv,1446,2024-10,False,Other Computer Services,Other Computer Services,Other Computer Services
,2024-10-08,8400/000 : FNB,Shopify 3478.67 SHOPIFY* 27 4XXXXX*5191 05 OCT XXXXXXXXXXXXXXXXXXX8982 Shopify,Account Payment,Shopify 3478.67 SHOPIFY* 27 4XXXXX*5191 05 OCT XXXXXXXXXXXXXXXXXXX8982 Shopify,62520.03,,3441180.79,AccountTransactionsReport(1).csv,1447,2024-10,False,E-commerce Platforms,E-commerce Platforms,E-commerce Platforms
,2024-10-08,8400/000 : FNB,599.00 TRIPLE WHALE 4XX*5191 04 OCT XX1399 599.00 TRIPLE WHALE 4XXXXX*5191 04 OCT XXXXXXXXXXXXXXXXXX,Account Payment,599.00 TRIPLE WHALE 4XX*5191 04 OCT XX1399 599.00 TRIPLE WHALE 4XXXXX*5191 04 OCT XXXXXXXXXXXXXXXXX,10735.14,,3451915.93,AccountTransactionsReport(1).csv,1448,2024-10,False,Other Computer Services,Other Computer Services,Other Computer Services
,2024-10-08,8400/000 : FNB,253.00 WWW.WOLFRAM. 4XX*5191 05 OCT XX3324 253.00 WWW.WOLFRAM. 4XXXXX*5191 05 OCT XXXXXXXXXXXXXXXXXX,Account Payment,253.00 WWW.WOLFRAM. 4XX*5191 05 OCT XX3324 253.00 WWW.WOLFRAM. 4XXXXX*5191 05 OCT XXXXXXXXXXXXXXXXX,4547.02,,3456462.95,AccountTransactionsReport(1).csv,1449,2024-10,False,Other Computer Services,Other Computer Services,Other Computer Services
,2024-10-08,8400/000 : FNB,174.00 INTERCOM R&D 4XX*5191 06 OCT XX2219 174.00 INTERCOM R&D 4XXXXX*5191 06 OCT XXXXXXXXXXXXXXXXXX,Account Payment,174.00 INTERCOM R&D 4XX*5191 06 OCT XX2219 174.00 INTERCOM R&D 4XXXXX*5191 06 OCT XXXXXXXXXXXXXXXXX,3127.2,,3459590.15,AccountTransactionsReport(1).csv,1450,2024-10,False,Other Computer Services,Customer Support,Customer Support
,2024-10-08,8400/000 : FNB,ManageWP 120.75 MANAGEWP 4XXXXX*5225 05 OCT XXXXXXXXXXXXXXXXXXX8976 ManageWP,Account Payment,ManageWP 120.75 MANAGEWP 4XXXXX*5225 05 OCT XXXXXXXXXXXXXXXXXXX8976 ManageWP,2170.16,,3461760.31,AccountTransactionsReport(1).csv,1451,2024-10,False,Other Computer Services,Other Computer Services,Other Computer Services
,2024-10-08,8400/000 : FNB,ManageWP 120.75 MANAGEWP 4XXXXX*5225 05 OCT XXXXXXXXXXXXXXXXXXX8920 ManageWP,Account Payment,ManageWP 120.75 MANAGEWP 4XXXXX*5225 05 OCT XXXXXXXXXXXXXXXXXXX8920 ManageWP,2170.16,,3463930.47,AccountTransactionsReport(1).csv,1452,2024-10,False,Other Computer Services,Other Computer Services,Other Computer Services
,2024-10-08,8400/000 : FNB,99.00 CHATBASE 4XX*5191 05 OCT XX1491 99.00 CHATBASE 4XXXXX*5191 05 OCT XXXXXXXXXXXXXXXXXXX1491,Account Payment,99.00 CHATBASE 4XX*5191 05 OCT XX1491 99.00 CHATBASE 4XXXXX*5191 05 OCT XXXXXXXXXXXXXXXXXXX1491,1779.27,,3465709.74,AccountTransactionsReport(1).csv,1453,2024-10,False,Other Computer Services,Other Computer Services,Other Computer Services
,2024-10-08,8400/000 : FNB,Hightail 15.00 HIGHTAIL 4XXXXX*5191 06 OCT XXXXXXXXXXXXXXXXXXX3548 Hightail,Account Payment,Hightail 15.00 HIGHTAIL 4XXXXX*5191 06 OCT XXXXXXXXXXXXXXXXXXX3548 Hightail,269.59,,3465979.33,AccountTransactionsReport(1).csv,1454,2024-10,False,Other Computer Services,Other Computer Services,Other Computer Services
,2024-10-09,8400/000 : FNB,Paddle 171.35 PADDLE.NET* 4XXXXX*5191 08 OCT XXXXXXXXXXXXXXXXXXX6052 Paddle,Account Payment,Paddle 171.35 PADDLE.NET* 4XXXXX*5191 08 OCT XXXXXXXXXXXXXXXXXXX6052 Paddle,3062.16,,3469041.49,AccountTransactionsReport(1).csv,1455,2024-10,False,Other Computer Services,Subscription Management,Subscription Management
,2024-10-09,8400/000 : FNB,"105.00 NOTION LABS, 4XX*5225 07 OCT XX4748 105.00 NOTION LABS, 4XXXXX*5225 07 OCT XXXXXXXXXXXXXXXXXX",Account Payment,"105.00 NOTION LABS, 4XX*5225 07 OCT XX4748 105.00 NOTION LABS, 4XXXXX*5225 07 OCT XXXXXXXXXXXXXXXXX",1887.1,,3470928.59,AccountTransactionsReport(1).csv,1456,2024-10,False,Other Computer Services,Collaboration Tools,Collaboration Tools
,2024-10-09,8400/000 : FNB,12.00 CODESANDBOX 4XX*5191 07 OCT XX1198 12.00 CODESANDBOX 4XXXXX*5191 07 OCT XXXXXXXXXXXXXXXXXXX119,Account Payment,12.00 CODESANDBOX 4XX*5191 07 OCT XX1198 12.00 CODESANDBOX 4XXXXX*5191 07 OCT XXXXXXXXXXXXXXXXXXX11,215.67,,3471144.26,AccountTransactionsReport(1).csv,1457,2024-10,False,Other Computer Services,Other Computer Services,Other Computer Services
,2024-10-10,8400/000 : FNB,150.00 AUTH0.COM 4XX*5191 08 OCT XX7379 150.00 AUTH0.COM 4XXXXX*5191 08 OCT XXXXXXXXXXXXXXXXXXX7379,Account Payment,150.00 AUTH0.COM 4XX*5191 08 OCT XX7379 150.00 AUTH0.COM 4XXXXX*5191 08 OCT XXXXXXXXXXXXXXXXXXX7379,2680.62,,3473824.88,AccountTransactionsReport(1).csv,1458,2024-10,False,Security Services,Security Services,Security Services
,2024-10-10,8400/000 : FNB,"25.00 NOTION LABS, 4XX*5191 08 OCT XX7665 25.00 NOTION LABS, 4XXXXX*5191 08 OCT XXXXXXXXXXXXXXXXXXX7",Account Payment,"25.00 NOTION LABS, 4XX*5191 08 OCT XX7665 25.00 NOTION LABS, 4XXXXX*5191 08 OCT XXXXXXXXXXXXXXXXXXX",446.77,,3474271.65,AccountTransactionsReport(1).csv,1459,2024-10,False,Other Computer Services,Collaboration Tools,Collaboration Tools
,2024-10-10,8400/000 : FNB,Google Store 34.99 Google One 4XXXXX*5191 09 OCT XXXXXXXXXXXXXXXXXXX6046 Google Store,Account Payment,Google Store 34.99 Google One 4XXXXX*5191 09 OCT XXXXXXXXXXXXXXXXXXX6046 Google Store,34.99,,3474306.64,AccountTransactionsReport(1).csv,1460,2024-10,False,Other Computer Services,Analytics & Monitoring,Analytics & Monitoring
,2024-10-11,8400/000 : FNB,10.00 SUNO INC. 4XX*5191 09 OCT XX0035 10.00 SUNO INC. 4XXXXX*5191 09 OCT XXXXXXXXXXXXXXXXXXX0035,Account Payment,10.00 SUNO INC. 4XX*5191 09 OCT XX0035 10.00 SUNO INC. 4XXXXX*5191 09 OCT XXXXXXXXXXXXXXXXXXX0035,179.79,,3474486.43,AccountTransactionsReport(1).csv,1461,2024-10,False,Other Computer Services,Other Computer Services,Other Computer Services
,2024-10-11,8400/000 : FNB,1499.00 APPDIRECT 4XX*5191 09 OCT XX3386 1499.00 APPDIRECT 4XXXXX*5191 09 OCT XXXXXXXXXXXXXXXXXXX338,Account Payment,1499.00 APPDIRECT 4XX*5191 09 OCT XX3386 1499.00 APPDIRECT 4XXXXX*5191 09 OCT XXXXXXXXXXXXXXXXXXX33,26950.07,,3501436.5,AccountTransactionsReport(1).csv,1462,2024-10,False,Other Computer Services,Other Computer Services,Other Computer Services
,2024-10-11,8400/000 : FNB,499.00 CASSIDYAI.CO 4XX*5191 09 OCT XX6549 499.00 CASSIDYAI.CO 4XXXXX*5191 09 OCT XXXXXXXXXXXXXXXXXX,Account Payment,499.00 CASSIDYAI.CO 4XX*5191 09 OCT XX6549 499.00 CASSIDYAI.CO 4XXXXX*5191 09 OCT XXXXXXXXXXXXXXXXX,8971.37,,3510407.87,AccountTransactionsReport(1).csv,1463,2024-10,False,Other Computer Services,Other Computer Services,Other Computer Services
,2024-10-11,8400/000 : FNB,60.00 OPENAI *CHATG 4XX*5191 09 OCT XX0388 60.00 OPENAI *CHATG 4XXXXX*5191 09 OCT XXXXXXXXXXXXXXXXXX,Account Payment,60.00 OPENAI *CHATG 4XX*5191 09 OCT XX0388 60.00 OPENAI *CHATG 4XXXXX*5191 09 OCT XXXXXXXXXXXXXXXXX,1078.72,,3511486.59,AccountTransactionsReport(1).csv,1464,2024-10,False,AI Services,AI Services,AI Services
,2024-10-11,8400/000 : FNB,20.00 VERCEL INC. 4XX*5191 09 OCT XX0120 20.00 VERCEL INC. 4XXXXX*5191 09 OCT XXXXXXXXXXXXXXXXXXX012,Account Payment,20.00 VERCEL INC. 4XX*5191 09 OCT XX0120 20.00 VERCEL INC. 4XXXXX*5191 09 OCT XXXXXXXXXXXXXXXXXXX01,359.57,,3511846.16,AccountTransactionsReport(1).csv,1465,2024-10,False,Cloud Services,Cloud Services,Cloud Services
,2024-10-11,8400/000 : FNB,20.00 HEROKU* SEP-9 4XX*5191 09 OCT XX3859 20.00 HEROKU* SEP-9 4XXXXX*5191 09 OCT XXXXXXXXXXXXXXXXXX,Account Payment,20.00 HEROKU* SEP-9 4XX*5191 09 OCT XX3859 20.00 HEROKU* SEP-9 4XXXXX*5191 09 OCT XXXXXXXXXXXXXXXXX,359.57,,3512205.73,AccountTransactionsReport(1).csv,1466,2024-10,False,Cloud Services,Cloud Services,Cloud Services
,2024-10-11,8400/000 : FNB,49.00 SKRAPP.IO STA 4XX*5191 09 OCT XX0740 49.00 SKRAPP.IO STA 4XXXXX*5191 09 OCT XXXXXXXXXXXXXXXXXX,Account Payment,49.00 SKRAPP.IO STA 4XX*5191 09 OCT XX0740 49.00 SKRAPP.IO STA 4XXXXX*5191 09 OCT XXXXXXXXXXXXXXXXX,880.95,,3513086.68,AccountTransactionsReport(1).csv,1467,2024-10,False,Other Computer Services,Other Computer Services,Other Computer Services
,2024-10-11,8400/000 : FNB,"40.00 REPLIT, INC. 4XX*5191 09 OCT XX2161 40.00 REPLIT, INC. 4XXXXX*5191 09 OCT XXXXXXXXXXXXXXXXXXX2",Account Payment,"40.00 REPLIT, INC. 4XX*5191 09 OCT XX2161 40.00 REPLIT, INC. 4XXXXX*5191 09 OCT XXXXXXXXXXXXXXXXXXX",719.15,,3513805.83,AccountTransactionsReport(1).csv,1468,2024-10,False,Other Computer Services,Other Computer Services,Other Computer Services
,2024-10-11,8400/000 : FNB,"Github Inc. 39.97 GITHUB, INC. 4XXXXX*5191 09 OCT XXXXXXXXXXXXXXXXXXX9623 Github Inc.",Account Payment,"Github Inc. 39.97 GITHUB, INC. 4XXXXX*5191 09 OCT XXXXXXXXXXXXXXXXXXX9623 Github Inc.",718.61,,3514524.44,AccountTransactionsReport(1).csv,1469,2024-10,False,Development Tools,Development Tools,Development Tools
,2024-10-11,8400/000 : FNB,30.00 ISHRAQ LLC 4XX*5191 09 OCT XX9426 30.00 ISHRAQ LLC 4XXXXX*5191 09 OCT XXXXXXXXXXXXXXXXXXX9426,Account Payment,30.00 ISHRAQ LLC 4XX*5191 09 OCT XX9426 30.00 ISHRAQ LLC 4XXXXX*5191 09 OCT XXXXXXXXXXXXXXXXXXX9426,539.37,,3515063.81,AccountTransactionsReport(1).csv,1470,2024-10,False,Other Computer Services,Other Computer Services,Other Computer Services
,2024-10-11,8400/000 : FNB,28.75 CLOUDFLARE 4XX*5191 09 OCT XX7854 28.75 CLOUDFLARE 4XXXXX*5191 09 OCT XXXXXXXXXXXXXXXXXXX7854,Account Payment,28.75 CLOUDFLARE 4XX*5191 09 OCT XX7854 28.75 CLOUDFLARE 4XXXXX*5191 09 OCT XXXXXXXXXXXXXXXXXXX7854,516.89,,3515580.7,AccountTransactionsReport(1).csv,1471,2024-10,False,Cloud Services,Cloud Services,Cloud Services
,2024-10-11,8400/000 : FNB,25.00 BEECEPTOR 4XX*5191 09 OCT XX7538 25.00 BEECEPTOR 4XXXXX*5191 09 OCT XXXXXXXXXXXXXXXXXXX7538,Account Payment,25.00 BEECEPTOR 4XX*5191 09 OCT XX7538 25.00 BEECEPTOR 4XXXXX*5191 09 OCT XXXXXXXXXXXXXXXXXXX7538,449.46,,3516030.16,AccountTransactionsReport(1).csv,1472,2024-10,False,Other Computer Services,Other Computer Services,Other Computer Services
,2024-10-11,8400/000 : FNB,25.00 BEECEPTOR 4XX*5191 09 OCT XX7827 25.00 BEECEPTOR 4XXXXX*5191 09 OCT XXXXXXXXXXXXXXXXXXX7827,Account Payment,25.00 BEECEPTOR 4XX*5191 09 OCT XX7827 25.00 BEECEPTOR 4XXXXX*5191 09 OCT XXXXXXXXXXXXXXXXXXX7827,449.46,,3516479.62,AccountTransactionsReport(1).csv,1473,2024-10,False,Other Computer Services,Other Computer Services,Other Computer Services
,2024-10-12,8400/000 : FNB,Shopify 3656.94 SHOPIFY* 28 4XXXXX*5225 10 OCT XXXXXXXXXXXXXXXXXXX9678 Shopify,Account Payment,Shopify 3656.94 SHOPIFY* 28 4XXXXX*5225 10 OCT XXXXXXXXXXXXXXXXXXX9678 Shopify,66033.12,,3582512.74,AccountTransactionsReport(1).csv,1474,2024-10,False,E-commerce Platforms,E-commerce Platforms,E-commerce Platforms
,2024-10-12,8400/000 : FNB,"99.00 PLAYFAB, INC. 4XX*5191 10 OCT XX9403 99.00 PLAYFAB, INC. 4XXXXX*5191 10 OCT XXXXXXXXXXXXXXXXXX",Account Payment,"99.00 PLAYFAB, INC. 4XX*5191 10 OCT XX9403 99.00 PLAYFAB, INC. 4XXXXX*5191 10 OCT XXXXXXXXXXXXXXXXX",1787.63,,3584300.37,AccountTransactionsReport(1).csv,1475,2024-10,False,Other Computer Services,Other Computer Services,Other Computer Services
,2024-10-12,8400/000 : FNB,"Github Inc. 47.42 GITHUB, INC. 4XXXXX*5191 10 OCT XXXXXXXXXXXXXXXXXXX0843 Github Inc.",Account Payment,"Github Inc. 47.42 GITHUB, INC. 4XXXXX*5191 10 OCT XXXXXXXXXXXXXXXXXXX0843 Github Inc.",856.26,,3585156.63,AccountTransactionsReport(1).csv,1476,2024-10,False,Development Tools,Development Tools,Development Tools
,2024-10-14,8400/000 : FNB,"Github Inc. 189.00 GITHUB, INC. 4XXXXX*5225 11 OCT XXXXXXXXXXXXXXXXXXX0096 Github Inc.",Account Payment,"Github Inc. 189.00 GITHUB, INC. 4XXXXX*5225 11 OCT XXXXXXXXXXXXXXXXXXX0096 Github Inc.",3413.01,,3588569.64,AccountTransactionsReport(1).csv,1477,2024-10,False,Development Tools,Development Tools,Development Tools
,2024-10-14,8400/000 : FNB,"Github Inc. 79.08 GITHUB, INC. 4XXXXX*5225 11 OCT XXXXXXXXXXXXXXXXXXX4270 Github Inc.",Account Payment,"Github Inc. 79.08 GITHUB, INC. 4XXXXX*5225 11 OCT XXXXXXXXXXXXXXXXXXX4270 Github Inc.",1428.05,,3589997.69,AccountTransactionsReport(1).csv,1478,2024-10,False,Development Tools,Development Tools,Development Tools
,2024-10-14,8400/000 : FNB,Intuit 546.25 INTUIT *QBoo 4XXXXX*5225 11 OCT XXXXXXXXXXXXXXXXXXX4188 Intuit,Account Payment,Intuit 546.25 INTUIT *QBoo 4XXXXX*5225 11 OCT XXXXXXXXXXXXXXXXXXX4188 Intuit,546.25,,3590543.94,AccountTransactionsReport(1).csv,1479,2024-10,False,Productivity Software,Productivity Software,Productivity Software
,2024-10-14,8400/000 : FNB,Slack & Co 21.56 SLACK T0740DV 4XXXXX*5191 11 OCT XXXXXXXXXXXXXXXXXXX8014 Slack & Co,Account Payment,Slack & Co 21.56 SLACK T0740DV 4XXXXX*5191 11 OCT XXXXXXXXXXXXXXXXXXX8014 Slack & Co,389.33,,3590933.27,AccountTransactionsReport(1).csv,1480,2024-10,False,Communication,Communication,Communication
,2024-10-14,8400/000 : FNB,"Github Inc. 54.20 GITHUB, INC. 4XXXXX*5191 11 OCT XXXXXXXXXXXXXXXXXXX5221 Github Inc.",Account Payment,"Github Inc. 54.20 GITHUB, INC. 4XXXXX*5191 11 OCT XXXXXXXXXXXXXXXXXXX5221 Github Inc.",978.76,,3591912.03,AccountTransactionsReport(1).csv,1481,2024-10,False,Development Tools,Development Tools,Development Tools
,2024-10-14,8400/000 : FNB,"Github Inc. 42.00 GITHUB, INC. 4XXXXX*5191 11 OCT XXXXXXXXXXXXXXXXXXX6763 Github Inc.",Account Payment,"Github Inc. 42.00 GITHUB, INC. 4XXXXX*5191 11 OCT XXXXXXXXXXXXXXXXXXX6763 Github Inc.",758.45,,3592670.48,AccountTransactionsReport(1).csv,1482,2024-10,False,Development Tools,Development Tools,Development Tools
,2024-10-14,8400/000 : FNB,Intuit 546.25 INTUIT *QBoo 4XXXXX*5225 11 OCT XXXXXXXXXXXXXXXXXXX4238 Intuit,Account Payment,Intuit 546.25 INTUIT *QBoo 4XXXXX*5225 11 OCT XXXXXXXXXXXXXXXXXXX4238 Intuit,546.25,,3593216.73,AccountTransactionsReport(1).csv,1483,2024-10,False,Productivity Software,Productivity Software,Productivity Software
,2024-10-15,8400/000 : FNB,Google Service Charges/Fees #INT PYMT FEE-34.99 Googl Google,Account Payment,Google Service Charges/Fees INT PYMT FEE-34.99 Googl Google,0.7,,3593217.43,AccountTransactionsReport(1).csv,1484,2024-10,False,Other Computer Services,Analytics & Monitoring,Analytics & Monitoring
,2024-10-15,8400/000 : FNB,15.00 TABNINE 4XX*5191 12 OCT XX5931 15.00 TABNINE 4XXXXX*5191 12 OCT XXXXXXXXXXXXXXXXXXX5931,Account Payment,15.00 TABNINE 4XX*5191 12 OCT XX5931 15.00 TABNINE 4XXXXX*5191 12 OCT XXXXXXXXXXXXXXXXXXX5931,269.19,,3593486.62,AccountTransactionsReport(1).csv,1485,2024-10,False,Other Computer Services,Other Computer Services,Other Computer Services
,2024-10-15,8400/000 : FNB,11.49 GOOGLE *Colab 4XX*5191 14 OCT XX1540 11.49 GOOGLE *Colab 4XXXXX*5191 14 OCT XXXXXXXXXXXXXXXXXX,Account Payment,11.49 GOOGLE *Colab 4XX*5191 14 OCT XX1540 11.49 GOOGLE *Colab 4XXXXX*5191 14 OCT XXXXXXXXXXXXXXXXX,206.19,,3593692.81,AccountTransactionsReport(1).csv,1486,2024-10,False,Other Computer Services,Analytics & Monitoring,Analytics & Monitoring
,2024-10-15,8400/000 : FNB,5.00 WWW.FLUX.AI 4XX*5191 13 OCT XX1902 5.00 WWW.FLUX.AI 4XXXXX*5191 13 OCT XXXXXXXXXXXXXXXXXXX1902,Account Payment,5.00 WWW.FLUX.AI 4XX*5191 13 OCT XX1902 5.00 WWW.FLUX.AI 4XXXXX*5191 13 OCT XXXXXXXXXXXXXXXXXXX1902,89.73,,3593782.54,AccountTransactionsReport(1).csv,1487,2024-10,False,Other Computer Services,Other Computer Services,Other Computer Services
,2024-10-15,8400/000 : FNB,180.00 AGENCYANALYT 4XX*5225 13 OCT XX9505 180.00 AGENCYANALYT 4XXXXX*5225 13 OCT XXXXXXXXXXXXXXXXXX,Account Payment,180.00 AGENCYANALYT 4XX*5225 13 OCT XX9505 180.00 AGENCYANALYT 4XXXXX*5225 13 OCT XXXXXXXXXXXXXXXXX,3230.24,,3597012.78,AccountTransactionsReport(1).csv,1488,2024-10,False,Other Computer Services,Other Computer Services,Other Computer Services
,2024-10-15,8400/000 : FNB,Shopify 74.75 SHOPIFY* 2835 4XXXXX*5225 12 OCT XXXXXXXXXXXXXXXXXXX4352 Shopify,Account Payment,Shopify 74.75 SHOPIFY* 2835 4XXXXX*5225 12 OCT XXXXXXXXXXXXXXXXXXX4352 Shopify,1341.44,,3598354.22,AccountTransactionsReport(1).csv,1489,2024-10,False,E-commerce Platforms,E-commerce Platforms,E-commerce Platforms
,2024-10-15,8400/000 : FNB,"70.00 NOTION LABS, 4XX*5191 12 OCT XX7306 70.00 NOTION LABS, 4XXXXX*5191 12 OCT XXXXXXXXXXXXXXXXXXX7",Account Payment,"70.00 NOTION LABS, 4XX*5191 12 OCT XX7306 70.00 NOTION LABS, 4XXXXX*5191 12 OCT XXXXXXXXXXXXXXXXXXX",1256.2,,3599610.42,AccountTransactionsReport(1).csv,1490,2024-10,False,Other Computer Services,Collaboration Tools,Collaboration Tools
,2024-10-15,8400/000 : FNB,32.00 BUBBLE STARTE 4XX*5191 13 OCT XX3638 32.00 BUBBLE STARTE 4XXXXX*5191 13 OCT XXXXXXXXXXXXXXXXXX,Account Payment,32.00 BUBBLE STARTE 4XX*5191 13 OCT XX3638 32.00 BUBBLE STARTE 4XXXXX*5191 13 OCT XXXXXXXXXXXXXXXXX,574.26,,3600184.68,AccountTransactionsReport(1).csv,1491,2024-10,False,Other Computer Services,Other Computer Services,Other Computer Services
,2024-10-15,8400/000 : FNB,20.00 HUGGINGFACE 4XX*5191 13 OCT XX4369 20.00 HUGGINGFACE 4XXXXX*5191 13 OCT XXXXXXXXXXXXXXXXXXX436,Account Payment,20.00 HUGGINGFACE 4XX*5191 13 OCT XX4369 20.00 HUGGINGFACE 4XXXXX*5191 13 OCT XXXXXXXXXXXXXXXXXXX43,358.92,,3600543.6,AccountTransactionsReport(1).csv,1492,2024-10,False,AI Services,AI Services,AI Services
,2024-10-16,8400/000 : FNB,Intuit 546.25 INTUIT *QBoo 4XXXXX*5225 14 OCT XXXXXXXXXXXXXXXXXXX5572 Intuit,Account Payment,Intuit 546.25 INTUIT *QBoo 4XXXXX*5225 14 OCT XXXXXXXXXXXXXXXXXXX5572 Intuit,546.25,,3601089.85,AccountTransactionsReport(1).csv,1493,2024-10,False,Productivity Software,Productivity Software,Productivity Software
,2024-10-16,8400/000 : FNB,"Github Inc. 14.00 GITHUB, INC. 4XXXXX*5225 14 OCT XXXXXXXXXXXXXXXXXXX9397 Github Inc.",Account Payment,"Github Inc. 14.00 GITHUB, INC. 4XXXXX*5225 14 OCT XXXXXXXXXXXXXXXXXXX9397 Github Inc.",251.24,,3601341.09,AccountTransactionsReport(1).csv,1494,2024-10,False,Development Tools,Development Tools,Development Tools
,2024-10-17,8400/000 : FNB,237.48 SLACK T0MN3D 4XX*5225 15 OCT XX5381 237.48 SLACK T0MN3D 4XXXXX*5225 15 OCT XXXXXXXXXXXXXXXXXX,Account Payment,237.48 SLACK T0MN3D 4XX*5225 15 OCT XX5381 237.48 SLACK T0MN3D 4XXXXX*5225 15 OCT XXXXXXXXXXXXXXXXX,4268.15,,3605609.24,AccountTransactionsReport(1).csv,1495,2024-10,False,Communication,Communication,Communication
,2024-10-17,8400/000 : FNB,120.00 OPENAI *CHAT 4XX*5191 16 OCT XX6386 120.00 OPENAI *CHAT 4XXXXX*5191 16 OCT XXXXXXXXXXXXXXXXXX,Account Payment,120.00 OPENAI *CHAT 4XX*5191 16 OCT XX6386 120.00 OPENAI *CHAT 4XXXXX*5191 16 OCT XXXXXXXXXXXXXXXXX,2164.81,,3607774.05,AccountTransactionsReport(1).csv,1496,2024-10,False,AI Services,AI Services,AI Services
,2024-10-17,8400/000 : FNB,376.40 HOLASPIRIT 4XX*5225 15 OCT XX1063 376.40 HOLASPIRIT 4XXXXX*5225 15 OCT XXXXXXXXXXXXXXXXXXX106,Account Payment,376.40 HOLASPIRIT 4XX*5225 15 OCT XX1063 376.40 HOLASPIRIT 4XXXXX*5225 15 OCT XXXXXXXXXXXXXXXXXXX10,7390.6,,3615164.65,AccountTransactionsReport(1).csv,1497,2024-10,False,Other Computer Services,Other Computer Services,Other Computer Services
,2024-10-17,8400/000 : FNB,231.95 HOLASPIRIT 4XX*5225 15 OCT XX2906 231.95 HOLASPIRIT 4XXXXX*5225 15 OCT XXXXXXXXXXXXXXXXXXX290,Account Payment,231.95 HOLASPIRIT 4XX*5225 15 OCT XX2906 231.95 HOLASPIRIT 4XXXXX*5225 15 OCT XXXXXXXXXXXXXXXXXXX29,4554.33,,3619718.98,AccountTransactionsReport(1).csv,1498,2024-10,False,Other Computer Services,Other Computer Services,Other Computer Services
,2024-10-17,8400/000 : FNB,4.07 GLASSFROG 4XX*5191 14 OCT XX1115 4.07 GLASSFROG 4XXXXX*5191 14 OCT XXXXXXXXXXXXXXXXXXX1115,Account Receipt,4.07 GLASSFROG 4XX*5191 14 OCT XX1115 4.07 GLASSFROG 4XXXXX*5191 14 OCT XXXXXXXXXXXXXXXXXXX1115,,69.89,3619649.09,AccountTransactionsReport(1).csv,1499,2024-10,False,Other Computer Services,Other Computer Services,Other Computer Services
,2024-10-18,8400/000 : FNB,"7.00 NPM, INC. 4XX*5191 16 OCT XX3459 7.00 NPM, INC. 4XXXXX*5191 16 OCT XXXXXXXXXXXXXXXXXXX3459",Account Payment,"7.00 NPM, INC. 4XX*5191 16 OCT XX3459 7.00 NPM, INC. 4XXXXX*5191 16 OCT XXXXXXXXXXXXXXXXXXX3459",126.28,,3619775.37,AccountTransactionsReport(1).csv,1500,2024-10,False,Other Computer Services,Other Computer Services,Other Computer Services
,2024-10-18,8400/000 : FNB,"7.00 NPM, INC. 4XX*5191 16 OCT XX8069 7.00 NPM, INC. 4XXXXX*5191 16 OCT XXXXXXXXXXXXXXXXXXX8069",Account Payment,"7.00 NPM, INC. 4XX*5191 16 OCT XX8069 7.00 NPM, INC. 4XXXXX*5191 16 OCT XXXXXXXXXXXXXXXXXXX8069",126.28,,3619901.65,AccountTransactionsReport(1).csv,1501,2024-10,False,Other Computer Services,Other Computer Services,Other Computer Services
,2024-10-18,8400/000 : FNB,"7.00 NPM, INC. 4XX*5191 16 OCT XX2481 7.00 NPM, INC. 4XXXXX*5191 16 OCT XXXXXXXXXXXXXXXXXXX2481",Account Payment,"7.00 NPM, INC. 4XX*5191 16 OCT XX2481 7.00 NPM, INC. 4XXXXX*5191 16 OCT XXXXXXXXXXXXXXXXXXX2481",126.28,,3620027.93,AccountTransactionsReport(1).csv,1502,2024-10,False,Other Computer Services,Other Computer Services,Other Computer Services
,2024-10-18,8400/000 : FNB,"7.00 NPM, INC. 4XX*5191 16 OCT XX0483 7.00 NPM, INC. 4XXXXX*5191 16 OCT XXXXXXXXXXXXXXXXXXX0483",Account Payment,"7.00 NPM, INC. 4XX*5191 16 OCT XX0483 7.00 NPM, INC. 4XXXXX*5191 16 OCT XXXXXXXXXXXXXXXXXXX0483",126.28,,3620154.21,AccountTransactionsReport(1).csv,1503,2024-10,False,Other Computer Services,Other Computer Services,Other Computer Services
,2024-10-18,8400/000 : FNB,280.00 WIZA.CO 4XX*5191 16 OCT XX6474 280.00 WIZA.CO 4XXXXX*5191 16 OCT XXXXXXXXXXXXXXXXXXX6474,Account Payment,280.00 WIZA.CO 4XX*5191 16 OCT XX6474 280.00 WIZA.CO 4XXXXX*5191 16 OCT XXXXXXXXXXXXXXXXXXX6474,5051.22,,3625205.43,AccountTransactionsReport(1).csv,1504,2024-10,False,Other Computer Services,Other Computer Services,Other Computer Services
,2024-10-18,8400/000 : FNB,"67.39 REPLIT, INC. 4XX*5191 16 OCT XX4412 67.39 REPLIT, INC. 4XXXXX*5191 16 OCT XXXXXXXXXXXXXXXXXXX4",Account Payment,"67.39 REPLIT, INC. 4XX*5191 16 OCT XX4412 67.39 REPLIT, INC. 4XXXXX*5191 16 OCT XXXXXXXXXXXXXXXXXXX",1215.72,,3626421.15,AccountTransactionsReport(1).csv,1505,2024-10,False,Other Computer Services,Other Computer Services,Other Computer Services
,2024-10-22,8400/000 : FNB,99.00 DYNAMIC.XYZ 4XX*5191 19 OCT XX2138 99.00 DYNAMIC.XYZ 4XXXXX*5191 19 OCT XXXXXXXXXXXXXXXXXXX213,Account Payment,99.00 DYNAMIC.XYZ 4XX*5191 19 OCT XX2138 99.00 DYNAMIC.XYZ 4XXXXX*5191 19 OCT XXXXXXXXXXXXXXXXXXX21,1790.94,,3628212.09,AccountTransactionsReport(1).csv,1506,2024-10,False,Other Computer Services,Other Computer Services,Other Computer Services
,2024-10-22,8400/000 : FNB,99.00 CUSTOMGPT.AI 4XX*5191 19 OCT XX9040 99.00 CUSTOMGPT.AI 4XXXXX*5191 19 OCT XXXXXXXXXXXXXXXXXXX9,Account Payment,99.00 CUSTOMGPT.AI 4XX*5191 19 OCT XX9040 99.00 CUSTOMGPT.AI 4XXXXX*5191 19 OCT XXXXXXXXXXXXXXXXXXX,1790.94,,3630003.03,AccountTransactionsReport(1).csv,1507,2024-10,False,AI Services,AI Services,AI Services
,2024-10-22,8400/000 : FNB,59.00 GREENBACK.COM 4XX*5225 19 OCT XX3040 59.00 GREENBACK.COM 4XXXXX*5225 19 OCT XXXXXXXXXXXXXXXXXX,Account Payment,59.00 GREENBACK.COM 4XX*5225 19 OCT XX3040 59.00 GREENBACK.COM 4XXXXX*5225 19 OCT XXXXXXXXXXXXXXXXX,1067.33,,3631070.36,AccountTransactionsReport(1).csv,1508,2024-10,False,Other Computer Services,Other Computer Services,Other Computer Services
,2024-10-22,8400/000 : FNB,20.00 RAILWAY 4XX*5191 18 OCT XX3261 20.00 RAILWAY 4XXXXX*5191 18 OCT XXXXXXXXXXXXXXXXXXX3261,Account Payment,20.00 RAILWAY 4XX*5191 18 OCT XX3261 20.00 RAILWAY 4XXXXX*5191 18 OCT XXXXXXXXXXXXXXXXXXX3261,363.28,,3631433.64,AccountTransactionsReport(1).csv,1509,2024-10,False,Other Computer Services,Other Computer Services,Other Computer Services
,2024-10-25,8400/000 : FNB,89.00 SENTRY 4XX*5191 24 OCT XX0585 89.00 SENTRY 4XXXXX*5191 24 OCT XXXXXXXXXXXXXXXXXXX0585,Account Payment,89.00 SENTRY 4XX*5191 24 OCT XX0585 89.00 SENTRY 4XXXXX*5191 24 OCT XXXXXXXXXXXXXXXXXXX0585,1623.44,,3633057.08,AccountTransactionsReport(1).csv,1510,2024-10,False,Other Computer Services,Analytics & Monitoring,Analytics & Monitoring
,2024-10-25,8400/000 : FNB,30.00 HASURA 4XX*5191 23 OCT XX0025 30.00 HASURA 4XXXXX*5191 23 OCT XXXXXXXXXXXXXXXXXXX0025,Account Payment,30.00 HASURA 4XX*5191 23 OCT XX0025 30.00 HASURA 4XXXXX*5191 23 OCT XXXXXXXXXXXXXXXXXXX0025,547.23,,3633604.31,AccountTransactionsReport(1).csv,1511,2024-10,False,Other Computer Services,Other Computer Services,Other Computer Services
,2024-10-25,8400/000 : FNB,"6.00 DOCKER, INC. 4XX*5191 24 OCT XX3377 6.00 DOCKER, INC. 4XXXXX*5191 24 OCT XXXXXXXXXXXXXXXXXXX337",Account Payment,"6.00 DOCKER, INC. 4XX*5191 24 OCT XX3377 6.00 DOCKER, INC. 4XXXXX*5191 24 OCT XXXXXXXXXXXXXXXXXXX33",109.45,,3633713.76,AccountTransactionsReport(1).csv,1512,2024-10,False,Other Computer Services,Other Computer Services,Other Computer Services
,2024-10-26,8400/000 : FNB,"74.00 PIPEDREAM, IN 4XX*5191 24 OCT XX4053 74.00 PIPEDREAM, IN 4XXXXX*5191 24 OCT XXXXXXXXXXXXXXXXXX",Account Payment,"74.00 PIPEDREAM, IN 4XX*5191 24 OCT XX4053 74.00 PIPEDREAM, IN 4XXXXX*5191 24 OCT XXXXXXXXXXXXXXXXX",1349.83,,3635063.59,AccountTransactionsReport(1).csv,1513,2024-10,False,Other Computer Services,Other Computer Services,Other Computer Services
,2024-10-26,8400/000 : FNB,Dropbox 18.38 DROPBOX*C6QPM 4XXXXX*5191 24 OCT XXXXXXXXXXXXXXXXXXX0474 Dropbox,Account Payment,Dropbox 18.38 DROPBOX*C6QPM 4XXXXX*5191 24 OCT XXXXXXXXXXXXXXXXXXX0474 Dropbox,335.27,,3635398.86,AccountTransactionsReport(1).csv,1514,2024-10,False,Other Computer Services,Other Computer Services,Other Computer Services
,2024-10-26,8400/000 : FNB,10.00 MATTERMOST 4XX*5191 24 OCT XX2160 10.00 MATTERMOST 4XXXXX*5191 24 OCT XXXXXXXXXXXXXXXXXXX2160,Account Payment,10.00 MATTERMOST 4XX*5191 24 OCT XX2160 10.00 MATTERMOST 4XXXXX*5191 24 OCT XXXXXXXXXXXXXXXXXXX2160,181.94,,3635580.8,AccountTransactionsReport(1).csv,1515,2024-10,False,Other Computer Services,Other Computer Services,Other Computer Services
,2024-10-28,8400/000 : FNB,150.00 AUTH0.COM 4XX*5191 25 OCT XX1002 150.00 AUTH0.COM 4XXXXX*5191 25 OCT XXXXXXXXXXXXXXXXXXX1002,Account Payment,150.00 AUTH0.COM 4XX*5191 25 OCT XX1002 150.00 AUTH0.COM 4XXXXX*5191 25 OCT XXXXXXXXXXXXXXXXXXX1002,2712.69,,3638293.49,AccountTransactionsReport(1).csv,1516,2024-10,False,Security Services,Security Services,Security Services
,2024-10-28,8400/000 : FNB,54.00 AIRTABLE.COM/ 4XX*5191 25 OCT XX0577 54.00 AIRTABLE.COM/ 4XXXXX*5191 25 OCT XXXXXXXXXXXXXXXXXX,Account Payment,54.00 AIRTABLE.COM/ 4XX*5191 25 OCT XX0577 54.00 AIRTABLE.COM/ 4XXXXX*5191 25 OCT XXXXXXXXXXXXXXXXX,982.47,,3639275.96,AccountTransactionsReport(1).csv,1517,2024-10,False,Other Computer Services,Collaboration Tools,Collaboration Tools
,2024-10-28,8400/000 : FNB,27.60 LEMSQZY* CODE 4XX*5191 25 OCT XX6232 27.60 LEMSQZY* CODE 4XXXXX*5191 25 OCT XXXXXXXXXXXXXXXXXX,Account Payment,27.60 LEMSQZY* CODE 4XX*5191 25 OCT XX6232 27.60 LEMSQZY* CODE 4XXXXX*5191 25 OCT XXXXXXXXXXXXXXXXX,502.16,,3639778.12,AccountTransactionsReport(1).csv,1518,2024-10,False,AI Services,AI Services,AI Services
,2024-10-28,8400/000 : FNB,399.99 POE.COM 4XX*5191 26 OCT XX7921 399.99 POE.COM 4XXXXX*5191 26 OCT XXXXXXXXXXXXXXXXXXX7921,Account Payment,399.99 POE.COM 4XX*5191 26 OCT XX7921 399.99 POE.COM 4XXXXX*5191 26 OCT XXXXXXXXXXXXXXXXXXX7921,399.99,,3640178.11,AccountTransactionsReport(1).csv,1519,2024-10,False,Other Computer Services,Other Computer Services,Other Computer Services
,2024-10-29,8400/000 : FNB,"3.11 REPLIT, INC. 4XX*5191 26 OCT XX0241 3.11 REPLIT, INC. 4XXXXX*5191 26 OCT XXXXXXXXXXXXXXXXXXX024",Account Payment,"3.11 REPLIT, INC. 4XX*5191 26 OCT XX0241 3.11 REPLIT, INC. 4XXXXX*5191 26 OCT XXXXXXXXXXXXXXXXXXX02",56.24,,3640234.35,AccountTransactionsReport(1).csv,1520,2024-10,False,Other Computer Services,Other Computer Services,Other Computer Services
,2024-10-29,8400/000 : FNB,100.00 SR.HT SERVIC 4XX*5191 27 OCT XX2338 100.00 SR.HT SERVIC 4XXXXX*5191 27 OCT XXXXXXXXXXXXXXXXXX,Account Payment,100.00 SR.HT SERVIC 4XX*5191 27 OCT XX2338 100.00 SR.HT SERVIC 4XXXXX*5191 27 OCT XXXXXXXXXXXXXXXXX,1808.46,,3642042.81,AccountTransactionsReport(1).csv,1521,2024-10,False,Other Computer Services,Other Computer Services,Other Computer Services
,2024-10-29,8400/000 : FNB,50.00 ANACONDA INC. 4XX*5191 26 OCT XX4906 50.00 ANACONDA INC. 4XXXXX*5191 26 OCT XXXXXXXXXXXXXXXXXX,Account Payment,50.00 ANACONDA INC. 4XX*5191 26 OCT XX4906 50.00 ANACONDA INC. 4XXXXX*5191 26 OCT XXXXXXXXXXXXXXXXX,904.23,,3642947.04,AccountTransactionsReport(1).csv,1522,2024-10,False,Other Computer Services,Other Computer Services,Other Computer Services
,2024-10-29,8400/000 : FNB,Intuit 570.40 INTUIT *QBoo 4XXXXX*5225 27 OCT XXXXXXXXXXXXXXXXXXX1501 Intuit,Account Payment,Intuit 570.40 INTUIT *QBoo 4XXXXX*5225 27 OCT XXXXXXXXXXXXXXXXXXX1501 Intuit,570.4,,3643517.44,AccountTransactionsReport(1).csv,1523,2024-10,False,Productivity Software,Productivity Software,Productivity Software
,2024-10-29,8400/000 : FNB,Intuit 546.25 INTUIT *QBoo 4XXXXX*5225 27 OCT XXXXXXXXXXXXXXXXXXX1485 Intuit,Account Payment,Intuit 546.25 INTUIT *QBoo 4XXXXX*5225 27 OCT XXXXXXXXXXXXXXXXXXX1485 Intuit,546.25,,3644063.69,AccountTransactionsReport(1).csv,1524,2024-10,False,Productivity Software,Productivity Software,Productivity Software
,2024-10-29,8400/000 : FNB,20.00 HUGGINGFACE 4XX*5191 28 OCT XX6263 20.00 HUGGINGFACE 4XXXXX*5191 28 OCT XXXXXXXXXXXXXXXXXXX626,Account Payment,20.00 HUGGINGFACE 4XX*5191 28 OCT XX6263 20.00 HUGGINGFACE 4XXXXX*5191 28 OCT XXXXXXXXXXXXXXXXXXX62,361.69,,3644425.38,AccountTransactionsReport(1).csv,1525,2024-10,False,AI Services,AI Services,AI Services
,2024-10-29,8400/000 : FNB,BT Group BOB GROUP 4XXXXX*5191 25 OCT XXXXXXXXXXXXXXXXXXX6752 BT Group,Account Payment,BT Group BOB GROUP 4XXXXX*5191 25 OCT XXXXXXXXXXXXXXXXXXX6752 BT Group,200.0,,3644625.38,AccountTransactionsReport(1).csv,1526,2024-10,False,Other Computer Services,Other Computer Services,Other Computer Services
,2024-10-29,8400/000 : FNB,Intuit 171.12 INTUIT *QBoo 4XXXXX*5225 27 OCT XXXXXXXXXXXXXXXXXXX1493 Intuit,Account Payment,Intuit 171.12 INTUIT *QBoo 4XXXXX*5225 27 OCT XXXXXXXXXXXXXXXXXXX1493 Intuit,171.12,,3644796.5,AccountTransactionsReport(1).csv,1527,2024-10,False,Productivity Software,Productivity Software,Productivity Software
,2024-10-29,8400/000 : FNB,Shopify 3421.17 SHOPIFY* 28 4XXXXX*5191 27 OCT XXXXXXXXXXXXXXXXXXX1035 Shopify,Account Payment,Shopify 3421.17 SHOPIFY* 28 4XXXXX*5191 27 OCT XXXXXXXXXXXXXXXXXXX1035 Shopify,61870.47,,3706666.97,AccountTransactionsReport(1).csv,1528,2024-10,False,E-commerce Platforms,E-commerce Platforms,E-commerce Platforms
,2024-10-29,8400/000 : FNB,1150.00 AUTH0.COM 4XX*5191 26 OCT XX9929 1150.00 AUTH0.COM 4XXXXX*5191 26 OCT XXXXXXXXXXXXXXXXXXX992,Account Payment,1150.00 AUTH0.COM 4XX*5191 26 OCT XX9929 1150.00 AUTH0.COM 4XXXXX*5191 26 OCT XXXXXXXXXXXXXXXXXXX99,20797.28,,3727464.25,AccountTransactionsReport(1).csv,1529,2024-10,False,Security Services,Security Services,Security Services
,2024-10-29,8400/000 : FNB,299.00 ORG CHART 4XX*5191 28 OCT XX1723 299.00 ORG CHART 4XXXXX*5191 28 OCT XXXXXXXXXXXXXXXXXXX1723,Account Payment,299.00 ORG CHART 4XX*5191 28 OCT XX1723 299.00 ORG CHART 4XXXXX*5191 28 OCT XXXXXXXXXXXXXXXXXXX1723,5407.3,,3732871.55,AccountTransactionsReport(1).csv,1530,2024-10,False,Other Computer Services,Other Computer Services,Other Computer Services
,2024-10-29,8400/000 : FNB,BT Group BOB GROUP 4XXXXX*5191 25 OCT XXXXXXXXXXXXXXXXXXX5960 BT Group,Account Payment,BT Group BOB GROUP 4XXXXX*5191 25 OCT XXXXXXXXXXXXXXXXXXX5960 BT Group,2098.85,,3734970.4,AccountTransactionsReport(1).csv,1531,2024-10,False,Other Computer Services,Other Computer Services,Other Computer Services
,2024-10-30,8400/000 : FNB,Adobe Systems 22.99 Adobe 4XXXXX*5191 28 OCT XXXXXXXXXXXXXXXXXXX8796 Adobe Systems,Account Payment,Adobe Systems 22.99 Adobe 4XXXXX*5191 28 OCT XXXXXXXXXXXXXXXXXXX8796 Adobe Systems,415.76,,3735386.16,AccountTransactionsReport(1).csv,1532,2024-10,False,Productivity Software,Productivity Software,Productivity Software
,2024-10-30,8400/000 : FNB,20.36 1xTeamCity Cl 4XX*5191 26 OCT XX5053 20.36 1xTeamCity Cl 4XXXXX*5191 26 OCT XXXXXXXXXXXXXXXXXX,Account Payment,20.36 1xTeamCity Cl 4XX*5191 26 OCT XX5053 20.36 1xTeamCity Cl 4XXXXX*5191 26 OCT XXXXXXXXXXXXXXXXX,368.2,,3735754.36,AccountTransactionsReport(1).csv,1533,2024-10,False,Other Computer Services,Other Computer Services,Other Computer Services
,2024-10-30,8400/000 : FNB,9.00 GITPOD.IO 4XX*5191 28 OCT XX0460 9.00 GITPOD.IO 4XXXXX*5191 28 OCT XXXXXXXXXXXXXXXXXXX0460,Account Payment,9.00 GITPOD.IO 4XX*5191 28 OCT XX0460 9.00 GITPOD.IO 4XXXXX*5191 28 OCT XXXXXXXXXXXXXXXXXXX0460,162.76,,3735917.12,AccountTransactionsReport(1).csv,1534,2024-10,False,Development Tools,Development Tools,Development Tools
,2024-10-30,8400/000 : FNB,Canva 141.99 CANVA* I0431 4XXXXX*5225 29 OCT XXXXXXXXXXXXXXXXXXX7618 Canva,Account Payment,Canva 141.99 CANVA* I0431 4XXXXX*5225 29 OCT XXXXXXXXXXXXXXXXXXX7618 Canva,141.99,,3736059.11,AccountTransactionsReport(1).csv,1535,2024-10,False,Other Computer Services,Design Tools,Design Tools
,2024-10-30,8400/000 : FNB,72.45 1xTeamCity Cl 4XX*5191 26 OCT XX5051 72.45 1xTeamCity Cl 4XXXXX*5191 26 OCT XXXXXXXXXXXXXXXXXX,Account Payment,72.45 1xTeamCity Cl 4XX*5191 26 OCT XX5051 72.45 1xTeamCity Cl 4XXXXX*5191 26 OCT XXXXXXXXXXXXXXXXX,1310.23,,3737369.34,AccountTransactionsReport(1).csv,1536,2024-10,False,Other Computer Services,Other Computer Services,Other Computer Services
,2024-10-30,8400/000 : FNB,29.99 BEENVERIFIED 4XX*5191 28 OCT XX4541 29.99 BEENVERIFIED 4XXXXX*5191 28 OCT XXXXXXXXXXXXXXXXXXX4,Account Payment,29.99 BEENVERIFIED 4XX*5191 28 OCT XX4541 29.99 BEENVERIFIED 4XXXXX*5191 28 OCT XXXXXXXXXXXXXXXXXXX,542.35,,3737911.69,AccountTransactionsReport(1).csv,1537,2024-10,False,Other Computer Services,Other Computer Services,Other Computer Services
,2024-10-30,8400/000 : FNB,430.00 Dlocal *Micr 4XX*5191 28 OCT XX7993 430.00 Dlocal *Micr 4XXXXX*5191 28 OCT XXXXXXXXXXXXXXXXXX,Account Payment,430.00 Dlocal *Micr 4XX*5191 28 OCT XX7993 430.00 Dlocal *Micr 4XXXXX*5191 28 OCT XXXXXXXXXXXXXXXXX,430.0,,3738341.69,AccountTransactionsReport(1).csv,1538,2024-10,False,Other Computer Services,Other Computer Services,Other Computer Services
,2024-10-31,8400/000 : FNB,5050.80 FRESHWORKS 4XX*5225 29 OCT XX7473 5050.80 FRESHWORKS 4XXXXX*5225 29 OCT XXXXXXXXXXXXXXXXXXX7,Account Payment,5050.80 FRESHWORKS 4XX*5225 29 OCT XX7473 5050.80 FRESHWORKS 4XXXXX*5225 29 OCT XXXXXXXXXXXXXXXXXXX,5050.8,,3743392.49,AccountTransactionsReport(1).csv,1539,2024-10,False,Productivity Software,Productivity Software,Productivity Software
,2024-11-04,8400/000 : FNB,Google 391.60 Google GSUIT 4XXXXX*5225 01 NOV XXXXXXXXXXXXXXXXXXX8084 Google,Account Payment,Google 391.60 Google GSUIT 4XXXXX*5225 01 NOV XXXXXXXXXXXXXXXXXXX8084 Google,7702.15,,3751094.64,AccountTransactionsReport(1).csv,1540,2024-11,False,Other Computer Services,Analytics & Monitoring,Analytics & Monitoring
,2024-11-04,8400/000 : FNB,Google Store 81.36 Google GSUITE 4XXXXX*5225 01 NOV XXXXXXXXXXXXXXXXXXX8085 Google Store,Account Payment,Google Store 81.36 Google GSUITE 4XXXXX*5225 01 NOV XXXXXXXXXXXXXXXXXXX8085 Google Store,1600.23,,3752694.87,AccountTransactionsReport(1).csv,1541,2024-11,False,Other Computer Services,Analytics & Monitoring,Analytics & Monitoring
,2024-11-05,8400/000 : FNB,Main Acc,Account Payment,First National Bank FNB OBE XXXXXXXX XXXX0133 First National Bank,36.54,,3752731.41,AccountTransactionsReport(1).csv,1542,2024-11,False,Other Computer Services,Other Computer Services,Other Computer Services
,2024-11-06,8400/000 : FNB,200Klingai.com,Account Payment,200.00 Klingai.com,3598.09,,3756329.5,AccountTransactionsReport(1).csv,1543,2024-11,False,Other Computer Services,Other Computer Services,Other Computer Services
,2024-11-06,8400/000 : FNB,WWW.WOLFRAM,Account Payment,www.Wolfram,4551.58,,3760881.08,AccountTransactionsReport(1).csv,1544,2024-11,False,Other Computer Services,Other Computer Services,Other Computer Services
,2024-11-06,8400/000 : FNB,450.00 WAPPALYZER,Account Payment,450.00 WAPPALYZER,8095.7,,3768976.78,AccountTransactionsReport(1).csv,1545,2024-11,False,Other Computer Services,Other Computer Services,Other Computer Services
,2024-11-06,8400/000 : FNB,1499.00 APPDIRECT,Account Payment,1499 APPDIRECT,27085.22,,3796062.0,AccountTransactionsReport(1).csv,1546,2024-11,False,Other Computer Services,Other Computer Services,Other Computer Services
,2024-11-06,8400/000 : FNB,SAGE ACC,Account Payment,SAGE ACC,3438.0,,3799500.0,AccountTransactionsReport(1).csv,1547,2024-11,False,Other Computer Services,Other Computer Services,Other Computer Services
,2024-11-06,8400/000 : FNB,11.30 GITHUB,Account Payment,11.30 GITHUB,204.17,,3799704.17,AccountTransactionsReport(1).csv,1548,2024-11,False,Development Tools,Development Tools,Development Tools
,2024-11-06,8400/000 : FNB,19.00 CHATBASE,Account Payment,19.00 CHATBASE,341.82,,3800045.99,AccountTransactionsReport(1).csv,1549,2024-11,False,Other Computer Services,Other Computer Services,Other Computer Services
,2024-11-06,8400/000 : FNB,19.00 GITHUB,Account Payment,19.00 GITHUB,343.31,,3800389.3,AccountTransactionsReport(1).csv,1550,2024-11,False,Development Tools,Development Tools,Development Tools
,2024-11-06,8400/000 : FNB,DNH GODADDY,Account Payment,DNH GODADDY,918.85,,3801308.15,AccountTransactionsReport(1).csv,1551,2024-11,False,Domain & Hosting,Domain & Hosting,Domain & Hosting
,2024-11-06,8400/000 : FNB,JINA AI,Account Payment,JINA AI,1798.86,,3803107.01,AccountTransactionsReport(1).csv,1552,2024-11,False,Other Computer Services,Other Computer Services,Other Computer Services
,2024-11-06,8400/000 : FNB,120.75 MANAGE WP,Account Payment,120.75 MANAGE WP,2172.35,,3805279.36,AccountTransactionsReport(1).csv,1553,2024-11,False,Other Computer Services,Other Computer Services,Other Computer Services
,2024-11-06,8400/000 : FNB,120.75 MANAGE WP,Account Payment,120.75 MANAGE WP,2172.35,,3807451.71,AccountTransactionsReport(1).csv,1554,2024-11,True,Other Computer Services,Other Computer Services,Other Computer Services
,2024-11-06,8400/000 : FNB,182.85 WIX.COM,Account Payment,182.85 WIX.COM,3289.55,,3810741.26,AccountTransactionsReport(1).csv,1555,2024-11,False,E-commerce Platforms,E-commerce Platforms,E-commerce Platforms
,2024-11-07,8400/000 : FNB,40.60 FACEBK,Account Payment,4.60 FACEBK,82.75,,3810824.01,AccountTransactionsReport(1).csv,1556,2024-11,False,Other Computer Services,Other Computer Services,Other Computer Services
,2024-11-07,8400/000 : FNB,PADDLENET,Account Payment,PADDLE.NET,187.94,,3811011.95,AccountTransactionsReport(1).csv,1557,2024-11,False,Other Computer Services,Subscription Management,Subscription Management
,2024-11-07,8400/000 : FNB,13.80 FACEBK,Account Payment,13.80 FACEBK,248.27,,3811260.22,AccountTransactionsReport(1).csv,1558,2024-11,False,Other Computer Services,Other Computer Services,Other Computer Services
,2024-11-07,8400/000 : FNB,17.25 SLACK,Account Payment,17.25 SLACK,310.34,,3811570.56,AccountTransactionsReport(1).csv,1559,2024-11,False,Communication,Communication,Communication
,2024-11-07,8400/000 : FNB,23.00 FACEBK,Account Payment,23.00 FACEBK,413.78,,3811984.34,AccountTransactionsReport(1).csv,1560,2024-11,False,Other Computer Services,Other Computer Services,Other Computer Services
,2024-11-07,8400/000 : FNB,29.00 CALCOM,Account Payment,29.00 CAL.COM,521.72,,3812506.06,AccountTransactionsReport(1).csv,1561,2024-11,False,Other Computer Services,Other Computer Services,Other Computer Services
,2024-11-07,8400/000 : FNB,47.84 DIGITAL OCEAN,Account Payment,47.84 DIGITAL OCEAN,860.67,,3813366.73,AccountTransactionsReport(1).csv,1562,2024-11,False,Other Computer Services,Other Computer Services,Other Computer Services
,2024-11-07,8400/000 : FNB,67.85 LEMSQZY CHAT,Account Payment,67.85 LEMSQZY CHAT,1220.65,,3814587.38,AccountTransactionsReport(1).csv,1563,2024-11,False,AI Services,AI Services,AI Services
,2024-11-07,8400/000 : FNB,99.00 CHATBASE,Account Payment,99.00 CHATBASE,1781.05,,3816368.43,AccountTransactionsReport(1).csv,1564,2024-11,False,Other Computer Services,Other Computer Services,Other Computer Services
,2024-11-07,8400/000 : FNB,179.00 MOZSEO:HELP@,Account Payment,179.00 MOZSEO:HELP@,3220.28,,3819588.71,AccountTransactionsReport(1).csv,1565,2024-11,False,Other Computer Services,Other Computer Services,Other Computer Services
,2024-11-08,8400/000 : FNB,19.99 WOOCOMMERCE,Account Payment,19.99 WOOCOMMERCE,358.09,,3819946.8,AccountTransactionsReport(1).csv,1566,2024-11,False,Other Computer Services,Other Computer Services,Other Computer Services
,2024-11-08,8400/000 : FNB,20.00 VERCEL INC.,Account Payment,20.00 VERCEL INC,358.28,,3820305.08,AccountTransactionsReport(1).csv,1567,2024-11,False,Cloud Services,Cloud Services,Cloud Services
,2024-11-08,8400/000 : FNB,20.00 VERCEL INC.,Account Payment,20.00 VERCEL INC,358.28,,3820663.36,AccountTransactionsReport(1).csv,1568,2024-11,True,Cloud Services,Cloud Services,Cloud Services
,2024-11-08,8400/000 : FNB,3.60 GETTADRESS,Account Payment,3.60 GETADDRESS,84.61,,3820747.97,AccountTransactionsReport(1).csv,1569,2024-11,False,Other Computer Services,Other Computer Services,Other Computer Services
,2024-11-09,8400/000 : FNB,12.00 CODE SANDBOX,Account Payment,12.00 CODESANDBOX,217.99,,3820965.96,AccountTransactionsReport(1).csv,1570,2024-11,False,Other Computer Services,Other Computer Services,Other Computer Services
,2024-11-09,8400/000 : FNB,570.40 INTUIT,Account Payment,570.40 INTUIT,570.4,,3821536.36,AccountTransactionsReport(1).csv,1571,2024-11,False,Productivity Software,Productivity Software,Productivity Software
,2024-11-09,8400/000 : FNB,FRAPPE CLOUD,Account Payment,FRAPPE CLOUD,906.69,,3822443.05,AccountTransactionsReport(1).csv,1572,2024-11,False,Other Computer Services,Other Computer Services,Other Computer Services
,2024-11-09,8400/000 : FNB,99.00 MIOSALON,Account Payment,99.00 MIOSALON.COM,1798.48,,3824241.53,AccountTransactionsReport(1).csv,1573,2024-11,False,Other Computer Services,Other Computer Services,Other Computer Services
,2024-11-09,8400/000 : FNB,99.00 MIOSALON.COM,Account Payment,99.00 MIOSALON.COM,1798.48,,3826040.01,AccountTransactionsReport(1).csv,1574,2024-11,True,Other Computer Services,Other Computer Services,Other Computer Services
,2024-11-09,8400/000 : FNB,105.00 NOTION LABS,Account Payment,105.00 NOTION LABS,1907.48,,3827947.49,AccountTransactionsReport(1).csv,1575,2024-11,False,Other Computer Services,Collaboration Tools,Collaboration Tools
,2024-11-09,8400/000 : FNB,134.00 SINCH MAILGU,Account Payment,134.00 SINCH MAILGU,2434.31,,3830381.8,AccountTransactionsReport(1).csv,1576,2024-11,False,Other Computer Services,Other Computer Services,Other Computer Services
,2024-11-11,8400/000 : FNB,Payment made,Account Payment,Payment made,270.91,,3830652.71,AccountTransactionsReport(1).csv,1577,2024-11,False,Other Computer Services,Other Computer Services,Other Computer Services
,2024-11-11,8400/000 : FNB,Payment made,Account Payment,Payment made,13046.78,,3843699.49,AccountTransactionsReport(1).csv,1578,2024-11,False,Other Computer Services,Other Computer Services,Other Computer Services
,2024-11-11,8400/000 : FNB,Payment made,Account Payment,Payment made,4497.07,,3848196.56,AccountTransactionsReport(1).csv,1579,2024-11,False,Other Computer Services,Other Computer Services,Other Computer Services
,2024-11-11,8400/000 : FNB,Payment made,Account Payment,Payment made,2709.08,,3850905.64,AccountTransactionsReport(1).csv,1580,2024-11,False,Other Computer Services,Other Computer Services,Other Computer Services
,2024-11-11,8400/000 : FNB,Payment made,Account Payment,Payment made,1643.51,,3852549.15,AccountTransactionsReport(1).csv,1581,2024-11,False,Other Computer Services,Other Computer Services,Other Computer Services
,2024-11-11,8400/000 : FNB,Payment made,Account Payment,Payment made,1300.36,,3853849.51,AccountTransactionsReport(1).csv,1582,2024-11,False,Other Computer Services,Other Computer Services,Other Computer Services
,2024-11-11,8400/000 : FNB,Payment made,Account Payment,Payment made,519.24,,3854368.75,AccountTransactionsReport(1).csv,1583,2024-11,False,Other Computer Services,Other Computer Services,Other Computer Services
,2024-11-11,8400/000 : FNB,Payment made,Account Payment,Payment made,451.51,,3854820.26,AccountTransactionsReport(1).csv,1584,2024-11,False,Other Computer Services,Other Computer Services,Other Computer Services
,2024-11-12,8400/000 : FNB,Payment,Account Payment,Payment made,126.25,,3854946.51,AccountTransactionsReport(1).csv,1585,2024-11,False,Other Computer Services,Other Computer Services,Other Computer Services
,2024-11-12,8400/000 : FNB,3691.45 SHOPIFY,Account Payment,3691.45 SHOPIFY,66573.65,,3921520.16,AccountTransactionsReport(1).csv,1586,2024-11,False,E-commerce Platforms,E-commerce Platforms,E-commerce Platforms
,2024-11-12,8400/000 : FNB,2558.98 SHOPIFY,Account Payment,2558.98 SHOPIFY,46150.05,,3967670.21,AccountTransactionsReport(1).csv,1587,2024-11,False,E-commerce Platforms,E-commerce Platforms,E-commerce Platforms
,2024-11-12,8400/000 : FNB,499.00 CASSIDY AI.CO,Account Payment,499.00 CASSIDY AI.CO,8999.25,,3976669.46,AccountTransactionsReport(1).csv,1588,2024-11,False,Other Computer Services,Other Computer Services,Other Computer Services
,2024-11-12,8400/000 : FNB,240 INSOMNIA TEAM,Account Payment,240 INSOMNIA TEAM,4328.29,,3980997.75,AccountTransactionsReport(1).csv,1589,2024-11,False,Other Computer Services,Other Computer Services,Other Computer Services
,2024-11-12,8400/000 : FNB,70.00 NOTION LABS,Account Payment,70.00 NOTION LABS,1262.42,,3982260.17,AccountTransactionsReport(1).csv,1590,2024-11,False,Other Computer Services,Collaboration Tools,Collaboration Tools
,2024-11-12,8400/000 : FNB,49.00 SKRAPP IO,Account Payment,49.00 SKRAPP IO,883.7,,3983143.87,AccountTransactionsReport(1).csv,1591,2024-11,False,Other Computer Services,Other Computer Services,Other Computer Services
,2024-11-12,8400/000 : FNB,40.00 REPLIT,Account Payment,40.00 REPLIT,721.38,,3983865.25,AccountTransactionsReport(1).csv,1592,2024-11,False,Other Computer Services,Other Computer Services,Other Computer Services
,2024-11-12,8400/000 : FNB,25.00 BEECEPTOR,Account Payment,25.00 BEECEPTOR,450.86,,3984316.11,AccountTransactionsReport(1).csv,1593,2024-11,False,Other Computer Services,Other Computer Services,Other Computer Services
,2024-11-12,8400/000 : FNB,25.00 BEECEPTOR,Account Payment,25.00 BEECEPTOR,450.86,,3984766.97,AccountTransactionsReport(1).csv,1594,2024-11,True,Other Computer Services,Other Computer Services,Other Computer Services
,2024-11-12,8400/000 : FNB,20.00 VERCEL,Account Payment,20.00 VERCEL,360.69,,3985127.66,AccountTransactionsReport(1).csv,1595,2024-11,False,Cloud Services,Cloud Services,Cloud Services
,2024-11-12,8400/000 : FNB,171.12 INTUIT,Account Payment,171.12 INTUIT,171.12,,3985298.78,AccountTransactionsReport(1).csv,1596,2024-11,False,Productivity Software,Productivity Software,Productivity Software
,2024-11-13,8400/000 : FNB,189.00 GITHUB,Account Payment,189.00 GITHUB,3408.53,,3988707.31,AccountTransactionsReport(1).csv,1597,2024-11,False,Development Tools,Development Tools,Development Tools
,2024-11-13,8400/000 : FNB,74.75 SHOPIFY,Account Payment,74.75 SHOPIFY,1348.08,,3990055.39,AccountTransactionsReport(1).csv,1598,2024-11,False,E-commerce Platforms,E-commerce Platforms,E-commerce Platforms
,2024-11-13,8400/000 : FNB,570.40 INTUIT,Account Payment,570.40 INTUIT,570.4,,3990625.79,AccountTransactionsReport(1).csv,1599,2024-11,False,Productivity Software,Productivity Software,Productivity Software
,2024-11-13,8400/000 : FNB,570.40 INTUIT,Account Payment,570.40 INTUIT,570.4,,3991196.19,AccountTransactionsReport(1).csv,1600,2024-11,True,Productivity Software,Productivity Software,Productivity Software
,2024-11-14,8400/000 : FNB,20.30 GITHUB,Account Payment,20.3 GITHUB,372.59,,3991568.78,AccountTransactionsReport(1).csv,1601,2024-11,False,Development Tools,Development Tools,Development Tools
,2024-11-14,8400/000 : FNB,15.00 TABNINE,Account Payment,15.00 TABNINE,275.31,,3991844.09,AccountTransactionsReport(1).csv,1602,2024-11,False,Other Computer Services,Other Computer Services,Other Computer Services
,2024-11-14,8400/000 : FNB,942.49 GITHUB,Account Payment,942.49 GITHUB,17496.95,,4009341.04,AccountTransactionsReport(1).csv,1603,2024-11,False,Development Tools,Development Tools,Development Tools
,2024-11-14,8400/000 : FNB,99.00 DMNS,Account Payment,99.00 DMNS.APP BUSI,1837.9,,4011178.94,AccountTransactionsReport(1).csv,1604,2024-11,False,Other Computer Services,Other Computer Services,Other Computer Services
,2024-11-14,8400/000 : FNB,60.00 INSOMNIA TEAM,Account Payment,60.00 INSOMNIA TEAM,1113.87,,4012292.81,AccountTransactionsReport(1).csv,1605,2024-11,False,Other Computer Services,Other Computer Services,Other Computer Services
,2024-11-14,8400/000 : FNB,32.00 BUBBLE START,Account Payment,32.00 BUBBLE START,594.07,,4012886.88,AccountTransactionsReport(1).csv,1606,2024-11,False,Other Computer Services,Other Computer Services,Other Computer Services
,2024-11-15,8400/000 : FNB,1590 DIFY,Account Payment,1590.00 DIFY,29665.1,,4042551.98,AccountTransactionsReport(1).csv,1607,2024-11,False,Other Computer Services,Other Computer Services,Other Computer Services
,2024-11-15,8400/000 : FNB,920.00 AUTH0.COM,Account Payment,920.00 AUTH0.COM,17079.42,,4059631.4,AccountTransactionsReport(1).csv,1608,2024-11,False,Security Services,Security Services,Security Services
,2024-11-15,8400/000 : FNB,180.00 AGENCY ANALYT,Account Payment,180.00 AGENCY ANALYT,3341.62,,4062973.02,AccountTransactionsReport(1).csv,1609,2024-11,False,Other Computer Services,Other Computer Services,Other Computer Services
,2024-11-15,8400/000 : FNB,171.35 PADDLE NET,Account Payment,171.35 PADDLE.NET,3181.04,,4066154.06,AccountTransactionsReport(1).csv,1610,2024-11,False,Other Computer Services,Subscription Management,Subscription Management
,2024-11-15,8400/000 : FNB,DYNAMIX,Account Payment,DYNAMIX,1847.08,,4068001.14,AccountTransactionsReport(1).csv,1611,2024-11,False,Other Computer Services,Other Computer Services,Other Computer Services
,2024-11-15,8400/000 : FNB,OPENAI,Account Payment,OPENAI,1113.87,,4069115.01,AccountTransactionsReport(1).csv,1612,2024-11,False,AI Services,AI Services,AI Services
,2024-11-15,8400/000 : FNB,57.52 PADDFLE NET,Account Payment,57.52 PADDLE.NET,1073.17,,4070188.18,AccountTransactionsReport(1).csv,1613,2024-11,False,Other Computer Services,Subscription Management,Subscription Management
,2024-11-15,8400/000 : FNB,21.56 SLACK,Account Payment,21.56 SLACK,400.25,,4070588.43,AccountTransactionsReport(1).csv,1614,2024-11,False,Communication,Communication,Communication
,2024-11-15,8400/000 : FNB,20.00 HEROKU,Account Payment,20.00 HEROKU,371.29,,4070959.72,AccountTransactionsReport(1).csv,1615,2024-11,False,Cloud Services,Cloud Services,Cloud Services
,2024-11-15,8400/000 : FNB,11.49 GOOGLE,Account Payment,11.49 GOOGLE,214.37,,4071174.09,AccountTransactionsReport(1).csv,1616,2024-11,False,Other Computer Services,Analytics & Monitoring,Analytics & Monitoring
,2024-11-15,8400/000 : FNB,SUMO INC.,Account Payment,SUNO INC.,185.65,,4071359.74,AccountTransactionsReport(1).csv,1617,2024-11,False,Other Computer Services,Other Computer Services,Other Computer Services
,2024-11-15,8400/000 : FNB,WWW.FLUX,Account Payment,WWW.FLUX,92.82,,4071452.56,AccountTransactionsReport(1).csv,1618,2024-11,False,Other Computer Services,Other Computer Services,Other Computer Services
,2024-11-16,8400/000 : FNB,599.00 TRIPLE WHALE,Account Payment,599.00 TRIPLE WHALE,11249.35,,4082701.91,AccountTransactionsReport(1).csv,1619,2024-11,False,Other Computer Services,Other Computer Services,Other Computer Services
,2024-11-16,8400/000 : FNB,280.00 WIZA.CO,Account Payment,280.00 WIZA.CO,5224.04,,4087925.95,AccountTransactionsReport(1).csv,1620,2024-11,False,Other Computer Services,Other Computer Services,Other Computer Services
,2024-11-16,8400/000 : FNB,153.48 OPENAI,Account Payment,153.48 OPENAI,2863.52,,4090789.47,AccountTransactionsReport(1).csv,1621,2024-11,False,AI Services,AI Services,AI Services
,2024-11-16,8400/000 : FNB,69.33 REPLIT,Account Payment,69.33 REPLIT,1293.51,,4092082.98,AccountTransactionsReport(1).csv,1622,2024-11,False,Other Computer Services,Other Computer Services,Other Computer Services
,2024-11-16,8400/000 : FNB,57.40 INTUIT,Account Payment,57.40 INTUIT,570.4,,4092653.38,AccountTransactionsReport(1).csv,1623,2024-11,False,Productivity Software,Productivity Software,Productivity Software
,2024-11-16,8400/000 : FNB,30.00 ISHRAQ,Account Payment,30.00 ISHRAQ,563.41,,4093216.79,AccountTransactionsReport(1).csv,1624,2024-11,False,Other Computer Services,Other Computer Services,Other Computer Services
,2024-11-16,8400/000 : FNB,20.00 HUGGINGFACE,Account Payment,20.00 HUGGINGFACE,373.15,,4093589.94,AccountTransactionsReport(1).csv,1625,2024-11,False,AI Services,AI Services,AI Services
,2024-11-16,8400/000 : FNB,20.00 RAILWAY,Account Payment,20.00 RAILWAY,373.15,,4093963.09,AccountTransactionsReport(1).csv,1626,2024-11,False,Other Computer Services,Other Computer Services,Other Computer Services
,2024-11-16,8400/000 : FNB,14.00 GITHUB,Account Payment,14.00 GITHUB,261.2,,4094224.29,AccountTransactionsReport(1).csv,1627,2024-11,False,Development Tools,Development Tools,Development Tools
,2024-11-18,8400/000 : FNB,"7.00 NPM, INC. 4XX*5191 16 NOV XX4139 7.00 NPM, INC. 4XXXXX*5191 16 NOV XXXXXXXXXXXXXXXXXXX4139",Account Payment,"7.00 NPM, INC. 4XX*5191 16 NOV XX4139 7.00 NPM, INC. 4XXXXX*5191 16 NOV XXXXXXXXXXXXXXXXXXX4139",130.86,,4094355.15,AccountTransactionsReport(1).csv,1628,2024-11,False,Other Computer Services,Other Computer Services,Other Computer Services
,2024-11-18,8400/000 : FNB,350.00 FRAMER.COM 4XX*5191 16 NOV XX0189 350.00 FRAMER.COM 4XXXXX*5191 16 NOV XXXXXXXXXXXXXXXXXXX018,Account Payment,350.00 FRAMER.COM 4XX*5191 16 NOV XX0189 350.00 FRAMER.COM 4XXXXX*5191 16 NOV XXXXXXXXXXXXXXXXXXX01,350.0,,4094705.15,AccountTransactionsReport(1).csv,1629,2024-11,False,Other Computer Services,Design Tools,Design Tools
,2024-11-18,8400/000 : FNB,170.28 SLACK T0MN3D 4XX*5225 15 NOV XX8713 170.28 SLACK T0MN3D 4XXXXX*5225 15 NOV XXXXXXXXXXXXXXXXXX,Account Payment,170.28 SLACK T0MN3D 4XX*5225 15 NOV XX8713 170.28 SLACK T0MN3D 4XXXXX*5225 15 NOV XXXXXXXXXXXXXXXXX,3197.89,,4097903.04,AccountTransactionsReport(1).csv,1630,2024-11,False,Communication,Communication,Communication
,2024-11-18,8400/000 : FNB,174.00 INTERCOM R&D 4XX*5191 15 NOV XX6287 174.00 INTERCOM R&D 4XXXXX*5191 15 NOV XXXXXXXXXXXXXXXXXX,Account Payment,174.00 INTERCOM R&D 4XX*5191 15 NOV XX6287 174.00 INTERCOM R&D 4XXXXX*5191 15 NOV XXXXXXXXXXXXXXXXX,3252.61,,4101155.65,AccountTransactionsReport(1).csv,1631,2024-11,False,Other Computer Services,Customer Support,Customer Support
,2024-11-18,8400/000 : FNB,231.95 HOLASPIRIT 4XX*5225 15 NOV XX3529 231.95 HOLASPIRIT 4XXXXX*5225 15 NOV XXXXXXXXXXXXXXXXXXX352,Account Payment,231.95 HOLASPIRIT 4XX*5225 15 NOV XX3529 231.95 HOLASPIRIT 4XXXXX*5225 15 NOV XXXXXXXXXXXXXXXXXXX35,4580.8,,4105736.45,AccountTransactionsReport(1).csv,1632,2024-11,False,Other Computer Services,Other Computer Services,Other Computer Services
,2024-11-18,8400/000 : FNB,376.40 HOLASPIRIT 4XX*5225 15 NOV XX6139 376.40 HOLASPIRIT 4XXXXX*5225 15 NOV XXXXXXXXXXXXXXXXXXX613,Account Payment,376.40 HOLASPIRIT 4XX*5225 15 NOV XX6139 376.40 HOLASPIRIT 4XXXXX*5225 15 NOV XXXXXXXXXXXXXXXXXXX61,7433.55,,4113170.0,AccountTransactionsReport(1).csv,1633,2024-11,False,Other Computer Services,Other Computer Services,Other Computer Services
,2024-11-19,8400/000 : FNB,4.99 DEEPAI 4XXXXX*5191 17 NOV XXXXXXXXXXXXXXXXXXX2752 4.99 DEEPAI 4XXXXX*5191 17 NOV XXXXXXXXXXXXXX,Account Receipt,4.99 DEEPAI 4XXXXX*5191 17 NOV XXXXXXXXXXXXXXXXXXX2752 4.99 DEEPAI 4XXXXX*5191 17 NOV XXXXXXXXXXXXX,,88.47,4113081.53,AccountTransactionsReport(1).csv,1634,2024-11,False,Other Computer Services,Other Computer Services,Other Computer Services
,2024-11-19,8400/000 : FNB,4.99 DEEPAI 4XX*5191 15 NOV XX8364 4.99 DEEPAI 4XXXXX*5191 15 NOV XXXXXXXXXXXXXXXXXXX8364,Account Payment,4.99 DEEPAI 4XX*5191 15 NOV XX8364 4.99 DEEPAI 4XXXXX*5191 15 NOV XXXXXXXXXXXXXXXXXXX8364,93.28,,4113174.81,AccountTransactionsReport(1).csv,1635,2024-11,False,Other Computer Services,Other Computer Services,Other Computer Services
,2024-11-19,8400/000 : FNB,"7.00 NPM, INC. 4XX*5191 16 NOV XX9834 7.00 NPM, INC. 4XXXXX*5191 16 NOV XXXXXXXXXXXXXXXXXXX9834",Account Payment,"7.00 NPM, INC. 4XX*5191 16 NOV XX9834 7.00 NPM, INC. 4XXXXX*5191 16 NOV XXXXXXXXXXXXXXXXXXX9834",130.86,,4113305.67,AccountTransactionsReport(1).csv,1636,2024-11,False,Other Computer Services,Other Computer Services,Other Computer Services
,2024-11-19,8400/000 : FNB,"7.00 NPM, INC. 4XX*5191 16 NOV XX8801 7.00 NPM, INC. 4XXXXX*5191 16 NOV XXXXXXXXXXXXXXXXXXX8801",Account Payment,"7.00 NPM, INC. 4XX*5191 16 NOV XX8801 7.00 NPM, INC. 4XXXXX*5191 16 NOV XXXXXXXXXXXXXXXXXXX8801",130.86,,4113436.53,AccountTransactionsReport(1).csv,1637,2024-11,False,Other Computer Services,Other Computer Services,Other Computer Services
,2024-11-19,8400/000 : FNB,"7.00 NPM, INC. 4XX*5191 16 NOV XX0467 7.00 NPM, INC. 4XXXXX*5191 16 NOV XXXXXXXXXXXXXXXXXXX0467",Account Payment,"7.00 NPM, INC. 4XX*5191 16 NOV XX0467 7.00 NPM, INC. 4XXXXX*5191 16 NOV XXXXXXXXXXXXXXXXXXX0467",130.86,,4113567.39,AccountTransactionsReport(1).csv,1638,2024-11,False,Other Computer Services,Other Computer Services,Other Computer Services
,2024-11-19,8400/000 : FNB,9.00 TWENTY.COM 4XX*5191 16 NOV XX7017 9.00 TWENTY.COM 4XXXXX*5191 16 NOV XXXXXXXXXXXXXXXXXXX7017,Account Payment,9.00 TWENTY.COM 4XX*5191 16 NOV XX7017 9.00 TWENTY.COM 4XXXXX*5191 16 NOV XXXXXXXXXXXXXXXXXXX7017,168.24,,4113735.63,AccountTransactionsReport(1).csv,1639,2024-11,False,Other Computer Services,Other Computer Services,Other Computer Services
,2024-11-19,8400/000 : FNB,20.00 VERCEL INC. 4XX*5191 16 NOV XX3344 20.00 VERCEL INC. 4XXXXX*5191 16 NOV XXXXXXXXXXXXXXXXXXX334,Account Payment,20.00 VERCEL INC. 4XX*5191 16 NOV XX3344 20.00 VERCEL INC. 4XXXXX*5191 16 NOV XXXXXXXXXXXXXXXXXXX33,373.86,,4114109.49,AccountTransactionsReport(1).csv,1640,2024-11,False,Cloud Services,Cloud Services,Cloud Services
,2024-11-19,8400/000 : FNB,"99.00 PLAYFAB, INC. 4XX*5191 17 NOV XX0574 99.00 PLAYFAB, INC. 4XXXXX*5191 17 NOV XXXXXXXXXXXXXXXXXX",Account Payment,"99.00 PLAYFAB, INC. 4XX*5191 17 NOV XX0574 99.00 PLAYFAB, INC. 4XXXXX*5191 17 NOV XXXXXXXXXXXXXXXXX",1850.62,,4115960.11,AccountTransactionsReport(1).csv,1641,2024-11,False,Other Computer Services,Other Computer Services,Other Computer Services
,2024-11-19,8400/000 : FNB,203.88 AFFORAI.COM 4XX*5191 16 NOV XX1573 203.88 AFFORAI.COM 4XXXXX*5191 16 NOV XXXXXXXXXXXXXXXXXXX1,Account Payment,203.88 AFFORAI.COM 4XX*5191 16 NOV XX1573 203.88 AFFORAI.COM 4XXXXX*5191 16 NOV XXXXXXXXXXXXXXXXXXX,3811.16,,4119771.27,AccountTransactionsReport(1).csv,1642,2024-11,False,Other Computer Services,Other Computer Services,Other Computer Services
,2024-11-19,8400/000 : FNB,852.00 10WEB.IO 4XX*5191 17 NOV XX9271 852.00 10WEB.IO 4XXXXX*5191 17 NOV XXXXXXXXXXXXXXXXXXX9271,Account Payment,852.00 10WEB.IO 4XX*5191 17 NOV XX9271 852.00 10WEB.IO 4XXXXX*5191 17 NOV XXXXXXXXXXXXXXXXXXX9271,15926.55,,4135697.82,AccountTransactionsReport(1).csv,1643,2024-11,False,Other Computer Services,Other Computer Services,Other Computer Services
,2024-11-20,8400/000 : FNB,Facebook 289.72 FACEBK* 4XXXXX*5191 18 NOV XXXXXXXXXXXXXXXXXXX5056 Facebook,Account Payment,Facebook 289.72 FACEBK* 4XXXXX*5191 18 NOV XXXXXXXXXXXXXXXXXXX5056 Facebook,289.72,,4135987.54,AccountTransactionsReport(1).csv,1644,2024-11,False,Marketing Tools,Marketing Tools,Marketing Tools
,2024-11-20,8400/000 : FNB,"Github Inc. 42.00 GITHUB, INC. 4XXXXX*5191 18 NOV XXXXXXXXXXXXXXXXXXX1437 Github Inc.",Account Payment,"Github Inc. 42.00 GITHUB, INC. 4XXXXX*5191 18 NOV XXXXXXXXXXXXXXXXXXX1437 Github Inc.",785.11,,4136772.65,AccountTransactionsReport(1).csv,1645,2024-11,False,Development Tools,Development Tools,Development Tools
,2024-11-20,8400/000 : FNB,Google Service Charges/Fees #INT PYMT FEE-34.99 Googl Google,Account Payment,Google Service Charges/Fees INT PYMT FEE-34.99 Googl Google,0.61,,4136773.26,AccountTransactionsReport(1).csv,1646,2024-11,False,Other Computer Services,Analytics & Monitoring,Analytics & Monitoring
,2024-11-20,8400/000 : FNB,299.00 MANGOAPPS 4XX*5191 18 NOV XX7852 299.00 MANGOAPPS 4XXXXX*5191 18 NOV XXXXXXXXXXXXXXXXXXX7852,Account Payment,299.00 MANGOAPPS 4XX*5191 18 NOV XX7852 299.00 MANGOAPPS 4XXXXX*5191 18 NOV XXXXXXXXXXXXXXXXXXX7852,5589.24,,4142362.5,AccountTransactionsReport(1).csv,1647,2024-11,False,Other Computer Services,Other Computer Services,Other Computer Services
,2024-11-21,8400/000 : FNB,Webflow 420.00 WEBFLOW.COM 4XXXXX*5191 20 NOV XXXXXXXXXXXXXXXXXXX2053 Webflow,Account Payment,Webflow 420.00 WEBFLOW.COM 4XXXXX*5191 20 NOV XXXXXXXXXXXXXXXXXXX2053 Webflow,7792.5,,4150155.0,AccountTransactionsReport(1).csv,1648,2024-11,False,Other Computer Services,Content Management,Content Management
,2024-11-21,8400/000 : FNB,299.00 MANGOAPPS 4XX*5191 19 NOV XX8129 299.00 MANGOAPPS 4XXXXX*5191 19 NOV XXXXXXXXXXXXXXXXXXX8129,Account Payment,299.00 MANGOAPPS 4XX*5191 19 NOV XX8129 299.00 MANGOAPPS 4XXXXX*5191 19 NOV XXXXXXXXXXXXXXXXXXX8129,5565.39,,4155720.39,AccountTransactionsReport(1).csv,1649,2024-11,False,Other Computer Services,Other Computer Services,Other Computer Services
,2024-11-21,8400/000 : FNB,59.00 GREENBACK.COM 4XX*5225 19 NOV XX0633 59.00 GREENBACK.COM 4XXXXX*5225 19 NOV XXXXXXXXXXXXXXXXXX,Account Payment,59.00 GREENBACK.COM 4XX*5225 19 NOV XX0633 59.00 GREENBACK.COM 4XXXXX*5225 19 NOV XXXXXXXXXXXXXXXXX,1098.18,,4156818.57,AccountTransactionsReport(1).csv,1650,2024-11,False,Other Computer Services,Other Computer Services,Other Computer Services
,2024-11-21,8400/000 : FNB,5.00 COMPONENTS.STU 4XX*5191 19 NOV XX8074 5.00 COMPONENTS.STU 4XXXXX*5191 19 NOV XXXXXXXXXXXXXXXXXX,Account Payment,5.00 COMPONENTS.STU 4XX*5191 19 NOV XX8074 5.00 COMPONENTS.STU 4XXXXX*5191 19 NOV XXXXXXXXXXXXXXXXX,93.06,,4156911.63,AccountTransactionsReport(1).csv,1651,2024-11,False,Other Computer Services,Other Computer Services,Other Computer Services
,2024-11-22,8400/000 : FNB,"74.00 PIPEDREAM, IN 4XX*5191 20 NOV XX6144 74.00 PIPEDREAM, IN 4XXXXX*5191 20 NOV XXXXXXXXXXXXXXXXXX",Account Payment,"74.00 PIPEDREAM, IN 4XX*5191 20 NOV XX6144 74.00 PIPEDREAM, IN 4XXXXX*5191 20 NOV XXXXXXXXXXXXXXXXX",1372.96,,4158284.59,AccountTransactionsReport(1).csv,1652,2024-11,False,Other Computer Services,Other Computer Services,Other Computer Services
,2024-11-22,8400/000 : FNB,54.00 AIRTABLE.COM/ 4XX*5191 21 NOV XX8607 54.00 AIRTABLE.COM/ 4XXXXX*5191 21 NOV XXXXXXXXXXXXXXXXXX,Account Payment,54.00 AIRTABLE.COM/ 4XX*5191 21 NOV XX8607 54.00 AIRTABLE.COM/ 4XXXXX*5191 21 NOV XXXXXXXXXXXXXXXXX,1002.47,,4159287.06,AccountTransactionsReport(1).csv,1653,2024-11,False,Other Computer Services,Collaboration Tools,Collaboration Tools
,2024-11-25,8400/000 : FNB,299.00 ORG CHART 4XX*5191 22 NOV XX4213 299.00 ORG CHART 4XXXXX*5191 22 NOV XXXXXXXXXXXXXXXXXXX4213,Account Payment,299.00 ORG CHART 4XX*5191 22 NOV XX4213 299.00 ORG CHART 4XXXXX*5191 22 NOV XXXXXXXXXXXXXXXXXXX4213,5549.71,,4164836.77,AccountTransactionsReport(1).csv,1654,2024-11,False,Other Computer Services,Other Computer Services,Other Computer Services
,2024-11-26,8400/000 : FNB,672.75 FIGMA 4XX*5225 24 NOV XX7631 672.75 FIGMA 4XXXXX*5225 24 NOV XXXXXXXXXXXXXXXXXXX7631,Account Payment,672.75 FIGMA 4XX*5225 24 NOV XX7631 672.75 FIGMA 4XXXXX*5225 24 NOV XXXXXXXXXXXXXXXXXXX7631,12466.41,,4177303.18,AccountTransactionsReport(1).csv,1655,2024-11,False,Other Computer Services,Design Tools,Design Tools
,2024-11-26,8400/000 : FNB,89.00 SENTRY 4XX*5191 24 NOV XX5397 89.00 SENTRY 4XXXXX*5191 24 NOV XXXXXXXXXXXXXXXXXXX5397,Account Payment,89.00 SENTRY 4XX*5191 24 NOV XX5397 89.00 SENTRY 4XXXXX*5191 24 NOV XXXXXXXXXXXXXXXXXXX5397,1649.22,,4178952.4,AccountTransactionsReport(1).csv,1656,2024-11,False,Other Computer Services,Analytics & Monitoring,Analytics & Monitoring
,2024-11-26,8400/000 : FNB,30.00 HASURA 4XX*5191 23 NOV XX3526 30.00 HASURA 4XXXXX*5191 23 NOV XXXXXXXXXXXXXXXXXXX3526,Account Payment,30.00 HASURA 4XX*5191 23 NOV XX3526 30.00 HASURA 4XXXXX*5191 23 NOV XXXXXXXXXXXXXXXXXXX3526,555.92,,4179508.32,AccountTransactionsReport(1).csv,1657,2024-11,False,Other Computer Services,Other Computer Services,Other Computer Services
,2024-11-26,8400/000 : FNB,Dropbox 18.38 DROPBOX*WPT1T 4XXXXX*5191 24 NOV XXXXXXXXXXXXXXXXXXX0557 Dropbox,Account Payment,Dropbox 18.38 DROPBOX*WPT1T 4XXXXX*5191 24 NOV XXXXXXXXXXXXXXXXXXX0557 Dropbox,340.59,,4179848.91,AccountTransactionsReport(1).csv,1658,2024-11,False,Other Computer Services,Other Computer Services,Other Computer Services
,2024-11-26,8400/000 : FNB,10.00 MATTERMOST 4XX*5191 24 NOV XX2442 10.00 MATTERMOST 4XXXXX*5191 24 NOV XXXXXXXXXXXXXXXXXXX2442,Account Payment,10.00 MATTERMOST 4XX*5191 24 NOV XX2442 10.00 MATTERMOST 4XXXXX*5191 24 NOV XXXXXXXXXXXXXXXXXXX2442,185.3,,4180034.21,AccountTransactionsReport(1).csv,1659,2024-11,False,Other Computer Services,Other Computer Services,Other Computer Services
,2024-11-26,8400/000 : FNB,"6.00 DOCKER, INC. 4XX*5191 24 NOV XX8974 6.00 DOCKER, INC. 4XXXXX*5191 24 NOV XXXXXXXXXXXXXXXXXXX897",Account Payment,"6.00 DOCKER, INC. 4XX*5191 24 NOV XX8974 6.00 DOCKER, INC. 4XXXXX*5191 24 NOV XXXXXXXXXXXXXXXXXXX89",111.18,,4180145.39,AccountTransactionsReport(1).csv,1660,2024-11,False,Other Computer Services,Other Computer Services,Other Computer Services
,2024-11-29,8400/000 : FNB,Intuit 570.40 INTUIT *QBoo 4XXXXX*5225 27 NOV XXXXXXXXXXXXXXXXXXX8634 Intuit,Account Payment,Intuit 570.40 INTUIT *QBoo 4XXXXX*5225 27 NOV XXXXXXXXXXXXXXXXXXX8634 Intuit,570.4,,4180715.79,AccountTransactionsReport(1).csv,1661,2024-11,False,Productivity Software,Productivity Software,Productivity Software
,2024-11-29,8400/000 : FNB,Intuit 546.25 INTUIT *QBoo 4XXXXX*5225 27 NOV XXXXXXXXXXXXXXXXXXX7298 Intuit,Account Payment,Intuit 546.25 INTUIT *QBoo 4XXXXX*5225 27 NOV XXXXXXXXXXXXXXXXXXX7298 Intuit,546.25,,4181262.04,AccountTransactionsReport(1).csv,1662,2024-11,False,Productivity Software,Productivity Software,Productivity Software
,2024-11-29,8400/000 : FNB,399.99 POE.COM 4XX*5191 27 NOV XX3364 399.99 POE.COM 4XXXXX*5191 27 NOV XXXXXXXXXXXXXXXXXXX3364,Account Payment,399.99 POE.COM 4XX*5191 27 NOV XX3364 399.99 POE.COM 4XXXXX*5191 27 NOV XXXXXXXXXXXXXXXXXXX3364,399.99,,4181662.03,AccountTransactionsReport(1).csv,1663,2024-11,False,Other Computer Services,Other Computer Services,Other Computer Services
,2024-11-29,8400/000 : FNB,Intuit 171.12 INTUIT *QBoo 4XXXXX*5225 27 NOV XXXXXXXXXXXXXXXXXXX7439 Intuit,Account Payment,Intuit 171.12 INTUIT *QBoo 4XXXXX*5225 27 NOV XXXXXXXXXXXXXXXXXXX7439 Intuit,171.12,,4181833.15,AccountTransactionsReport(1).csv,1664,2024-11,False,Productivity Software,Productivity Software,Productivity Software
,2024-11-30,8400/000 : FNB,1150.00 AUTH0.COM 4XX*5191 29 NOV XX4583 1150.00 AUTH0.COM 4XXXXX*5191 29 NOV XXXXXXXXXXXXXXXXXXX458,Account Payment,1150.00 AUTH0.COM 4XX*5191 29 NOV XX4583 1150.00 AUTH0.COM 4XXXXX*5191 29 NOV XXXXXXXXXXXXXXXXXXX45,21448.04,,4203281.19,AccountTransactionsReport(1).csv,1665,2024-11,False,Security Services,Security Services,Security Services
,2024-11-30,8400/000 : FNB,150.00 AUTH0.COM 4XX*5191 28 NOV XX2610 150.00 AUTH0.COM 4XXXXX*5191 28 NOV XXXXXXXXXXXXXXXXXXX2610,Account Payment,150.00 AUTH0.COM 4XX*5191 28 NOV XX2610 150.00 AUTH0.COM 4XXXXX*5191 28 NOV XXXXXXXXXXXXXXXXXXX2610,2797.57,,4206078.76,AccountTransactionsReport(1).csv,1666,2024-11,False,Security Services,Security Services,Security Services
,2024-11-30,8400/000 : FNB,29.99 BEENVERIFIED 4XX*5191 28 NOV XX7798 29.99 BEENVERIFIED 4XXXXX*5191 28 NOV XXXXXXXXXXXXXXXXXXX7,Account Payment,29.99 BEENVERIFIED 4XX*5191 28 NOV XX7798 29.99 BEENVERIFIED 4XXXXX*5191 28 NOV XXXXXXXXXXXXXXXXXXX,558.35,,4206637.11,AccountTransactionsReport(1).csv,1667,2024-11,False,Other Computer Services,Other Computer Services,Other Computer Services
,2024-11-30,8400/000 : FNB,430.00 Dlocal *Micr 4XX*5191 28 NOV XX5694 430.00 Dlocal *Micr 4XXXXX*5191 28 NOV XXXXXXXXXXXXXXXXXX,Account Payment,430.00 Dlocal *Micr 4XX*5191 28 NOV XX5694 430.00 Dlocal *Micr 4XXXXX*5191 28 NOV XXXXXXXXXXXXXXXXX,430.0,,4207067.11,AccountTransactionsReport(1).csv,1668,2024-11,False,Other Computer Services,Other Computer Services,Other Computer Services
,2024-11-30,8400/000 : FNB,20.00 HUGGINGFACE 4XX*5191 28 NOV XX0905 20.00 HUGGINGFACE 4XXXXX*5191 28 NOV XXXXXXXXXXXXXXXXXXX090,Account Payment,20.00 HUGGINGFACE 4XX*5191 28 NOV XX0905 20.00 HUGGINGFACE 4XXXXX*5191 28 NOV XXXXXXXXXXXXXXXXXXX09,372.36,,4207439.47,AccountTransactionsReport(1).csv,1669,2024-11,False,AI Services,AI Services,AI Services
,2024-11-30,8400/000 : FNB,9.00 GITPOD.IO 4XX*5191 28 NOV XX2644 9.00 GITPOD.IO 4XXXXX*5191 28 NOV XXXXXXXXXXXXXXXXXXX2644,Account Payment,9.00 GITPOD.IO 4XX*5191 28 NOV XX2644 9.00 GITPOD.IO 4XXXXX*5191 28 NOV XXXXXXXXXXXXXXXXXXX2644,167.56,,4207607.03,AccountTransactionsReport(1).csv,1670,2024-11,False,Development Tools,Development Tools,Development Tools
,2024-11-30,8400/000 : FNB,Canva 141.99 CANVA* I0435 4XXXXX*5225 29 NOV XXXXXXXXXXXXXXXXXXX5312 Canva,Account Payment,Canva 141.99 CANVA* I0435 4XXXXX*5225 29 NOV XXXXXXXXXXXXXXXXXXX5312 Canva,141.99,,4207749.02,AccountTransactionsReport(1).csv,1671,2024-11,False,Other Computer Services,Design Tools,Design Tools
,2024-12-02,8400/000 : FNB,Shopify 3421.17 SHOPIFY* 30 4XXXXX*5191 29 NOV XXXXXXXXXXXXXXXXXXX7959 Shopify,Account Payment,Shopify 3421.17 SHOPIFY* 30 4XXXXX*5191 29 NOV XXXXXXXXXXXXXXXXXXX7959 Shopify,63806.44,,4271555.46,AccountTransactionsReport(1).csv,1672,2024-12,False,E-commerce Platforms,E-commerce Platforms,E-commerce Platforms
,2024-12-02,8400/000 : FNB,5050.80 FRESHWORKS 4XX*5225 29 NOV XX0934 5050.80 FRESHWORKS 4XXXXX*5225 29 NOV XXXXXXXXXXXXXXXXXXX0,Account Payment,5050.80 FRESHWORKS 4XX*5225 29 NOV XX0934 5050.80 FRESHWORKS 4XXXXX*5225 29 NOV XXXXXXXXXXXXXXXXXXX,5050.8,,4276606.26,AccountTransactionsReport(1).csv,1673,2024-12,False,Productivity Software,Productivity Software,Productivity Software
,2024-12-02,8400/000 : FNB,67.85 LEMSQZY* CHAT 4XX*5191 30 NOV XX1451 67.85 LEMSQZY* CHAT 4XXXXX*5191 30 NOV XXXXXXXXXXXXXXXXXX,Account Payment,67.85 LEMSQZY* CHAT 4XX*5191 30 NOV XX1451 67.85 LEMSQZY* CHAT 4XXXXX*5191 30 NOV XXXXXXXXXXXXXXXXX,1255.58,,4277861.84,AccountTransactionsReport(1).csv,1674,2024-12,False,AI Services,AI Services,AI Services
,2024-12-02,8400/000 : FNB,Facebook 652.77 FACEBK *CTLV 4XXXXX*5191 30 NOV XXXXXXXXXXXXXXXXXXX1363 Facebook,Account Payment,Facebook 652.77 FACEBK *CTLV 4XXXXX*5191 30 NOV XXXXXXXXXXXXXXXXXXX1363 Facebook,652.77,,4278514.61,AccountTransactionsReport(1).csv,1675,2024-12,False,Marketing Tools,Marketing Tools,Marketing Tools
,2024-12-02,8400/000 : FNB,5.00 COMPONENTS.STU 4XX*5191 29 NOV XX6607 5.00 COMPONENTS.STU 4XXXXX*5191 29 NOV XXXXXXXXXXXXXXXXXX,Account Payment,5.00 COMPONENTS.STU 4XX*5191 29 NOV XX6607 5.00 COMPONENTS.STU 4XXXXX*5191 29 NOV XXXXXXXXXXXXXXXXX,93.25,,4278607.86,AccountTransactionsReport(1).csv,1676,2024-12,False,Other Computer Services,Other Computer Services,Other Computer Services
,2024-12-03,8400/000 : FNB,134.00 SINCH MAILGU 4XX*5191 01 DEC XX6900 134.00 SINCH MAILGU 4XXXXX*5191 01 DEC XXXXXXXXXXXXXXXXXX,Account Payment,134.00 SINCH MAILGU 4XX*5191 01 DEC XX6900 134.00 SINCH MAILGU 4XXXXX*5191 01 DEC XXXXXXXXXXXXXXXXX,2479.7,,4281087.56,AccountTransactionsReport(1).csv,1677,2024-12,False,Other Computer Services,Other Computer Services,Other Computer Services
,2024-12-03,8400/000 : FNB,Google Store 83.96 Google GSUITE 4XXXXX*5225 01 DEC XXXXXXXXXXXXXXXXXXX0083 Google Store,Account Payment,Google Store 83.96 Google GSUITE 4XXXXX*5225 01 DEC XXXXXXXXXXXXXXXXXXX0083 Google Store,1643.07,,4282730.63,AccountTransactionsReport(1).csv,1678,2024-12,False,Other Computer Services,Analytics & Monitoring,Analytics & Monitoring
,2024-12-03,8400/000 : FNB,612.00 MERMAID CHAR 4XX*5191 01 DEC XX5697 612.00 MERMAID CHAR 4XXXXX*5191 01 DEC XXXXXXXXXXXXXXXXXX,Account Payment,612.00 MERMAID CHAR 4XX*5191 01 DEC XX5697 612.00 MERMAID CHAR 4XXXXX*5191 01 DEC XXXXXXXXXXXXXXXXX,11325.19,,4294055.82,AccountTransactionsReport(1).csv,1679,2024-12,False,Other Computer Services,Other Computer Services,Other Computer Services
,2024-12-03,8400/000 : FNB,540.00 AIRTABLE.COM 4XX*5191 02 DEC XX0020 540.00 AIRTABLE.COM 4XXXXX*5191 02 DEC XXXXXXXXXXXXXXXXXX,Account Payment,540.00 AIRTABLE.COM 4XX*5191 02 DEC XX0020 540.00 AIRTABLE.COM 4XXXXX*5191 02 DEC XXXXXXXXXXXXXXXXX,9992.82,,4304048.64,AccountTransactionsReport(1).csv,1680,2024-12,False,Other Computer Services,Collaboration Tools,Collaboration Tools
,2024-12-03,8400/000 : FNB,Google 391.60 Google GSUIT 4XXXXX*5225 01 DEC XXXXXXXXXXXXXXXXXXX3089 Google,Account Payment,Google 391.60 Google GSUIT 4XXXXX*5225 01 DEC XXXXXXXXXXXXXXXXXXX3089 Google,7663.47,,4311712.11,AccountTransactionsReport(1).csv,1681,2024-12,False,Other Computer Services,Analytics & Monitoring,Analytics & Monitoring
,2024-12-03,8400/000 : FNB,Canva 6799.90 CANVA* I043 4XXXXX*5225 01 DEC XXXXXXXXXXXXXXXXXXX3574 Canva,Account Payment,Canva 6799.90 CANVA* I043 4XXXXX*5225 01 DEC XXXXXXXXXXXXXXXXXXX3574 Canva,6799.9,,4318512.01,AccountTransactionsReport(1).csv,1682,2024-12,False,Other Computer Services,Design Tools,Design Tools
,2024-12-03,8400/000 : FNB,Google 298.08 Google GSUIT 4XXXXX*5191 01 DEC XXXXXXXXXXXXXXXXXXX5047 Google,Account Payment,Google 298.08 Google GSUIT 4XXXXX*5191 01 DEC XXXXXXXXXXXXXXXXXXX5047 Google,5516.04,,4324028.05,AccountTransactionsReport(1).csv,1683,2024-12,False,Other Computer Services,Analytics & Monitoring,Analytics & Monitoring
,2024-12-03,8400/000 : FNB,"Wix.com 182.85 Wix.Com, Inc 4XXXXX*5191 02 DEC XXXXXXXXXXXXXXXXXXX0075 Wix.com",Account Payment,"Wix.com 182.85 Wix.Com, Inc 4XXXXX*5191 02 DEC XXXXXXXXXXXXXXXXXXX0075 Wix.com",3410.24,,4327438.29,AccountTransactionsReport(1).csv,1684,2024-12,False,E-commerce Platforms,E-commerce Platforms,E-commerce Platforms
,2024-12-03,8400/000 : FNB,50.09 FRAPPE CLOUD 4XX*5191 30 NOV XX5621 50.09 FRAPPE CLOUD 4XXXXX*5191 30 NOV XXXXXXXXXXXXXXXXXXX5,Account Payment,50.09 FRAPPE CLOUD 4XX*5191 30 NOV XX5621 50.09 FRAPPE CLOUD 4XXXXX*5191 30 NOV XXXXXXXXXXXXXXXXXXX,926.93,,4328365.22,AccountTransactionsReport(1).csv,1685,2024-12,False,Other Computer Services,Other Computer Services,Other Computer Services
,2024-12-03,8400/000 : FNB,Digitalocean 47.84 DIGITALOCEAN. 4XXXXX*5191 01 DEC XXXXXXXXXXXXXXXXXXX1410 Digitalocean,Account Payment,Digitalocean 47.84 DIGITALOCEAN. 4XXXXX*5191 01 DEC XXXXXXXXXXXXXXXXXXX1410 Digitalocean,885.29,,4329250.51,AccountTransactionsReport(1).csv,1686,2024-12,False,Cloud Services,Cloud Services,Cloud Services
,2024-12-03,8400/000 : FNB,17.25 SLACK T06A3T4 4XX*5191 01 DEC XX9598 17.25 SLACK T06A3T4 4XXXXX*5191 01 DEC XXXXXXXXXXXXXXXXXX,Account Payment,17.25 SLACK T06A3T4 4XX*5191 01 DEC XX9598 17.25 SLACK T06A3T4 4XXXXX*5191 01 DEC XXXXXXXXXXXXXXXXX,319.22,,4329569.73,AccountTransactionsReport(1).csv,1687,2024-12,False,Communication,Communication,Communication
,2024-12-04,8400/000 : FNB,BT Group BOB GROUP 4XXXXX*5191 01 DEC XXXXXXXXXXXXXXXXXXX9596 BT Group,Account Payment,BT Group BOB GROUP 4XXXXX*5191 01 DEC XXXXXXXXXXXXXXXXXXX9596 BT Group,2298.85,,4331868.58,AccountTransactionsReport(1).csv,1688,2024-12,False,Other Computer Services,Other Computer Services,Other Computer Services
,2024-12-04,8400/000 : FNB,345.00 1xTeamCity C 4XX*5191 01 DEC XX6059 345.00 1xTeamCity C 4XXXXX*5191 01 DEC XXXXXXXXXXXXXXXXXX,Account Payment,345.00 1xTeamCity C 4XX*5191 01 DEC XX6059 345.00 1xTeamCity C 4XXXXX*5191 01 DEC XXXXXXXXXXXXXXXXX,6384.3,,4338252.88,AccountTransactionsReport(1).csv,1689,2024-12,False,Other Computer Services,Other Computer Services,Other Computer Services
,2024-12-04,8400/000 : FNB,576.00 LEONARDO.AI 4XX*5225 02 DEC XX9108 576.00 LEONARDO.AI 4XXXXX*5225 02 DEC XXXXXXXXXXXXXXXXXXX9,Account Payment,576.00 LEONARDO.AI 4XX*5225 02 DEC XX9108 576.00 LEONARDO.AI 4XXXXX*5225 02 DEC XXXXXXXXXXXXXXXXXXX,10659.0,,4348911.88,AccountTransactionsReport(1).csv,1690,2024-12,False,Other Computer Services,Other Computer Services,Other Computer Services
,2024-12-06,8400/000 : FNB,CLOUDFLARE 4XX*5191 04 DEC XX0992 CLOUDFLARE 4XXXXX*5191 04 DEC XXXXXXXXXXXXXXXXXXX0992,Account Payment,CLOUDFLARE 4XX*5191 04 DEC XX0992 CLOUDFLARE 4XXXXX*5191 04 DEC XXXXXXXXXXXXXXXXXXX0992,14.31,,4348926.19,AccountTransactionsReport(1).csv,1691,2024-12,False,Cloud Services,Cloud Services,Cloud Services
,2024-12-06,8400/000 : FNB,"Github Inc. 10.77 GITHUB, INC. 4XXXXX*5225 04 DEC XXXXXXXXXXXXXXXXXXX5943 Github Inc.",Account Payment,"Github Inc. 10.77 GITHUB, INC. 4XXXXX*5225 04 DEC XXXXXXXXXXXXXXXXXXX5943 Github Inc.",200.12,,4349126.31,AccountTransactionsReport(1).csv,1692,2024-12,False,Development Tools,Development Tools,Development Tools
,2024-12-06,8400/000 : FNB,19.00 CHATBASE 4XX*5191 05 DEC XX4805 19.00 CHATBASE 4XXXXX*5191 05 DEC XXXXXXXXXXXXXXXXXXX4805,Account Payment,19.00 CHATBASE 4XX*5191 05 DEC XX4805 19.00 CHATBASE 4XXXXX*5191 05 DEC XXXXXXXXXXXXXXXXXXX4805,352.76,,4349479.07,AccountTransactionsReport(1).csv,1693,2024-12,False,Other Computer Services,Other Computer Services,Other Computer Services
,2024-12-06,8400/000 : FNB,"Github Inc. 19.00 GITHUB, INC. 4XXXXX*5225 04 DEC XXXXXXXXXXXXXXXXXXX5653 Github Inc.",Account Payment,"Github Inc. 19.00 GITHUB, INC. 4XXXXX*5225 04 DEC XXXXXXXXXXXXXXXXXXX5653 Github Inc.",353.06,,4349832.13,AccountTransactionsReport(1).csv,1694,2024-12,False,Development Tools,Development Tools,Development Tools
,2024-12-06,8400/000 : FNB,99.99 JINA.AI 4XX*5191 05 DEC XX2768 99.99 JINA.AI 4XXXXX*5191 05 DEC XXXXXXXXXXXXXXXXXXX2768,Account Payment,99.99 JINA.AI 4XX*5191 05 DEC XX2768 99.99 JINA.AI 4XXXXX*5191 05 DEC XXXXXXXXXXXXXXXXXXX2768,1856.42,,4351688.55,AccountTransactionsReport(1).csv,1695,2024-12,False,Other Computer Services,Other Computer Services,Other Computer Services
,2024-12-06,8400/000 : FNB,ManageWP 120.75 MANAGEWP 4XXXXX*5225 05 DEC XXXXXXXXXXXXXXXXXXX5184 ManageWP,Account Payment,ManageWP 120.75 MANAGEWP 4XXXXX*5225 05 DEC XXXXXXXXXXXXXXXXXXX5184 ManageWP,2241.85,,4353930.4,AccountTransactionsReport(1).csv,1696,2024-12,False,Other Computer Services,Other Computer Services,Other Computer Services
,2024-12-06,8400/000 : FNB,ManageWP 120.75 MANAGEWP 4XXXXX*5225 05 DEC XXXXXXXXXXXXXXXXXXX5192 ManageWP,Account Payment,ManageWP 120.75 MANAGEWP 4XXXXX*5225 05 DEC XXXXXXXXXXXXXXXXXXX5192 ManageWP,2241.85,,4356172.25,AccountTransactionsReport(1).csv,1697,2024-12,False,Other Computer Services,Other Computer Services,Other Computer Services
,2024-12-06,8400/000 : FNB,253.00 WWW.WOLFRAM. 4XX*5191 05 DEC XX9384 253.00 WWW.WOLFRAM. 4XXXXX*5191 05 DEC XXXXXXXXXXXXXXXXXX,Account Payment,253.00 WWW.WOLFRAM. 4XX*5191 05 DEC XX9384 253.00 WWW.WOLFRAM. 4XXXXX*5191 05 DEC XXXXXXXXXXXXXXXXX,4697.2,,4360869.45,AccountTransactionsReport(1).csv,1698,2024-12,False,Other Computer Services,Other Computer Services,Other Computer Services
,2024-12-06,8400/000 : FNB,450.00 WAPPALYZER 4XX*5191 04 DEC XX0472 450.00 WAPPALYZER 4XXXXX*5191 04 DEC XXXXXXXXXXXXXXXXXXX047,Account Payment,450.00 WAPPALYZER 4XX*5191 04 DEC XX0472 450.00 WAPPALYZER 4XXXXX*5191 04 DEC XXXXXXXXXXXXXXXXXXX04,8361.92,,4369231.37,AccountTransactionsReport(1).csv,1699,2024-12,False,Other Computer Services,Other Computer Services,Other Computer Services
,2024-12-06,8400/000 : FNB,599.00 TRIPLE WHALE 4XX*5191 04 DEC XX6660 599.00 TRIPLE WHALE 4XXXXX*5191 04 DEC XXXXXXXXXXXXXXXXXX,Account Payment,599.00 TRIPLE WHALE 4XX*5191 04 DEC XX6660 599.00 TRIPLE WHALE 4XXXXX*5191 04 DEC XXXXXXXXXXXXXXXXX,11130.65,,4380362.02,AccountTransactionsReport(1).csv,1700,2024-12,False,Other Computer Services,Other Computer Services,Other Computer Services
,2024-12-06,8400/000 : FNB,1499.00 APPDIRECT 4XX*5225 04 DEC XX1363 1499.00 APPDIRECT 4XXXXX*5225 04 DEC XXXXXXXXXXXXXXXXXXX136,Account Payment,1499.00 APPDIRECT 4XX*5225 04 DEC XX1363 1499.00 APPDIRECT 4XXXXX*5225 04 DEC XXXXXXXXXXXXXXXXXXX13,27854.49,,4408216.51,AccountTransactionsReport(1).csv,1701,2024-12,False,Other Computer Services,Other Computer Services,Other Computer Services
,2024-12-07,8400/000 : FNB,Facebook 4.60 FACEBK *M46JVE 4XXXXX*5191 05 DEC XXXXXXXXXXXXXXXXXXX7063 Facebook,Account Payment,Facebook 4.60 FACEBK *M46JVE 4XXXXX*5191 05 DEC XXXXXXXXXXXXXXXXXXX7063 Facebook,85.4,,4408301.91,AccountTransactionsReport(1).csv,1702,2024-12,False,Marketing Tools,Marketing Tools,Marketing Tools
,2024-12-07,8400/000 : FNB,187.94 PADDLE.NET* 4XX*5191 05 DEC XX2132 187.94 PADDLE.NET* 4XXXXX*5191 05 DEC XXXXXXXXXXXXXXXXXXX2,Account Payment,187.94 PADDLE.NET* 4XX*5191 05 DEC XX2132 187.94 PADDLE.NET* 4XXXXX*5191 05 DEC XXXXXXXXXXXXXXXXXXX,187.94,,4408489.85,AccountTransactionsReport(1).csv,1703,2024-12,False,Other Computer Services,Subscription Management,Subscription Management
,2024-12-07,8400/000 : FNB,Facebook 13.80 FACEBK *L4WAD 4XXXXX*5191 05 DEC XXXXXXXXXXXXXXXXXXX5091 Facebook,Account Payment,Facebook 13.80 FACEBK *L4WAD 4XXXXX*5191 05 DEC XXXXXXXXXXXXXXXXXXX5091 Facebook,256.21,,4408746.06,AccountTransactionsReport(1).csv,1704,2024-12,False,Marketing Tools,Marketing Tools,Marketing Tools
,2024-12-07,8400/000 : FNB,Facebook 23.00 FACEBK *M9RDH 4XXXXX*5191 05 DEC XXXXXXXXXXXXXXXXXXX3085 Facebook,Account Payment,Facebook 23.00 FACEBK *M9RDH 4XXXXX*5191 05 DEC XXXXXXXXXXXXXXXXXXX3085 Facebook,427.02,,4409173.08,AccountTransactionsReport(1).csv,1705,2024-12,False,Marketing Tools,Marketing Tools,Marketing Tools
,2024-12-07,8400/000 : FNB,29.00 CAL.COM 4XX*5191 05 DEC XX2317 29.00 CAL.COM 4XXXXX*5191 05 DEC XXXXXXXXXXXXXXXXXXX2317,Account Payment,29.00 CAL.COM 4XX*5191 05 DEC XX2317 29.00 CAL.COM 4XXXXX*5191 05 DEC XXXXXXXXXXXXXXXXXXX2317,538.42,,4409711.5,AccountTransactionsReport(1).csv,1706,2024-12,False,Other Computer Services,Other Computer Services,Other Computer Services
,2024-12-07,8400/000 : FNB,99.00 CHATBASE 4XX*5191 05 DEC XX3123 99.00 CHATBASE 4XXXXX*5191 05 DEC XXXXXXXXXXXXXXXXXXX3123,Account Payment,99.00 CHATBASE 4XX*5191 05 DEC XX3123 99.00 CHATBASE 4XXXXX*5191 05 DEC XXXXXXXXXXXXXXXXXXX3123,1838.04,,4411549.54,AccountTransactionsReport(1).csv,1707,2024-12,False,Other Computer Services,Other Computer Services,Other Computer Services
,2024-12-09,8400/000 : FNB,19.99 WOOCOMMERCE S 4XX*5225 06 DEC XX0918 19.99 WOOCOMMERCE S 4XXXXX*5225 06 DEC XXXXXXXXXXXXXXXXXX,Account Payment,19.99 WOOCOMMERCE S 4XX*5225 06 DEC XX0918 19.99 WOOCOMMERCE S 4XXXXX*5225 06 DEC XXXXXXXXXXXXXXXXX,371.25,,4411920.79,AccountTransactionsReport(1).csv,1708,2024-12,False,Other Computer Services,Other Computer Services,Other Computer Services
,2024-12-09,8400/000 : FNB,20.00 VERCEL INC. 4XX*5225 06 DEC XX6304 20.00 VERCEL INC. 4XXXXX*5225 06 DEC XXXXXXXXXXXXXXXXXXX630,Account Payment,20.00 VERCEL INC. 4XX*5225 06 DEC XX6304 20.00 VERCEL INC. 4XXXXX*5225 06 DEC XXXXXXXXXXXXXXXXXXX63,371.43,,4412292.22,AccountTransactionsReport(1).csv,1709,2024-12,False,Cloud Services,Cloud Services,Cloud Services
,2024-12-09,8400/000 : FNB,20.00 VERCEL INC. 4XX*5225 06 DEC XX7235 20.00 VERCEL INC. 4XXXXX*5225 06 DEC XXXXXXXXXXXXXXXXXXX723,Account Payment,20.00 VERCEL INC. 4XX*5225 06 DEC XX7235 20.00 VERCEL INC. 4XXXXX*5225 06 DEC XXXXXXXXXXXXXXXXXXX72,371.43,,4412663.65,AccountTransactionsReport(1).csv,1710,2024-12,False,Cloud Services,Cloud Services,Cloud Services
,2024-12-10,8400/000 : FNB,Google Store 34.99 Google One 4XXXXX*5191 08 DEC XXXXXXXXXXXXXXXXXXX1094 Google Store,Account Payment,Google Store 34.99 Google One 4XXXXX*5191 08 DEC XXXXXXXXXXXXXXXXXXX1094 Google Store,34.99,,4412698.64,AccountTransactionsReport(1).csv,1711,2024-12,False,Other Computer Services,Analytics & Monitoring,Analytics & Monitoring
,2024-12-10,8400/000 : FNB,3.60 GETADDRESS.IO 4XX*5225 07 DEC XX7994 3.60 GETADDRESS.IO 4XXXXX*5225 07 DEC XXXXXXXXXXXXXXXXXXX7,Account Payment,3.60 GETADDRESS.IO 4XX*5225 07 DEC XX7994 3.60 GETADDRESS.IO 4XXXXX*5225 07 DEC XXXXXXXXXXXXXXXXXXX,84.73,,4412783.37,AccountTransactionsReport(1).csv,1712,2024-12,False,Other Computer Services,Other Computer Services,Other Computer Services
,2024-12-10,8400/000 : FNB,179.00 MOZSEO:HELP@ 4XX*5191 07 DEC XX1924 179.00 MOZSEO:HELP@ 4XXXXX*5191 07 DEC XXXXXXXXXXXXXXXXXX,Account Payment,179.00 MOZSEO:HELP@ 4XX*5191 07 DEC XX1924 179.00 MOZSEO:HELP@ 4XXXXX*5191 07 DEC XXXXXXXXXXXXXXXXX,3303.49,,4416086.86,AccountTransactionsReport(1).csv,1713,2024-12,False,Other Computer Services,Other Computer Services,Other Computer Services
,2024-12-10,8400/000 : FNB,Stable 249.00 STABLE 4XXXXX*5191 08 DEC XXXXXXXXXXXXXXXXXXX8513 Stable,Account Payment,Stable 249.00 STABLE 4XXXXX*5191 08 DEC XXXXXXXXXXXXXXXXXXX8513 Stable,4595.36,,4420682.22,AccountTransactionsReport(1).csv,1714,2024-12,False,Other Computer Services,Other Computer Services,Other Computer Services
,2024-12-10,8400/000 : FNB,920.00 AUTH0.COM 4XX*5191 08 DEC XX9998 920.00 AUTH0.COM 4XXXXX*5191 08 DEC XXXXXXXXXXXXXXXXXXX9998,Account Payment,920.00 AUTH0.COM 4XX*5191 08 DEC XX9998 920.00 AUTH0.COM 4XXXXX*5191 08 DEC XXXXXXXXXXXXXXXXXXX9998,16978.84,,4437661.06,AccountTransactionsReport(1).csv,1715,2024-12,False,Security Services,Security Services,Security Services
,2024-12-10,8400/000 : FNB,Shopify 2558.98 SHOPIFY* 30 4XXXXX*5191 08 DEC XXXXXXXXXXXXXXXXXXX5656 Shopify,Account Payment,Shopify 2558.98 SHOPIFY* 30 4XXXXX*5191 08 DEC XXXXXXXXXXXXXXXXXXX5656 Shopify,47226.64,,4484887.7,AccountTransactionsReport(1).csv,1716,2024-12,False,E-commerce Platforms,E-commerce Platforms,E-commerce Platforms
,2024-12-10,8400/000 : FNB,"25.00 NOTION LABS, 4XX*5191 08 DEC XX6582 25.00 NOTION LABS, 4XXXXX*5191 08 DEC XXXXXXXXXXXXXXXXXXX6",Account Payment,"25.00 NOTION LABS, 4XX*5191 08 DEC XX6582 25.00 NOTION LABS, 4XXXXX*5191 08 DEC XXXXXXXXXXXXXXXXXXX",461.38,,4485349.08,AccountTransactionsReport(1).csv,1717,2024-12,False,Other Computer Services,Collaboration Tools,Collaboration Tools
,2024-12-10,8400/000 : FNB,Intuit 570.40 INTUIT *QBoo 4XXXXX*5225 07 DEC XXXXXXXXXXXXXXXXXXX9940 Intuit,Account Payment,Intuit 570.40 INTUIT *QBoo 4XXXXX*5225 07 DEC XXXXXXXXXXXXXXXXXXX9940 Intuit,570.4,,4485919.48,AccountTransactionsReport(1).csv,1718,2024-12,False,Productivity Software,Productivity Software,Productivity Software
,2024-12-10,8400/000 : FNB,63.25 CLOUDFLARE 4XX*5191 08 DEC XX1331 63.25 CLOUDFLARE 4XXXXX*5191 08 DEC XXXXXXXXXXXXXXXXXXX1331,Account Payment,63.25 CLOUDFLARE 4XX*5191 08 DEC XX1331 63.25 CLOUDFLARE 4XXXXX*5191 08 DEC XXXXXXXXXXXXXXXXXXX1331,1167.3,,4487086.78,AccountTransactionsReport(1).csv,1719,2024-12,False,Cloud Services,Cloud Services,Cloud Services
,2024-12-10,8400/000 : FNB,72.00 TERMIUS CORPO 4XX*5191 08 DEC XX7655 72.00 TERMIUS CORPO 4XXXXX*5191 08 DEC XXXXXXXXXXXXXXXXXX,Account Payment,72.00 TERMIUS CORPO 4XX*5191 08 DEC XX7655 72.00 TERMIUS CORPO 4XXXXX*5191 08 DEC XXXXXXXXXXXXXXXXX,1328.77,,4488415.55,AccountTransactionsReport(1).csv,1720,2024-12,False,Other Computer Services,Other Computer Services,Other Computer Services
,2024-12-10,8400/000 : FNB,"Github Inc. 91.00 GITHUB, INC. 4XXXXX*5191 08 DEC XXXXXXXXXXXXXXXXXXX2402 Github Inc.",Account Payment,"Github Inc. 91.00 GITHUB, INC. 4XXXXX*5191 08 DEC XXXXXXXXXXXXXXXXXXX2402 Github Inc.",1679.43,,4490094.98,AccountTransactionsReport(1).csv,1721,2024-12,False,Development Tools,Development Tools,Development Tools
,2024-12-10,8400/000 : FNB,99.00 MIOSALON.COM( 4XX*5225 07 DEC XX5982 99.00 MIOSALON.COM( 4XXXXX*5225 07 DEC XXXXXXXXXXXXXXXXXX,Account Payment,99.00 MIOSALON.COM( 4XX*5225 07 DEC XX5982 99.00 MIOSALON.COM( 4XXXXX*5225 07 DEC XXXXXXXXXXXXXXXXX,1827.08,,4491922.06,AccountTransactionsReport(1).csv,1722,2024-12,False,Other Computer Services,Other Computer Services,Other Computer Services
,2024-12-10,8400/000 : FNB,99.00 MIOSALON.COM( 4XX*5225 07 DEC XX8803 99.00 MIOSALON.COM( 4XXXXX*5225 07 DEC XXXXXXXXXXXXXXXXXX,Account Payment,99.00 MIOSALON.COM( 4XX*5225 07 DEC XX8803 99.00 MIOSALON.COM( 4XXXXX*5225 07 DEC XXXXXXXXXXXXXXXXX,1827.08,,4493749.14,AccountTransactionsReport(1).csv,1723,2024-12,False,Other Computer Services,Other Computer Services,Other Computer Services
,2024-12-10,8400/000 : FNB,"105.00 NOTION LABS, 4XX*5225 07 DEC XX9228 105.00 NOTION LABS, 4XXXXX*5225 07 DEC XXXXXXXXXXXXXXXXXX",Account Payment,"105.00 NOTION LABS, 4XX*5225 07 DEC XX9228 105.00 NOTION LABS, 4XXXXX*5225 07 DEC XXXXXXXXXXXXXXXXX",1937.81,,4495686.95,AccountTransactionsReport(1).csv,1724,2024-12,False,Other Computer Services,Collaboration Tools,Collaboration Tools
,2024-12-10,8400/000 : FNB,150.00 AUTH0.COM 4XX*5191 08 DEC XX5149 150.00 AUTH0.COM 4XXXXX*5191 08 DEC XXXXXXXXXXXXXXXXXXX5149,Account Payment,150.00 AUTH0.COM 4XX*5191 08 DEC XX5149 150.00 AUTH0.COM 4XXXXX*5191 08 DEC XXXXXXXXXXXXXXXXXXX5149,2768.29,,4498455.24,AccountTransactionsReport(1).csv,1725,2024-12,False,Security Services,Security Services,Security Services
,2024-12-10,8400/000 : FNB,171.35 PADDLE.NET* 4XX*5191 08 DEC XX3232 171.35 PADDLE.NET* 4XXXXX*5191 08 DEC XXXXXXXXXXXXXXXXXXX3,Account Payment,171.35 PADDLE.NET* 4XX*5191 08 DEC XX3232 171.35 PADDLE.NET* 4XXXXX*5191 08 DEC XXXXXXXXXXXXXXXXXXX,3162.31,,4501617.55,AccountTransactionsReport(1).csv,1726,2024-12,False,Other Computer Services,Subscription Management,Subscription Management
,2024-12-10,8400/000 : FNB,"7.00 NPM, INC. 4XX*5191 08 DEC XX9950 7.00 NPM, INC. 4XXXXX*5191 08 DEC XXXXXXXXXXXXXXXXXXX9950",Account Payment,"7.00 NPM, INC. 4XX*5191 08 DEC XX9950 7.00 NPM, INC. 4XXXXX*5191 08 DEC XXXXXXXXXXXXXXXXXXX9950",129.18,,4501746.73,AccountTransactionsReport(1).csv,1727,2024-12,False,Other Computer Services,Other Computer Services,Other Computer Services
,2024-12-10,8400/000 : FNB,"7.00 NPM, INC. 4XX*5191 08 DEC XX7277 7.00 NPM, INC. 4XXXXX*5191 08 DEC XXXXXXXXXXXXXXXXXXX7277",Account Payment,"7.00 NPM, INC. 4XX*5191 08 DEC XX7277 7.00 NPM, INC. 4XXXXX*5191 08 DEC XXXXXXXXXXXXXXXXXXX7277",129.18,,4501875.91,AccountTransactionsReport(1).csv,1728,2024-12,False,Other Computer Services,Other Computer Services,Other Computer Services
,2024-12-10,8400/000 : FNB,"7.00 NPM, INC. 4XX*5191 08 DEC XX9664 7.00 NPM, INC. 4XXXXX*5191 08 DEC XXXXXXXXXXXXXXXXXXX9664",Account Payment,"7.00 NPM, INC. 4XX*5191 08 DEC XX9664 7.00 NPM, INC. 4XXXXX*5191 08 DEC XXXXXXXXXXXXXXXXXXX9664",129.18,,4502005.09,AccountTransactionsReport(1).csv,1729,2024-12,False,Other Computer Services,Other Computer Services,Other Computer Services
,2024-12-10,8400/000 : FNB,"7.00 NPM, INC. 4XX*5191 08 DEC XX2740 7.00 NPM, INC. 4XXXXX*5191 08 DEC XXXXXXXXXXXXXXXXXXX2740",Account Payment,"7.00 NPM, INC. 4XX*5191 08 DEC XX2740 7.00 NPM, INC. 4XXXXX*5191 08 DEC XXXXXXXXXXXXXXXXXXX2740",129.18,,4502134.27,AccountTransactionsReport(1).csv,1730,2024-12,False,Other Computer Services,Other Computer Services,Other Computer Services
,2024-12-10,8400/000 : FNB,12.00 CODESANDBOX 4XX*5191 07 DEC XX3642 12.00 CODESANDBOX 4XXXXX*5191 07 DEC XXXXXXXXXXXXXXXXXXX364,Account Payment,12.00 CODESANDBOX 4XX*5191 07 DEC XX3642 12.00 CODESANDBOX 4XXXXX*5191 07 DEC XXXXXXXXXXXXXXXXXXX36,221.46,,4502355.73,AccountTransactionsReport(1).csv,1731,2024-12,False,Other Computer Services,Other Computer Services,Other Computer Services
,2024-12-10,8400/000 : FNB,Hightail 15.00 HIGHTAIL 4XXXXX*5191 08 DEC XXXXXXXXXXXXXXXXXXX1287 Hightail,Account Payment,Hightail 15.00 HIGHTAIL 4XXXXX*5191 08 DEC XXXXXXXXXXXXXXXXXXX1287 Hightail,276.83,,4502632.56,AccountTransactionsReport(1).csv,1732,2024-12,False,Other Computer Services,Other Computer Services,Other Computer Services
,2024-12-10,8400/000 : FNB,15.00 CAL.COM 4XX*5191 08 DEC XX6009 15.00 CAL.COM 4XXXXX*5191 08 DEC XXXXXXXXXXXXXXXXXXX6009,Account Payment,15.00 CAL.COM 4XX*5191 08 DEC XX6009 15.00 CAL.COM 4XXXXX*5191 08 DEC XXXXXXXXXXXXXXXXXXX6009,276.83,,4502909.39,AccountTransactionsReport(1).csv,1733,2024-12,False,Other Computer Services,Other Computer Services,Other Computer Services
,2024-12-10,8400/000 : FNB,Facebook Service Charges/Fees #INT PYMT FEE-652.77 FACE Facebook,Account Payment,Facebook Service Charges/Fees INT PYMT FEE-652.77 FACE Facebook,13.06,,4502922.45,AccountTransactionsReport(1).csv,1734,2024-12,False,Marketing Tools,Marketing Tools,Marketing Tools
,2024-12-11,8400/000 : FNB,7.00 CHATBASE 4XX*5191 10 DEC XX9426 7.00 CHATBASE 4XXXXX*5191 10 DEC XXXXXXXXXXXXXXXXXXX9426,Account Payment,7.00 CHATBASE 4XX*5191 10 DEC XX9426 7.00 CHATBASE 4XXXXX*5191 10 DEC XXXXXXXXXXXXXXXXXXX9426,129.04,,4503051.49,AccountTransactionsReport(1).csv,1735,2024-12,False,Other Computer Services,Other Computer Services,Other Computer Services
,2024-12-11,8400/000 : FNB,Intuit 171.12 INTUIT *QBoo 4XXXXX*5225 09 DEC XXXXXXXXXXXXXXXXXXX7361 Intuit,Account Payment,Intuit 171.12 INTUIT *QBoo 4XXXXX*5225 09 DEC XXXXXXXXXXXXXXXXXXX7361 Intuit,171.12,,4503222.61,AccountTransactionsReport(1).csv,1736,2024-12,False,Productivity Software,Productivity Software,Productivity Software
,2024-12-11,8400/000 : FNB,499.00 CASSIDYAI.CO 4XX*5191 09 DEC XX7088 499.00 CASSIDYAI.CO 4XXXXX*5191 09 DEC XXXXXXXXXXXXXXXXXX,Account Payment,499.00 CASSIDYAI.CO 4XX*5191 09 DEC XX7088 499.00 CASSIDYAI.CO 4XXXXX*5191 09 DEC XXXXXXXXXXXXXXXXX,9209.17,,4512431.78,AccountTransactionsReport(1).csv,1737,2024-12,False,Other Computer Services,Other Computer Services,Other Computer Services
,2024-12-11,8400/000 : FNB,20.00 VERCEL INC. 4XX*5191 09 DEC XX5694 20.00 VERCEL INC. 4XXXXX*5191 09 DEC XXXXXXXXXXXXXXXXXXX569,Account Payment,20.00 VERCEL INC. 4XX*5191 09 DEC XX5694 20.00 VERCEL INC. 4XXXXX*5191 09 DEC XXXXXXXXXXXXXXXXXXX56,369.11,,4512800.89,AccountTransactionsReport(1).csv,1738,2024-12,False,Cloud Services,Cloud Services,Cloud Services
,2024-12-11,8400/000 : FNB,20.00 HEROKU* NOV-9 4XX*5191 09 DEC XX8473 20.00 HEROKU* NOV-9 4XXXXX*5191 09 DEC XXXXXXXXXXXXXXXXXX,Account Payment,20.00 HEROKU* NOV-9 4XX*5191 09 DEC XX8473 20.00 HEROKU* NOV-9 4XXXXX*5191 09 DEC XXXXXXXXXXXXXXXXX,369.11,,4513170.0,AccountTransactionsReport(1).csv,1739,2024-12,False,Cloud Services,Cloud Services,Cloud Services
,2024-12-11,8400/000 : FNB,21.56 SLACK T0740DV 4XX*5191 10 DEC XX4046 21.56 SLACK T0740DV 4XXXXX*5191 10 DEC XXXXXXXXXXXXXXXXXX,Account Payment,21.56 SLACK T0740DV 4XX*5191 10 DEC XX4046 21.56 SLACK T0740DV 4XXXXX*5191 10 DEC XXXXXXXXXXXXXXXXX,397.45,,4513567.45,AccountTransactionsReport(1).csv,1740,2024-12,False,Communication,Communication,Communication
,2024-12-11,8400/000 : FNB,25.00 BEECEPTOR 4XX*5191 09 DEC XX0323 25.00 BEECEPTOR 4XXXXX*5191 09 DEC XXXXXXXXXXXXXXXXXXX0323,Account Payment,25.00 BEECEPTOR 4XX*5191 09 DEC XX0323 25.00 BEECEPTOR 4XXXXX*5191 09 DEC XXXXXXXXXXXXXXXXXXX0323,461.38,,4514028.83,AccountTransactionsReport(1).csv,1741,2024-12,False,Other Computer Services,Other Computer Services,Other Computer Services
,2024-12-11,8400/000 : FNB,25.00 BEECEPTOR 4XX*5191 09 DEC XX0612 25.00 BEECEPTOR 4XXXXX*5191 09 DEC XXXXXXXXXXXXXXXXXXX0612,Account Payment,25.00 BEECEPTOR 4XX*5191 09 DEC XX0612 25.00 BEECEPTOR 4XXXXX*5191 09 DEC XXXXXXXXXXXXXXXXXXX0612,461.38,,4514490.21,AccountTransactionsReport(1).csv,1742,2024-12,False,Other Computer Services,Other Computer Services,Other Computer Services
,2024-12-11,8400/000 : FNB,30.00 ISHRAQ LLC 4XX*5191 09 DEC XX8957 30.00 ISHRAQ LLC 4XXXXX*5191 09 DEC XXXXXXXXXXXXXXXXXXX8957,Account Payment,30.00 ISHRAQ LLC 4XX*5191 09 DEC XX8957 30.00 ISHRAQ LLC 4XXXXX*5191 09 DEC XXXXXXXXXXXXXXXXXXX8957,553.66,,4515043.87,AccountTransactionsReport(1).csv,1743,2024-12,False,Other Computer Services,Other Computer Services,Other Computer Services
,2024-12-11,8400/000 : FNB,"40.00 REPLIT, INC. 4XX*5191 09 DEC XX9010 40.00 REPLIT, INC. 4XXXXX*5191 09 DEC XXXXXXXXXXXXXXXXXXX9",Account Payment,"40.00 REPLIT, INC. 4XX*5191 09 DEC XX9010 40.00 REPLIT, INC. 4XXXXX*5191 09 DEC XXXXXXXXXXXXXXXXXXX",738.21,,4515782.08,AccountTransactionsReport(1).csv,1744,2024-12,False,Other Computer Services,Other Computer Services,Other Computer Services
,2024-12-11,8400/000 : FNB,49.00 SKRAPP.IO STA 4XX*5191 09 DEC XX3571 49.00 SKRAPP.IO STA 4XXXXX*5191 09 DEC XXXXXXXXXXXXXXXXXX,Account Payment,49.00 SKRAPP.IO STA 4XX*5191 09 DEC XX3571 49.00 SKRAPP.IO STA 4XXXXX*5191 09 DEC XXXXXXXXXXXXXXXXX,904.31,,4516686.39,AccountTransactionsReport(1).csv,1745,2024-12,False,Other Computer Services,Other Computer Services,Other Computer Services
,2024-12-11,8400/000 : FNB,60.00 OPENAI *CHATG 4XX*5191 09 DEC XX4414 60.00 OPENAI *CHATG 4XXXXX*5191 09 DEC XXXXXXXXXXXXXXXXXX,Account Payment,60.00 OPENAI *CHATG 4XX*5191 09 DEC XX4414 60.00 OPENAI *CHATG 4XXXXX*5191 09 DEC XXXXXXXXXXXXXXXXX,1107.31,,4517793.7,AccountTransactionsReport(1).csv,1746,2024-12,False,AI Services,AI Services,AI Services
,2024-12-11,8400/000 : FNB,"70.00 NOTION LABS, 4XX*5191 10 DEC XX3797 70.00 NOTION LABS, 4XXXXX*5191 10 DEC XXXXXXXXXXXXXXXXXXX3",Account Payment,"70.00 NOTION LABS, 4XX*5191 10 DEC XX3797 70.00 NOTION LABS, 4XXXXX*5191 10 DEC XXXXXXXXXXXXXXXXXXX",1290.42,,4519084.12,AccountTransactionsReport(1).csv,1747,2024-12,False,Other Computer Services,Collaboration Tools,Collaboration Tools
,2024-12-12,8400/000 : FNB,Facebook 135.79 FACEBK *9WR9 4XXXXX*5191 10 DEC XXXXXXXXXXXXXXXXXXX1497 Facebook,Account Payment,Facebook 135.79 FACEBK *9WR9 4XXXXX*5191 10 DEC XXXXXXXXXXXXXXXXXXX1497 Facebook,135.79,,4519219.91,AccountTransactionsReport(1).csv,1748,2024-12,False,Marketing Tools,Marketing Tools,Marketing Tools
,2024-12-12,8400/000 : FNB,32.00 BUBBLE STARTE 4XX*5191 11 DEC XX2714 32.00 BUBBLE STARTE 4XXXXX*5191 11 DEC XXXXXXXXXXXXXXXXXX,Account Payment,32.00 BUBBLE STARTE 4XX*5191 11 DEC XX2714 32.00 BUBBLE STARTE 4XXXXX*5191 11 DEC XXXXXXXXXXXXXXXXX,584.85,,4519804.76,AccountTransactionsReport(1).csv,1749,2024-12,False,Other Computer Services,Other Computer Services,Other Computer Services
,2024-12-12,8400/000 : FNB,99.00 DYNAMIC.XYZ 4XX*5191 11 DEC XX0469 99.00 DYNAMIC.XYZ 4XXXXX*5191 11 DEC XXXXXXXXXXXXXXXXXXX046,Account Payment,99.00 DYNAMIC.XYZ 4XX*5191 11 DEC XX0469 99.00 DYNAMIC.XYZ 4XXXXX*5191 11 DEC XXXXXXXXXXXXXXXXXXX04,1809.38,,4521614.14,AccountTransactionsReport(1).csv,1750,2024-12,False,Other Computer Services,Other Computer Services,Other Computer Services
,2024-12-12,8400/000 : FNB,"99.00 PLAYFAB, INC. 4XX*5191 10 DEC XX9410 99.00 PLAYFAB, INC. 4XXXXX*5191 10 DEC XXXXXXXXXXXXXXXXXX",Account Payment,"99.00 PLAYFAB, INC. 4XX*5191 10 DEC XX9410 99.00 PLAYFAB, INC. 4XXXXX*5191 10 DEC XXXXXXXXXXXXXXXXX",1825.02,,4523439.16,AccountTransactionsReport(1).csv,1751,2024-12,False,Other Computer Services,Other Computer Services,Other Computer Services
,2024-12-12,8400/000 : FNB,Shopify 3633.95 SHOPIFY* 30 4XXXXX*5225 10 DEC XXXXXXXXXXXXXXXXXXX6945 Shopify,Account Payment,Shopify 3633.95 SHOPIFY* 30 4XXXXX*5225 10 DEC XXXXXXXXXXXXXXXXXXX6945 Shopify,66990.21,,4590429.37,AccountTransactionsReport(1).csv,1752,2024-12,False,E-commerce Platforms,E-commerce Platforms,E-commerce Platforms
,2024-12-13,8400/000 : FNB,9.00 TWENTY.COM 4XX*5191 11 DEC XX8000 9.00 TWENTY.COM 4XXXXX*5191 11 DEC XXXXXXXXXXXXXXXXXXX8000,Account Payment,9.00 TWENTY.COM 4XX*5191 11 DEC XX8000 9.00 TWENTY.COM 4XXXXX*5191 11 DEC XXXXXXXXXXXXXXXXXXX8000,164.49,,4590593.86,AccountTransactionsReport(1).csv,1753,2024-12,False,Other Computer Services,Other Computer Services,Other Computer Services
,2024-12-13,8400/000 : FNB,Intuit 570.40 INTUIT *QBoo 4XXXXX*5225 11 DEC XXXXXXXXXXXXXXXXXXX7523 Intuit,Account Payment,Intuit 570.40 INTUIT *QBoo 4XXXXX*5225 11 DEC XXXXXXXXXXXXXXXXXXX7523 Intuit,570.4,,4591164.26,AccountTransactionsReport(1).csv,1754,2024-12,False,Productivity Software,Productivity Software,Productivity Software
,2024-12-13,8400/000 : FNB,Intuit 570.40 INTUIT *QBoo 4XXXXX*5225 11 DEC XXXXXXXXXXXXXXXXXXX7564 Intuit,Account Payment,Intuit 570.40 INTUIT *QBoo 4XXXXX*5225 11 DEC XXXXXXXXXXXXXXXXXXX7564 Intuit,570.4,,4591734.66,AccountTransactionsReport(1).csv,1755,2024-12,False,Productivity Software,Productivity Software,Productivity Software
,2024-12-13,8400/000 : FNB,"Github Inc. 42.00 GITHUB, INC. 4XXXXX*5191 11 DEC XXXXXXXXXXXXXXXXXXX4711 Github Inc.",Account Payment,"Github Inc. 42.00 GITHUB, INC. 4XXXXX*5191 11 DEC XXXXXXXXXXXXXXXXXXX4711 Github Inc.",767.61,,4592502.27,AccountTransactionsReport(1).csv,1756,2024-12,False,Development Tools,Development Tools,Development Tools
,2024-12-13,8400/000 : FNB,"Github Inc. 70.64 GITHUB, INC. 4XXXXX*5191 11 DEC XXXXXXXXXXXXXXXXXXX2266 Github Inc.",Account Payment,"Github Inc. 70.64 GITHUB, INC. 4XXXXX*5191 11 DEC XXXXXXXXXXXXXXXXXXX2266 Github Inc.",1291.05,,4593793.32,AccountTransactionsReport(1).csv,1757,2024-12,False,Development Tools,Development Tools,Development Tools
,2024-12-13,8400/000 : FNB,Shopify 74.75 SHOPIFY* 3052 4XXXXX*5225 11 DEC XXXXXXXXXXXXXXXXXXX4961 Shopify,Account Payment,Shopify 74.75 SHOPIFY* 3052 4XXXXX*5225 11 DEC XXXXXXXXXXXXXXXXXXX4961 Shopify,1366.17,,4595159.49,AccountTransactionsReport(1).csv,1758,2024-12,False,E-commerce Platforms,E-commerce Platforms,E-commerce Platforms
,2024-12-13,8400/000 : FNB,"Github Inc. 210.00 GITHUB, INC. 4XXXXX*5225 11 DEC XXXXXXXXXXXXXXXXXXX2873 Github Inc.",Account Payment,"Github Inc. 210.00 GITHUB, INC. 4XXXXX*5225 11 DEC XXXXXXXXXXXXXXXXXXX2873 Github Inc.",3838.08,,4598997.57,AccountTransactionsReport(1).csv,1759,2024-12,False,Development Tools,Development Tools,Development Tools
,2024-12-14,8400/000 : FNB,15.00 TABNINE 4XX*5191 12 DEC XX9048 15.00 TABNINE 4XXXXX*5191 12 DEC XXXXXXXXXXXXXXXXXXX9048,Account Payment,15.00 TABNINE 4XX*5191 12 DEC XX9048 15.00 TABNINE 4XXXXX*5191 12 DEC XXXXXXXXXXXXXXXXXXX9048,274.2,,4599271.77,AccountTransactionsReport(1).csv,1760,2024-12,False,Other Computer Services,Other Computer Services,Other Computer Services
,2024-12-14,8400/000 : FNB,20.00 HUGGINGFACE 4XX*5191 13 DEC XX7366 20.00 HUGGINGFACE 4XXXXX*5191 13 DEC XXXXXXXXXXXXXXXXXXX736,Account Payment,20.00 HUGGINGFACE 4XX*5191 13 DEC XX7366 20.00 HUGGINGFACE 4XXXXX*5191 13 DEC XXXXXXXXXXXXXXXXXXX73,363.86,,4599635.63,AccountTransactionsReport(1).csv,1761,2024-12,False,AI Services,AI Services,AI Services
,2024-12-14,8400/000 : FNB,50.00 ANACONDA INC. 4XX*5191 12 DEC XX4409 50.00 ANACONDA INC. 4XXXXX*5191 12 DEC XXXXXXXXXXXXXXXXXX,Account Payment,50.00 ANACONDA INC. 4XX*5191 12 DEC XX4409 50.00 ANACONDA INC. 4XXXXX*5191 12 DEC XXXXXXXXXXXXXXXXX,913.99,,4600549.62,AccountTransactionsReport(1).csv,1762,2024-12,False,Other Computer Services,Other Computer Services,Other Computer Services
,2024-12-14,8400/000 : FNB,60.00 INSOMNIA TEAM 4XX*5191 13 DEC XX9506 60.00 INSOMNIA TEAM 4XXXXX*5191 13 DEC XXXXXXXXXXXXXXXXXX,Account Payment,60.00 INSOMNIA TEAM 4XX*5191 13 DEC XX9506 60.00 INSOMNIA TEAM 4XXXXX*5191 13 DEC XXXXXXXXXXXXXXXXX,1091.59,,4601641.21,AccountTransactionsReport(1).csv,1763,2024-12,False,Other Computer Services,Other Computer Services,Other Computer Services
,2024-12-14,8400/000 : FNB,99.00 DMNS.APP BUSI 4XX*5191 13 DEC XX6156 99.00 DMNS.APP BUSI 4XXXXX*5191 13 DEC XXXXXXXXXXXXXXXXXX,Account Payment,99.00 DMNS.APP BUSI 4XX*5191 13 DEC XX6156 99.00 DMNS.APP BUSI 4XXXXX*5191 13 DEC XXXXXXXXXXXXXXXXX,1801.14,,4603442.35,AccountTransactionsReport(1).csv,1764,2024-12,False,Other Computer Services,Other Computer Services,Other Computer Services
,2024-12-17,8400/000 : FNB,10.00 SUNO INC. 4XX*5191 13 DEC XX8782 10.00 SUNO INC. 4XXXXX*5191 13 DEC XXXXXXXXXXXXXXXXXXX8782,Account Payment,10.00 SUNO INC. 4XX*5191 13 DEC XX8782 10.00 SUNO INC. 4XXXXX*5191 13 DEC XXXXXXXXXXXXXXXXXXX8782,181.94,,4603624.29,AccountTransactionsReport(1).csv,1765,2024-12,False,Other Computer Services,Other Computer Services,Other Computer Services
,2024-12-17,8400/000 : FNB,11.49 GOOGLE *Colab 4XX*5191 14 DEC XX4842 11.49 GOOGLE *Colab 4XXXXX*5191 14 DEC XXXXXXXXXXXXXXXXXX,Account Payment,11.49 GOOGLE *Colab 4XX*5191 14 DEC XX4842 11.49 GOOGLE *Colab 4XXXXX*5191 14 DEC XXXXXXXXXXXXXXXXX,210.49,,4603834.78,AccountTransactionsReport(1).csv,1766,2024-12,False,Other Computer Services,Analytics & Monitoring,Analytics & Monitoring
,2024-12-17,8400/000 : FNB,"Github Inc. 14.00 GITHUB, INC. 4XXXXX*5225 14 DEC XXXXXXXXXXXXXXXXXXX2221 Github Inc.",Account Payment,"Github Inc. 14.00 GITHUB, INC. 4XXXXX*5225 14 DEC XXXXXXXXXXXXXXXXXXX2221 Github Inc.",256.47,,4604091.25,AccountTransactionsReport(1).csv,1767,2024-12,False,Development Tools,Development Tools,Development Tools
,2024-12-17,8400/000 : FNB,350.00 FRAMER.COM 4XX*5191 16 DEC XX7472 350.00 FRAMER.COM 4XXXXX*5191 16 DEC XXXXXXXXXXXXXXXXXXX747,Account Payment,350.00 FRAMER.COM 4XX*5191 16 DEC XX7472 350.00 FRAMER.COM 4XXXXX*5191 16 DEC XXXXXXXXXXXXXXXXXXX74,350.0,,4604441.25,AccountTransactionsReport(1).csv,1768,2024-12,False,Other Computer Services,Design Tools,Design Tools
,2024-12-17,8400/000 : FNB,20.00 RAILWAY 4XX*5191 14 DEC XX2379 20.00 RAILWAY 4XXXXX*5191 14 DEC XXXXXXXXXXXXXXXXXXX2379,Account Payment,20.00 RAILWAY 4XX*5191 14 DEC XX2379 20.00 RAILWAY 4XXXXX*5191 14 DEC XXXXXXXXXXXXXXXXXXX2379,366.39,,4604807.64,AccountTransactionsReport(1).csv,1769,2024-12,False,Other Computer Services,Other Computer Services,Other Computer Services
,2024-12-17,8400/000 : FNB,Intuit 570.40 INTUIT *QBoo 4XXXXX*5225 14 DEC XXXXXXXXXXXXXXXXXXX3294 Intuit,Account Payment,Intuit 570.40 INTUIT *QBoo 4XXXXX*5225 14 DEC XXXXXXXXXXXXXXXXXXX3294 Intuit,570.4,,4605378.04,AccountTransactionsReport(1).csv,1770,2024-12,False,Productivity Software,Productivity Software,Productivity Software
,2024-12-17,8400/000 : FNB,"40.00 REPLIT, INC. 4XX*5191 14 DEC XX9828 40.00 REPLIT, INC. 4XXXXX*5191 14 DEC XXXXXXXXXXXXXXXXXXX9",Account Payment,"40.00 REPLIT, INC. 4XX*5191 14 DEC XX9828 40.00 REPLIT, INC. 4XXXXX*5191 14 DEC XXXXXXXXXXXXXXXXXXX",732.78,,4606110.82,AccountTransactionsReport(1).csv,1771,2024-12,False,Other Computer Services,Other Computer Services,Other Computer Services
,2024-12-17,8400/000 : FNB,58.75 PADDLE.NET* W 4XX*5191 14 DEC XX3077 58.75 PADDLE.NET* W 4XXXXX*5191 14 DEC XXXXXXXXXXXXXXXXXX,Account Payment,58.75 PADDLE.NET* W 4XX*5191 14 DEC XX3077 58.75 PADDLE.NET* W 4XXXXX*5191 14 DEC XXXXXXXXXXXXXXXXX,1076.27,,4607187.09,AccountTransactionsReport(1).csv,1772,2024-12,False,Other Computer Services,Subscription Management,Subscription Management
,2024-12-17,8400/000 : FNB,70.00 ANTHROPIC 4XX*5191 14 DEC XX7138 70.00 ANTHROPIC 4XXXXX*5191 14 DEC XXXXXXXXXXXXXXXXXXX7138,Account Payment,70.00 ANTHROPIC 4XX*5191 14 DEC XX7138 70.00 ANTHROPIC 4XXXXX*5191 14 DEC XXXXXXXXXXXXXXXXXXX7138,1282.36,,4608469.45,AccountTransactionsReport(1).csv,1773,2024-12,False,AI Services,AI Services,AI Services
,2024-12-17,8400/000 : FNB,100.00 REG AGENT ST 4XX*5191 14 DEC XX9252 100.00 REG AGENT ST 4XXXXX*5191 14 DEC XXXXXXXXXXXXXXXXXX,Account Payment,100.00 REG AGENT ST 4XX*5191 14 DEC XX9252 100.00 REG AGENT ST 4XXXXX*5191 14 DEC XXXXXXXXXXXXXXXXX,1831.95,,4610301.4,AccountTransactionsReport(1).csv,1774,2024-12,False,Other Computer Services,Other Computer Services,Other Computer Services
,2024-12-17,8400/000 : FNB,150.00 OPENAI *CHAT 4XX*5191 14 DEC XX4017 150.00 OPENAI *CHAT 4XXXXX*5191 14 DEC XXXXXXXXXXXXXXXXXX,Account Payment,150.00 OPENAI *CHAT 4XX*5191 14 DEC XX4017 150.00 OPENAI *CHAT 4XXXXX*5191 14 DEC XXXXXXXXXXXXXXXXX,2747.92,,4613049.32,AccountTransactionsReport(1).csv,1775,2024-12,False,AI Services,AI Services,AI Services
,2024-12-17,8400/000 : FNB,170.77 SLACK T0MN3D 4XX*5225 15 DEC XX4778 170.77 SLACK T0MN3D 4XXXXX*5225 15 DEC XXXXXXXXXXXXXXXXXX,Account Payment,170.77 SLACK T0MN3D 4XX*5225 15 DEC XX4778 170.77 SLACK T0MN3D 4XXXXX*5225 15 DEC XXXXXXXXXXXXXXXXX,3128.42,,4616177.74,AccountTransactionsReport(1).csv,1776,2024-12,False,Communication,Communication,Communication
,2024-12-17,8400/000 : FNB,174.00 INTERCOM R&D 4XX*5191 15 DEC XX9269 174.00 INTERCOM R&D 4XXXXX*5191 15 DEC XXXXXXXXXXXXXXXXXX,Account Payment,174.00 INTERCOM R&D 4XX*5191 15 DEC XX9269 174.00 INTERCOM R&D 4XXXXX*5191 15 DEC XXXXXXXXXXXXXXXXX,3187.59,,4619365.33,AccountTransactionsReport(1).csv,1777,2024-12,False,Other Computer Services,Customer Support,Customer Support
,2024-12-17,8400/000 : FNB,180.00 AGENCYANALYT 4XX*5225 13 DEC XX3124 180.00 AGENCYANALYT 4XXXXX*5225 13 DEC XXXXXXXXXXXXXXXXXX,Account Payment,180.00 AGENCYANALYT 4XX*5225 13 DEC XX3124 180.00 AGENCYANALYT 4XXXXX*5225 13 DEC XXXXXXXXXXXXXXXXX,3274.79,,4622640.12,AccountTransactionsReport(1).csv,1778,2024-12,False,Other Computer Services,Other Computer Services,Other Computer Services
,2024-12-17,8400/000 : FNB,231.95 HOLASPIRIT 4XX*5225 15 DEC XX8593 231.95 HOLASPIRIT 4XXXXX*5225 15 DEC XXXXXXXXXXXXXXXXXXX859,Account Payment,231.95 HOLASPIRIT 4XX*5225 15 DEC XX8593 231.95 HOLASPIRIT 4XXXXX*5225 15 DEC XXXXXXXXXXXXXXXXXXX85,4456.62,,4627096.74,AccountTransactionsReport(1).csv,1779,2024-12,False,Other Computer Services,Other Computer Services,Other Computer Services
,2024-12-17,8400/000 : FNB,280.00 WIZA.CO 4XX*5191 14 DEC XX8747 280.00 WIZA.CO 4XXXXX*5191 14 DEC XXXXXXXXXXXXXXXXXXX8747,Account Payment,280.00 WIZA.CO 4XX*5191 14 DEC XX8747 280.00 WIZA.CO 4XXXXX*5191 14 DEC XXXXXXXXXXXXXXXXXXX8747,5129.46,,4632226.2,AccountTransactionsReport(1).csv,1780,2024-12,False,Other Computer Services,Other Computer Services,Other Computer Services
,2024-12-17,8400/000 : FNB,348.00 WWW.MAKE.COM 4XX*5191 15 DEC XX0929 348.00 WWW.MAKE.COM 4XXXXX*5191 15 DEC XXXXXXXXXXXXXXXXXX,Account Payment,348.00 WWW.MAKE.COM 4XX*5191 15 DEC XX0929 348.00 WWW.MAKE.COM 4XXXXX*5191 15 DEC XXXXXXXXXXXXXXXXX,6375.18,,4638601.38,AccountTransactionsReport(1).csv,1781,2024-12,False,Other Computer Services,API Services,API Services
,2024-12-17,8400/000 : FNB,376.40 HOLASPIRIT 4XX*5225 15 DEC XX5686 376.40 HOLASPIRIT 4XXXXX*5225 15 DEC XXXXXXXXXXXXXXXXXXX568,Account Payment,376.40 HOLASPIRIT 4XX*5225 15 DEC XX5686 376.40 HOLASPIRIT 4XXXXX*5225 15 DEC XXXXXXXXXXXXXXXXXXX56,7232.06,,4645833.44,AccountTransactionsReport(1).csv,1782,2024-12,False,Other Computer Services,Other Computer Services,Other Computer Services
,2024-12-17,8400/000 : FNB,5.00 WWW.FLUX.AI 4XX*5191 13 DEC XX9405 5.00 WWW.FLUX.AI 4XXXXX*5191 13 DEC XXXXXXXXXXXXXXXXXXX9405,Account Payment,5.00 WWW.FLUX.AI 4XX*5191 13 DEC XX9405 5.00 WWW.FLUX.AI 4XXXXX*5191 13 DEC XXXXXXXXXXXXXXXXXXX9405,90.96,,4645924.4,AccountTransactionsReport(1).csv,1783,2024-12,False,Other Computer Services,Other Computer Services,Other Computer Services
,2024-12-17,8400/000 : FNB,650.00 ATARIMAGENCY 4XX*5191 15 DEC XX4002 650.00 ATARIMAGENCY 4XXXXX*5191 15 DEC XXXXXXXXXXXXXXXXXX,Account Payment,650.00 ATARIMAGENCY 4XX*5191 15 DEC XX4002 650.00 ATARIMAGENCY 4XXXXX*5191 15 DEC XXXXXXXXXXXXXXXXX,11907.67,,4657832.07,AccountTransactionsReport(1).csv,1784,2024-12,False,Other Computer Services,Other Computer Services,Other Computer Services
,2024-12-17,8400/000 : FNB,780.00 RETOOL 4XX*5225 15 DEC XX9999 780.00 RETOOL 4XXXXX*5225 15 DEC XXXXXXXXXXXXXXXXXXX9999,Account Payment,780.00 RETOOL 4XX*5225 15 DEC XX9999 780.00 RETOOL 4XXXXX*5225 15 DEC XXXXXXXXXXXXXXXXXXX9999,14289.2,,4672121.27,AccountTransactionsReport(1).csv,1785,2024-12,False,Other Computer Services,Other Computer Services,Other Computer Services
,2024-12-18,8400/000 : FNB,20.00 VERCEL INC. 4XX*5191 16 DEC XX2181 20.00 VERCEL INC. 4XXXXX*5191 16 DEC XXXXXXXXXXXXXXXXXXX218,Account Payment,20.00 VERCEL INC. 4XX*5191 16 DEC XX2181 20.00 VERCEL INC. 4XXXXX*5191 16 DEC XXXXXXXXXXXXXXXXXXX21,366.39,,4672487.66,AccountTransactionsReport(1).csv,1786,2024-12,False,Cloud Services,Cloud Services,Cloud Services
,2024-12-19,8400/000 : FNB,6.45 VERCEL INC. 4XX*5225 18 DEC XX3094 6.45 VERCEL INC. 4XXXXX*5225 18 DEC XXXXXXXXXXXXXXXXXXX3094,Account Payment,6.45 VERCEL INC. 4XX*5225 18 DEC XX3094 6.45 VERCEL INC. 4XXXXX*5225 18 DEC XXXXXXXXXXXXXXXXXXX3094,119.64,,4672607.3,AccountTransactionsReport(1).csv,1787,2024-12,False,Cloud Services,Cloud Services,Cloud Services
,2024-12-20,8400/000 : FNB,6.45 VERCEL INC. 4XX*5225 18 DEC XX3224 6.45 VERCEL INC. 4XXXXX*5225 18 DEC XXXXXXXXXXXXXXXXXXX3224,Account Payment,6.45 VERCEL INC. 4XX*5225 18 DEC XX3224 6.45 VERCEL INC. 4XXXXX*5225 18 DEC XXXXXXXXXXXXXXXXXXX3224,119.64,,4672726.94,AccountTransactionsReport(1).csv,1788,2024-12,False,Cloud Services,Cloud Services,Cloud Services
,2024-12-21,8400/000 : FNB,59.00 GREENBACK.COM 4XX*5225 19 DEC XX1663 59.00 GREENBACK.COM 4XXXXX*5225 19 DEC XXXXXXXXXXXXXXXXXX,Account Payment,59.00 GREENBACK.COM 4XX*5225 19 DEC XX1663 59.00 GREENBACK.COM 4XXXXX*5225 19 DEC XXXXXXXXXXXXXXXXX,1106.45,,4673833.39,AccountTransactionsReport(1).csv,1789,2024-12,False,Other Computer Services,Other Computer Services,Other Computer Services
,2024-12-21,8400/000 : FNB,1499.00 APPDIRECT 4XX*5191 19 DEC XX2055 1499.00 APPDIRECT 4XXXXX*5191 19 DEC XXXXXXXXXXXXXXXXXXX205,Account Payment,1499.00 APPDIRECT 4XX*5191 19 DEC XX2055 1499.00 APPDIRECT 4XXXXX*5191 19 DEC XXXXXXXXXXXXXXXXXXX20,28111.21,,4701944.6,AccountTransactionsReport(1).csv,1790,2024-12,False,Other Computer Services,Other Computer Services,Other Computer Services
,2024-12-23,8400/000 : FNB,54.00 AIRTABLE.COM/ 4XX*5191 21 DEC XX1051 54.00 AIRTABLE.COM/ 4XXXXX*5191 21 DEC XXXXXXXXXXXXXXXXXX,Account Payment,54.00 AIRTABLE.COM/ 4XX*5191 21 DEC XX1051 54.00 AIRTABLE.COM/ 4XXXXX*5191 21 DEC XXXXXXXXXXXXXXXXX,1016.72,,4702961.32,AccountTransactionsReport(1).csv,1791,2024-12,False,Other Computer Services,Collaboration Tools,Collaboration Tools
,2024-12-23,8400/000 : FNB,"74.00 PIPEDREAM, IN 4XX*5191 20 DEC XX1230 74.00 PIPEDREAM, IN 4XXXXX*5191 20 DEC XXXXXXXXXXXXXXXXXX",Account Payment,"74.00 PIPEDREAM, IN 4XX*5191 20 DEC XX1230 74.00 PIPEDREAM, IN 4XXXXX*5191 20 DEC XXXXXXXXXXXXXXXXX",1393.04,,4704354.36,AccountTransactionsReport(1).csv,1792,2024-12,False,Other Computer Services,Other Computer Services,Other Computer Services
,2024-12-23,8400/000 : FNB,870.39 APPDIRECT 4XX*5191 20 DEC XX6206 870.39 APPDIRECT 4XXXXX*5191 20 DEC XXXXXXXXXXXXXXXXXXX6206,Account Payment,870.39 APPDIRECT 4XX*5191 20 DEC XX6206 870.39 APPDIRECT 4XXXXX*5191 20 DEC XXXXXXXXXXXXXXXXXXX6206,16385.09,,4720739.45,AccountTransactionsReport(1).csv,1793,2024-12,False,Other Computer Services,Other Computer Services,Other Computer Services
,2024-12-23,8400/000 : FNB,1512.00 FIGMA 4XX*5191 21 DEC XX3598 1512.00 FIGMA 4XXXXX*5191 21 DEC XXXXXXXXXXXXXXXXXXX3598,Account Payment,1512.00 FIGMA 4XX*5191 21 DEC XX3598 1512.00 FIGMA 4XXXXX*5191 21 DEC XXXXXXXXXXXXXXXXXXX3598,28468.01,,4749207.46,AccountTransactionsReport(1).csv,1794,2024-12,False,Other Computer Services,Design Tools,Design Tools
,2024-12-24,8400/000 : FNB,100.00 OPENAI 4XX*5191 23 DEC XX6510 100.00 OPENAI 4XXXXX*5191 23 DEC XXXXXXXXXXXXXXXXXXX6510,Account Payment,100.00 OPENAI 4XX*5191 23 DEC XX6510 100.00 OPENAI 4XXXXX*5191 23 DEC XXXXXXXXXXXXXXXXXXX6510,1882.81,,4751090.27,AccountTransactionsReport(1).csv,1795,2024-12,False,AI Services,AI Services,AI Services
,2024-12-24,8400/000 : FNB,299.00 ORG CHART 4XX*5191 22 DEC XX7664 299.00 ORG CHART 4XXXXX*5191 22 DEC XXXXXXXXXXXXXXXXXXX7664,Account Payment,299.00 ORG CHART 4XX*5191 22 DEC XX7664 299.00 ORG CHART 4XXXXX*5191 22 DEC XXXXXXXXXXXXXXXXXXX7664,5629.58,,4756719.85,AccountTransactionsReport(1).csv,1796,2024-12,False,Other Computer Services,Other Computer Services,Other Computer Services
,2024-12-27,8400/000 : FNB,Facebook 1192.32 FACEBK *NYE 4XXXXX*5191 26 DEC XXXXXXXXXXXXXXXXXXX2064 Facebook,Account Payment,Facebook 1192.32 FACEBK *NYE 4XXXXX*5191 26 DEC XXXXXXXXXXXXXXXXXXX2064 Facebook,1192.32,,4757912.17,AccountTransactionsReport(1).csv,1797,2024-12,False,Marketing Tools,Marketing Tools,Marketing Tools
,2024-12-27,8400/000 : FNB,89.00 SENTRY 4XX*5191 24 DEC XX7959 89.00 SENTRY 4XXXXX*5191 24 DEC XXXXXXXXXXXXXXXXXXX7959,Account Payment,89.00 SENTRY 4XX*5191 24 DEC XX7959 89.00 SENTRY 4XXXXX*5191 24 DEC XXXXXXXXXXXXXXXXXXX7959,1690.73,,4759602.9,AccountTransactionsReport(1).csv,1798,2024-12,False,Other Computer Services,Analytics & Monitoring,Analytics & Monitoring
,2024-12-27,8400/000 : FNB,96.00 OBSIDIAN.MD 4XX*5191 25 DEC XX2850 96.00 OBSIDIAN.MD 4XXXXX*5191 25 DEC XXXXXXXXXXXXXXXXXXX285,Account Payment,96.00 OBSIDIAN.MD 4XX*5191 25 DEC XX2850 96.00 OBSIDIAN.MD 4XXXXX*5191 25 DEC XXXXXXXXXXXXXXXXXXX28,1833.95,,4761436.85,AccountTransactionsReport(1).csv,1799,2024-12,False,Other Computer Services,Other Computer Services,Other Computer Services
,2024-12-27,8400/000 : FNB,150.00 AUTH0.COM 4XX*5191 25 DEC XX3332 150.00 AUTH0.COM 4XXXXX*5191 25 DEC XXXXXXXXXXXXXXXXXXX3332,Account Payment,150.00 AUTH0.COM 4XX*5191 25 DEC XX3332 150.00 AUTH0.COM 4XXXXX*5191 25 DEC XXXXXXXXXXXXXXXXXXX3332,2865.55,,4764302.4,AccountTransactionsReport(1).csv,1800,2024-12,False,Security Services,Security Services,Security Services
,2024-12-27,8400/000 : FNB,"6.00 DOCKER, INC. 4XX*5191 24 DEC XX7822 6.00 DOCKER, INC. 4XXXXX*5191 24 DEC XXXXXXXXXXXXXXXXXXX782",Account Payment,"6.00 DOCKER, INC. 4XX*5191 24 DEC XX7822 6.00 DOCKER, INC. 4XXXXX*5191 24 DEC XXXXXXXXXXXXXXXXXXX78",113.99,,4764416.39,AccountTransactionsReport(1).csv,1801,2024-12,False,Other Computer Services,Other Computer Services,Other Computer Services
,2024-12-27,8400/000 : FNB,10.00 MATTERMOST 4XX*5191 24 DEC XX8370 10.00 MATTERMOST 4XXXXX*5191 24 DEC XXXXXXXXXXXXXXXXXXX8370,Account Payment,10.00 MATTERMOST 4XX*5191 24 DEC XX8370 10.00 MATTERMOST 4XXXXX*5191 24 DEC XXXXXXXXXXXXXXXXXXX8370,189.96,,4764606.35,AccountTransactionsReport(1).csv,1802,2024-12,False,Other Computer Services,Other Computer Services,Other Computer Services
,2024-12-27,8400/000 : FNB,Dropbox 18.38 DROPBOX*T8VR6 4XXXXX*5191 24 DEC XXXXXXXXXXXXXXXXXXX0755 Dropbox,Account Payment,Dropbox 18.38 DROPBOX*T8VR6 4XXXXX*5191 24 DEC XXXXXXXXXXXXXXXXXXX0755 Dropbox,349.17,,4764955.52,AccountTransactionsReport(1).csv,1803,2024-12,False,Other Computer Services,Other Computer Services,Other Computer Services
,2024-12-27,8400/000 : FNB,399.99 POE.COM 4XX*5191 26 DEC XX1339 399.99 POE.COM 4XXXXX*5191 26 DEC XXXXXXXXXXXXXXXXXXX1339,Account Payment,399.99 POE.COM 4XX*5191 26 DEC XX1339 399.99 POE.COM 4XXXXX*5191 26 DEC XXXXXXXXXXXXXXXXXXX1339,399.99,,4765355.51,AccountTransactionsReport(1).csv,1804,2024-12,False,Other Computer Services,Other Computer Services,Other Computer Services
,2024-12-27,8400/000 : FNB,30.00 HASURA 4XX*5191 23 DEC XX6584 30.00 HASURA 4XXXXX*5191 23 DEC XXXXXXXXXXXXXXXXXXX6584,Account Payment,30.00 HASURA 4XX*5191 23 DEC XX6584 30.00 HASURA 4XXXXX*5191 23 DEC XXXXXXXXXXXXXXXXXXX6584,564.85,,4765920.36,AccountTransactionsReport(1).csv,1805,2024-12,False,Other Computer Services,Other Computer Services,Other Computer Services
,2024-12-27,8400/000 : FNB,50.00 ANACONDA INC. 4XX*5191 26 DEC XX6344 50.00 ANACONDA INC. 4XXXXX*5191 26 DEC XXXXXXXXXXXXXXXXXX,Account Payment,50.00 ANACONDA INC. 4XX*5191 26 DEC XX6344 50.00 ANACONDA INC. 4XXXXX*5191 26 DEC XXXXXXXXXXXXXXXXX,955.18,,4766875.54,AccountTransactionsReport(1).csv,1806,2024-12,False,Other Computer Services,Other Computer Services,Other Computer Services
,2024-12-27,8400/000 : FNB,50.00 OBSIDIAN.MD 4XX*5191 25 DEC XX4206 50.00 OBSIDIAN.MD 4XXXXX*5191 25 DEC XXXXXXXXXXXXXXXXXXX420,Account Payment,50.00 OBSIDIAN.MD 4XX*5191 25 DEC XX4206 50.00 OBSIDIAN.MD 4XXXXX*5191 25 DEC XXXXXXXXXXXXXXXXXXX42,955.18,,4767830.72,AccountTransactionsReport(1).csv,1807,2024-12,False,Other Computer Services,Other Computer Services,Other Computer Services
,2024-12-28,8400/000 : FNB,1150.00 AUTH0.COM 4XX*5191 26 DEC XX1818 1150.00 AUTH0.COM 4XXXXX*5191 26 DEC XXXXXXXXXXXXXXXXXXX181,Account Payment,1150.00 AUTH0.COM 4XX*5191 26 DEC XX1818 1150.00 AUTH0.COM 4XXXXX*5191 26 DEC XXXXXXXXXXXXXXXXXXX18,21969.21,,4789799.93,AccountTransactionsReport(1).csv,1808,2024-12,False,Security Services,Security Services,Security Services
,2024-12-30,8400/000 : FNB,Intuit 171.12 INTUIT *QBoo 4XXXXX*5225 27 DEC XXXXXXXXXXXXXXXXXXX7877 Intuit,Account Payment,Intuit 171.12 INTUIT *QBoo 4XXXXX*5225 27 DEC XXXXXXXXXXXXXXXXXXX7877 Intuit,171.12,,4789971.05,AccountTransactionsReport(1).csv,1809,2024-12,False,Productivity Software,Productivity Software,Productivity Software
,2024-12-30,8400/000 : FNB,Intuit 546.25 INTUIT *QBoo 4XXXXX*5225 27 DEC XXXXXXXXXXXXXXXXXXX7604 Intuit,Account Payment,Intuit 546.25 INTUIT *QBoo 4XXXXX*5225 27 DEC XXXXXXXXXXXXXXXXXXX7604 Intuit,546.25,,4790517.3,AccountTransactionsReport(1).csv,1810,2024-12,False,Productivity Software,Productivity Software,Productivity Software
,2024-12-30,8400/000 : FNB,Intuit 570.40 INTUIT *QBoo 4XXXXX*5225 27 DEC XXXXXXXXXXXXXXXXXXX7976 Intuit,Account Payment,Intuit 570.40 INTUIT *QBoo 4XXXXX*5225 27 DEC XXXXXXXXXXXXXXXXXXX7976 Intuit,570.4,,4791087.7,AccountTransactionsReport(1).csv,1811,2024-12,False,Productivity Software,Productivity Software,Productivity Software
,2024-12-30,8400/000 : FNB,628.61 APPDIRECT 4XX*5191 27 DEC XX6000 628.61 APPDIRECT 4XXXXX*5191 27 DEC XXXXXXXXXXXXXXXXXXX6000,Account Payment,628.61 APPDIRECT 4XX*5191 27 DEC XX6000 628.61 APPDIRECT 4XXXXX*5191 27 DEC XXXXXXXXXXXXXXXXXXX6000,12134.36,,4803222.06,AccountTransactionsReport(1).csv,1812,2024-12,False,Other Computer Services,Other Computer Services,Other Computer Services
,2024-12-30,8400/000 : FNB,Shopify 3421.17 SHOPIFY* 31 4XXXXX*5191 27 DEC XXXXXXXXXXXXXXXXXXX9915 Shopify,Account Payment,Shopify 3421.17 SHOPIFY* 31 4XXXXX*5191 27 DEC XXXXXXXXXXXXXXXXXXX9915 Shopify,66040.5,,4869262.56,AccountTransactionsReport(1).csv,1813,2024-12,False,E-commerce Platforms,E-commerce Platforms,E-commerce Platforms
,2024-12-31,8400/000 : FNB,WINX3843 WINX3843,Account Receipt,WINX3843 WINX3843,,45608.15,4823654.41,AccountTransactionsReport(1).csv,1814,2024-12,False,Other Computer Services,Other Computer Services,Other Computer Services
,2024-12-31,8400/000 : FNB,5.00 COMPONENTS.STU 4XX*5191 29 DEC XX0233 5.00 COMPONENTS.STU 4XXXXX*5191 29 DEC XXXXXXXXXXXXXXXXXX,Account Payment,5.00 COMPONENTS.STU 4XX*5191 29 DEC XX0233 5.00 COMPONENTS.STU 4XXXXX*5191 29 DEC XXXXXXXXXXXXXXXXX,96.4,,4823750.81,AccountTransactionsReport(1).csv,1815,2024-12,False,Other Computer Services,Other Computer Services,Other Computer Services
,2024-12-31,8400/000 : FNB,Canva 141.99 CANVA* I0438 4XXXXX*5225 29 DEC XXXXXXXXXXXXXXXXXXX9020 Canva,Account Payment,Canva 141.99 CANVA* I0438 4XXXXX*5225 29 DEC XXXXXXXXXXXXXXXXXXX9020 Canva,141.99,,4823892.8,AccountTransactionsReport(1).csv,1816,2024-12,False,Other Computer Services,Design Tools,Design Tools
,2024-12-31,8400/000 : FNB,9.00 GITPOD.IO 4XX*5191 28 DEC XX6736 9.00 GITPOD.IO 4XXXXX*5191 28 DEC XXXXXXXXXXXXXXXXXXX6736,Account Payment,9.00 GITPOD.IO 4XX*5191 28 DEC XX6736 9.00 GITPOD.IO 4XXXXX*5191 28 DEC XXXXXXXXXXXXXXXXXXX6736,173.52,,4824066.32,AccountTransactionsReport(1).csv,1817,2024-12,False,Development Tools,Development Tools,Development Tools
,2024-12-31,8400/000 : FNB,12.44 UNSTOPPABLEDO 4XX*5191 30 DEC XX6876 12.44 UNSTOPPABLEDO 4XXXXX*5191 30 DEC XXXXXXXXXXXXXXXXXX,Account Payment,12.44 UNSTOPPABLEDO 4XX*5191 30 DEC XX6876 12.44 UNSTOPPABLEDO 4XXXXX*5191 30 DEC XXXXXXXXXXXXXXXXX,239.84,,4824306.16,AccountTransactionsReport(1).csv,1818,2024-12,False,Other Computer Services,Other Computer Services,Other Computer Services
,2024-12-31,8400/000 : FNB,20.00 HUGGINGFACE 4XX*5191 30 DEC XX8925 20.00 HUGGINGFACE 4XXXXX*5191 30 DEC XXXXXXXXXXXXXXXXXXX892,Account Payment,20.00 HUGGINGFACE 4XX*5191 30 DEC XX8925 20.00 HUGGINGFACE 4XXXXX*5191 30 DEC XXXXXXXXXXXXXXXXXXX89,385.59,,4824691.75,AccountTransactionsReport(1).csv,1819,2024-12,False,AI Services,AI Services,AI Services
,2024-12-31,8400/000 : FNB,430.00 Dlocal *Micr 4XX*5191 28 DEC XX2728 430.00 Dlocal *Micr 4XXXXX*5191 28 DEC XXXXXXXXXXXXXXXXXX,Account Payment,430.00 Dlocal *Micr 4XX*5191 28 DEC XX2728 430.00 Dlocal *Micr 4XXXXX*5191 28 DEC XXXXXXXXXXXXXXXXX,430.0,,4825121.75,AccountTransactionsReport(1).csv,1820,2024-12,False,Other Computer Services,Other Computer Services,Other Computer Services
,2024-12-31,8400/000 : FNB,29.99 BEENVERIFIED 4XX*5191 28 DEC XX6703 29.99 BEENVERIFIED 4XXXXX*5191 28 DEC XXXXXXXXXXXXXXXXXXX6,Account Payment,29.99 BEENVERIFIED 4XX*5191 28 DEC XX6703 29.99 BEENVERIFIED 4XXXXX*5191 28 DEC XXXXXXXXXXXXXXXXXXX,578.2,,4825699.95,AccountTransactionsReport(1).csv,1821,2024-12,False,Other Computer Services,Other Computer Services,Other Computer Services
,2024-12-31,8400/000 : FNB,100.00 OPENAI 4XX*5191 30 DEC XX6323 100.00 OPENAI 4XXXXX*5191 30 DEC XXXXXXXXXXXXXXXXXXX6323,Account Payment,100.00 OPENAI 4XX*5191 30 DEC XX6323 100.00 OPENAI 4XXXXX*5191 30 DEC XXXXXXXXXXXXXXXXXXX6323,1927.97,,4827627.92,AccountTransactionsReport(1).csv,1822,2024-12,False,AI Services,AI Services,AI Services
,2024-12-31,8400/000 : FNB,100.00 OPENAI 4XX*5191 30 DEC XX0437 100.00 OPENAI 4XXXXX*5191 30 DEC XXXXXXXXXXXXXXXXXXX0437,Account Payment,100.00 OPENAI 4XX*5191 30 DEC XX0437 100.00 OPENAI 4XXXXX*5191 30 DEC XXXXXXXXXXXXXXXXXXX0437,1927.97,,4829555.89,AccountTransactionsReport(1).csv,1823,2024-12,False,AI Services,AI Services,AI Services
,2024-12-31,8400/000 : FNB,Wix.com 182.85 WIX.COM 4XXXXX*5191 29 DEC XXXXXXXXXXXXXXXXXXX4365 Wix.com,Account Payment,Wix.com 182.85 WIX.COM 4XXXXX*5191 29 DEC XXXXXXXXXXXXXXXXXXX4365 Wix.com,3525.3,,4833081.19,AccountTransactionsReport(1).csv,1824,2024-12,False,E-commerce Platforms,E-commerce Platforms,E-commerce Platforms
,2024-12-31,8400/000 : FNB,5050.80 FRESHWORKS 4XX*5225 29 DEC XX7380 5050.80 FRESHWORKS 4XXXXX*5225 29 DEC XXXXXXXXXXXXXXXXXXX7,Account Payment,5050.80 FRESHWORKS 4XX*5225 29 DEC XX7380 5050.80 FRESHWORKS 4XXXXX*5225 29 DEC XXXXXXXXXXXXXXXXXXX,5050.8,,4838131.99,AccountTransactionsReport(1).csv,1825,2024-12,False,Productivity Software,Productivity Software,Productivity Software
,2025-01-03,8400/000 : FNB,39.82 GOOGLE*GSUITE 4XX*5225 01 JAN XX0063 39.82 GOOGLE*GSUITE 4XXXXX*5225 01 JAN XXXXXXXXXXXXXXXXXX,Account Payment,39.82 GOOGLE*GSUITE 4XX*5225 01 JAN XX0063 39.82 GOOGLE*GSUITE 4XXXXX*5225 01 JAN XXXXXXXXXXXXXXXXX,799.26,,4838931.25,AccountTransactionsReport(1).csv,1826,2025-01,False,Other Computer Services,Analytics & Monitoring,Analytics & Monitoring
,2025-01-03,8400/000 : FNB,83.96 GOOGLE*GSUITE 4XX*5225 01 JAN XX0383 83.96 GOOGLE*GSUITE 4XXXXX*5225 01 JAN XXXXXXXXXXXXXXXXXX,Account Payment,83.96 GOOGLE*GSUITE 4XX*5225 01 JAN XX0383 83.96 GOOGLE*GSUITE 4XXXXX*5225 01 JAN XXXXXXXXXXXXXXXXX,1685.22,,4840616.47,AccountTransactionsReport(1).csv,1827,2025-01,False,Other Computer Services,Analytics & Monitoring,Analytics & Monitoring
,2025-01-03,8400/000 : FNB,Google Store 391.60 GOOGLE*GSUIT 4XXXXX*5225 01 JAN XXXXXXXXXXXXXXXXXXX3962 Google Store,Account Payment,Google Store 391.60 GOOGLE*GSUIT 4XXXXX*5225 01 JAN XXXXXXXXXXXXXXXXXXX3962 Google Store,7860.1,,4848476.57,AccountTransactionsReport(1).csv,1828,2025-01,False,Other Computer Services,Analytics & Monitoring,Analytics & Monitoring
,2025-01-07,8400/000 : FNB,1499.00 APPDIRECT 4XX*5225 04 JAN XX5062 1499.00 APPDIRECT 4XXXXX*5225 04 JAN XXXXXXXXXXXXXXXXXXX506,Account Payment,1499.00 APPDIRECT 4XX*5225 04 JAN XX5062 1499.00 APPDIRECT 4XXXXX*5225 04 JAN XXXXXXXXXXXXXXXXXXX50,28796.3,,4877272.87,AccountTransactionsReport(1).csv,1829,2025-01,False,Other Computer Services,Other Computer Services,Other Computer Services
,2025-01-07,8400/000 : FNB,Facebook 4.60 FACEBK *52YJGF 4XXXXX*5191 05 JAN XXXXXXXXXXXXXXXXXXX6057 Facebook,Account Payment,Facebook 4.60 FACEBK *52YJGF 4XXXXX*5191 05 JAN XXXXXXXXXXXXXXXXXXX6057 Facebook,88.36,,4877361.23,AccountTransactionsReport(1).csv,1830,2025-01,False,Marketing Tools,Marketing Tools,Marketing Tools
,2025-01-07,8400/000 : FNB,"Github Inc. 7.82 GITHUB, INC. 4XXXXX*5225 04 JAN XXXXXXXXXXXXXXXXXXX7000 Github Inc.",Account Payment,"Github Inc. 7.82 GITHUB, INC. 4XXXXX*5225 04 JAN XXXXXXXXXXXXXXXXXXX7000 Github Inc.",150.23,,4877511.46,AccountTransactionsReport(1).csv,1831,2025-01,False,Development Tools,Development Tools,Development Tools
,2025-01-07,8400/000 : FNB,9.00 TWENTY.COM 4XX*5191 06 JAN XX0614 9.00 TWENTY.COM 4XXXXX*5191 06 JAN XXXXXXXXXXXXXXXXXXX0614,Account Payment,9.00 TWENTY.COM 4XX*5191 06 JAN XX0614 9.00 TWENTY.COM 4XXXXX*5191 06 JAN XXXXXXXXXXXXXXXXXXX0614,172.89,,4877684.35,AccountTransactionsReport(1).csv,1832,2025-01,False,Other Computer Services,Other Computer Services,Other Computer Services
,2025-01-07,8400/000 : FNB,Paddle 187.94 PADDLE.NET* 4XXXXX*5191 05 JAN XXXXXXXXXXXXXXXXXXX6801 Paddle,Account Payment,Paddle 187.94 PADDLE.NET* 4XXXXX*5191 05 JAN XXXXXXXXXXXXXXXXXXX6801 Paddle,187.94,,4877872.29,AccountTransactionsReport(1).csv,1833,2025-01,False,Other Computer Services,Subscription Management,Subscription Management
,2025-01-07,8400/000 : FNB,Facebook 13.80 FACEBK *W2HAM 4XXXXX*5191 05 JAN XXXXXXXXXXXXXXXXXXX7073 Facebook,Account Payment,Facebook 13.80 FACEBK *W2HAM 4XXXXX*5191 05 JAN XXXXXXXXXXXXXXXXXXX7073 Facebook,265.1,,4878137.39,AccountTransactionsReport(1).csv,1834,2025-01,False,Marketing Tools,Marketing Tools,Marketing Tools
,2025-01-07,8400/000 : FNB,17.25 SLACK T06A3T4 4XX*5191 05 JAN XX2346 17.25 SLACK T06A3T4 4XXXXX*5191 05 JAN XXXXXXXXXXXXXXXXXX,Account Payment,17.25 SLACK T06A3T4 4XX*5191 05 JAN XX2346 17.25 SLACK T06A3T4 4XXXXX*5191 05 JAN XXXXXXXXXXXXXXXXX,331.38,,4878468.77,AccountTransactionsReport(1).csv,1835,2025-01,False,Communication,Communication,Communication
,2025-01-07,8400/000 : FNB,"Github Inc. 19.00 GITHUB, INC. 4XXXXX*5225 04 JAN XXXXXXXXXXXXXXXXXXX8259 Github Inc.",Account Payment,"Github Inc. 19.00 GITHUB, INC. 4XXXXX*5225 04 JAN XXXXXXXXXXXXXXXXXXX8259 Github Inc.",365.0,,4878833.77,AccountTransactionsReport(1).csv,1836,2025-01,False,Development Tools,Development Tools,Development Tools
,2025-01-07,8400/000 : FNB,Facebook 23.00 FACEBK *V4RA3 4XXXXX*5191 05 JAN XXXXXXXXXXXXXXXXXXX1098 Facebook,Account Payment,Facebook 23.00 FACEBK *V4RA3 4XXXXX*5191 05 JAN XXXXXXXXXXXXXXXXXXX1098 Facebook,441.83,,4879275.6,AccountTransactionsReport(1).csv,1837,2025-01,False,Marketing Tools,Marketing Tools,Marketing Tools
,2025-01-07,8400/000 : FNB,29.00 CAL.COM 4XX*5191 05 JAN XX9721 29.00 CAL.COM 4XXXXX*5191 05 JAN XXXXXXXXXXXXXXXXXXX9721,Account Payment,29.00 CAL.COM 4XX*5191 05 JAN XX9721 29.00 CAL.COM 4XXXXX*5191 05 JAN XXXXXXXXXXXXXXXXXXX9721,557.1,,4879832.7,AccountTransactionsReport(1).csv,1838,2025-01,False,Other Computer Services,Other Computer Services,Other Computer Services
,2025-01-07,8400/000 : FNB,99.00 WWW.ODRIVE.CO 4XX*5191 05 JAN XX0711 99.00 WWW.ODRIVE.CO 4XXXXX*5191 05 JAN XXXXXXXXXXXXXXXXXX,Account Payment,99.00 WWW.ODRIVE.CO 4XX*5191 05 JAN XX0711 99.00 WWW.ODRIVE.CO 4XXXXX*5191 05 JAN XXXXXXXXXXXXXXXXX,1901.82,,4881734.52,AccountTransactionsReport(1).csv,1839,2025-01,False,Other Computer Services,Other Computer Services,Other Computer Services
,2025-01-07,8400/000 : FNB,99.00 CHATBASE 4XX*5191 05 JAN XX0791 99.00 CHATBASE 4XXXXX*5191 05 JAN XXXXXXXXXXXXXXXXXXX0791,Account Payment,99.00 CHATBASE 4XX*5191 05 JAN XX0791 99.00 CHATBASE 4XXXXX*5191 05 JAN XXXXXXXXXXXXXXXXXXX0791,1901.82,,4883636.34,AccountTransactionsReport(1).csv,1840,2025-01,False,Other Computer Services,Other Computer Services,Other Computer Services
,2025-01-07,8400/000 : FNB,99.99 JINA.AI 4XX*5191 06 JAN XX0934 99.99 JINA.AI 4XXXXX*5191 06 JAN XXXXXXXXXXXXXXXXXXX0934,Account Payment,99.99 JINA.AI 4XX*5191 06 JAN XX0934 99.99 JINA.AI 4XXXXX*5191 06 JAN XXXXXXXXXXXXXXXXXXX0934,1920.84,,4885557.18,AccountTransactionsReport(1).csv,1841,2025-01,False,Other Computer Services,Other Computer Services,Other Computer Services
,2025-01-07,8400/000 : FNB,ManageWP 120.75 MANAGEWP 4XXXXX*5225 05 JAN XXXXXXXXXXXXXXXXXXX7720 ManageWP,Account Payment,ManageWP 120.75 MANAGEWP 4XXXXX*5225 05 JAN XXXXXXXXXXXXXXXXXXX7720 ManageWP,2319.65,,4887876.83,AccountTransactionsReport(1).csv,1842,2025-01,False,Other Computer Services,Other Computer Services,Other Computer Services
,2025-01-07,8400/000 : FNB,ManageWP 120.75 MANAGEWP 4XXXXX*5225 05 JAN XXXXXXXXXXXXXXXXXXX8059 ManageWP,Account Payment,ManageWP 120.75 MANAGEWP 4XXXXX*5225 05 JAN XXXXXXXXXXXXXXXXXXX8059 ManageWP,2319.65,,4890196.48,AccountTransactionsReport(1).csv,1843,2025-01,False,Other Computer Services,Other Computer Services,Other Computer Services
,2025-01-07,8400/000 : FNB,179.00 MOZSEO:HELP@ 4XX*5191 05 JAN XX6135 179.00 MOZSEO:HELP@ 4XXXXX*5191 05 JAN XXXXXXXXXXXXXXXXXX,Account Payment,179.00 MOZSEO:HELP@ 4XX*5191 05 JAN XX6135 179.00 MOZSEO:HELP@ 4XXXXX*5191 05 JAN XXXXXXXXXXXXXXXXX,3438.65,,4893635.13,AccountTransactionsReport(1).csv,1844,2025-01,False,Other Computer Services,Other Computer Services,Other Computer Services
,2025-01-07,8400/000 : FNB,399.99 CHATBOX AI 4XX*5191 05 JAN XX7259 399.99 CHATBOX AI 4XXXXX*5191 05 JAN XXXXXXXXXXXXXXXXXXX725,Account Payment,399.99 CHATBOX AI 4XX*5191 05 JAN XX7259 399.99 CHATBOX AI 4XXXXX*5191 05 JAN XXXXXXXXXXXXXXXXXXX72,7683.95,,4901319.08,AccountTransactionsReport(1).csv,1845,2025-01,False,Other Computer Services,Other Computer Services,Other Computer Services
,2025-01-08,8400/000 : FNB,3.60 GETADDRESS.IO 4XX*5225 07 JAN XX2281 3.60 GETADDRESS.IO 4XXXXX*5225 07 JAN XXXXXXXXXXXXXXXXXXX2,Account Payment,3.60 GETADDRESS.IO 4XX*5225 07 JAN XX2281 3.60 GETADDRESS.IO 4XXXXX*5225 07 JAN XXXXXXXXXXXXXXXXXXX,85.86,,4901404.94,AccountTransactionsReport(1).csv,1846,2025-01,False,Other Computer Services,Other Computer Services,Other Computer Services
,2025-01-08,8400/000 : FNB,Woocommerce 19.99 WOOCOMMERCE S 4XXXXX*5225 06 JAN XXXXXXXXXXXXXXXXXXX9297 Woocommerce,Account Payment,Woocommerce 19.99 WOOCOMMERCE S 4XXXXX*5225 06 JAN XXXXXXXXXXXXXXXXXXX9297 Woocommerce,384.02,,4901788.96,AccountTransactionsReport(1).csv,1847,2025-01,False,Other Computer Services,Other Computer Services,Other Computer Services
,2025-01-08,8400/000 : FNB,20.00 VERCEL INC. 4XX*5225 06 JAN XX7675 20.00 VERCEL INC. 4XXXXX*5225 06 JAN XXXXXXXXXXXXXXXXXXX767,Account Payment,20.00 VERCEL INC. 4XX*5225 06 JAN XX7675 20.00 VERCEL INC. 4XXXXX*5225 06 JAN XXXXXXXXXXXXXXXXXXX76,384.2,,4902173.16,AccountTransactionsReport(1).csv,1848,2025-01,False,Cloud Services,Cloud Services,Cloud Services
,2025-01-08,8400/000 : FNB,41.00 VERCEL INC. 4XX*5225 06 JAN XX6600 41.00 VERCEL INC. 4XXXXX*5225 06 JAN XXXXXXXXXXXXXXXXXXX660,Account Payment,41.00 VERCEL INC. 4XX*5225 06 JAN XX6600 41.00 VERCEL INC. 4XXXXX*5225 06 JAN XXXXXXXXXXXXXXXXXXX66,787.62,,4902960.78,AccountTransactionsReport(1).csv,1849,2025-01,False,Cloud Services,Cloud Services,Cloud Services
,2025-01-08,8400/000 : FNB,72.00 TERMIUS CORPO 4XX*5191 06 JAN XX2018 72.00 TERMIUS CORPO 4XXXXX*5191 06 JAN XXXXXXXXXXXXXXXXXX,Account Payment,72.00 TERMIUS CORPO 4XX*5191 06 JAN XX2018 72.00 TERMIUS CORPO 4XXXXX*5191 06 JAN XXXXXXXXXXXXXXXXX,1383.14,,4904343.92,AccountTransactionsReport(1).csv,1850,2025-01,False,Other Computer Services,Other Computer Services,Other Computer Services
,2025-01-08,8400/000 : FNB,920.00 AUTH0.COM 4XX*5191 06 JAN XX8971 920.00 AUTH0.COM 4XXXXX*5191 06 JAN XXXXXXXXXXXXXXXXXXX8971,Account Payment,920.00 AUTH0.COM 4XX*5191 06 JAN XX8971 920.00 AUTH0.COM 4XXXXX*5191 06 JAN XXXXXXXXXXXXXXXXXXX8971,17673.52,,4922017.44,AccountTransactionsReport(1).csv,1851,2025-01,False,Security Services,Security Services,Security Services
,2025-01-08,8400/000 : FNB,Shopify 2558.98 SHOPIFY* 31 4XXXXX*5191 06 JAN XXXXXXXXXXXXXXXXXXX8711 Shopify,Account Payment,Shopify 2558.98 SHOPIFY* 31 4XXXXX*5191 06 JAN XXXXXXXXXXXXXXXXXXX8711 Shopify,49158.88,,4971176.32,AccountTransactionsReport(1).csv,1852,2025-01,False,E-commerce Platforms,E-commerce Platforms,E-commerce Platforms
,2025-01-09,8400/000 : FNB,"105.00 NOTION LABS, 4XX*5225 07 JAN XX0510 105.00 NOTION LABS, 4XXXXX*5225 07 JAN XXXXXXXXXXXXXXXXXX",Account Payment,"105.00 NOTION LABS, 4XX*5225 07 JAN XX0510 105.00 NOTION LABS, 4XXXXX*5225 07 JAN XXXXXXXXXXXXXXXXX",2013.8,,4973190.12,AccountTransactionsReport(1).csv,1853,2025-01,False,Other Computer Services,Collaboration Tools,Collaboration Tools
,2025-01-09,8400/000 : FNB,99.00 MIOSALON.COM( 4XX*5225 07 JAN XX2845 99.00 MIOSALON.COM( 4XXXXX*5225 07 JAN XXXXXXXXXXXXXXXXXX,Account Payment,99.00 MIOSALON.COM( 4XX*5225 07 JAN XX2845 99.00 MIOSALON.COM( 4XXXXX*5225 07 JAN XXXXXXXXXXXXXXXXX,1898.72,,4975088.84,AccountTransactionsReport(1).csv,1854,2025-01,False,Other Computer Services,Other Computer Services,Other Computer Services
,2025-01-09,8400/000 : FNB,99.00 MIOSALON.COM( 4XX*5225 07 JAN XX0013 99.00 MIOSALON.COM( 4XXXXX*5225 07 JAN XXXXXXXXXXXXXXXXXX,Account Payment,99.00 MIOSALON.COM( 4XX*5225 07 JAN XX0013 99.00 MIOSALON.COM( 4XXXXX*5225 07 JAN XXXXXXXXXXXXXXXXX,1898.72,,4976987.56,AccountTransactionsReport(1).csv,1855,2025-01,False,Other Computer Services,Other Computer Services,Other Computer Services
,2025-01-09,8400/000 : FNB,Intuit 570.40 INTUIT *QBoo 4XXXXX*5225 07 JAN XXXXXXXXXXXXXXXXXXX9255 Intuit,Account Payment,Intuit 570.40 INTUIT *QBoo 4XXXXX*5225 07 JAN XXXXXXXXXXXXXXXXXXX9255 Intuit,570.4,,4977557.96,AccountTransactionsReport(1).csv,1856,2025-01,False,Productivity Software,Productivity Software,Productivity Software
,2025-01-10,8400/000 : FNB,"25.00 NOTION LABS, 4XX*5225 08 JAN XX8930 25.00 NOTION LABS, 4XXXXX*5225 08 JAN XXXXXXXXXXXXXXXXXXX8",Account Payment,"25.00 NOTION LABS, 4XX*5225 08 JAN XX8930 25.00 NOTION LABS, 4XXXXX*5225 08 JAN XXXXXXXXXXXXXXXXXXX",477.93,,4978035.89,AccountTransactionsReport(1).csv,1857,2025-01,False,Other Computer Services,Collaboration Tools,Collaboration Tools
,2025-01-11,8400/000 : FNB,599.00 TRIPLE WHALE 4XX*5191 10 JAN XX9516 599.00 TRIPLE WHALE 4XXXXX*5191 10 JAN XXXXXXXXXXXXXXXXXX,Account Payment,599.00 TRIPLE WHALE 4XX*5191 10 JAN XX9516 599.00 TRIPLE WHALE 4XXXXX*5191 10 JAN XXXXXXXXXXXXXXXXX,11612.52,,4989648.41,AccountTransactionsReport(1).csv,1858,2025-01,False,Other Computer Services,Other Computer Services,Other Computer Services
,2025-01-11,8400/000 : FNB,499.00 CASSIDYAI.CO 4XX*5191 09 JAN XX4123 499.00 CASSIDYAI.CO 4XXXXX*5191 09 JAN XXXXXXXXXXXXXXXXXX,Account Payment,499.00 CASSIDYAI.CO 4XX*5191 09 JAN XX4123 499.00 CASSIDYAI.CO 4XXXXX*5191 09 JAN XXXXXXXXXXXXXXXXX,9662.32,,4999310.73,AccountTransactionsReport(1).csv,1859,2025-01,False,Other Computer Services,Other Computer Services,Other Computer Services
,2025-01-11,8400/000 : FNB,450.00 WAPPALYZER 4XX*5191 09 JAN XX8321 450.00 WAPPALYZER 4XXXXX*5191 09 JAN XXXXXXXXXXXXXXXXXXX832,Account Payment,450.00 WAPPALYZER 4XX*5191 09 JAN XX8321 450.00 WAPPALYZER 4XXXXX*5191 09 JAN XXXXXXXXXXXXXXXXXXX83,8713.51,,5008024.24,AccountTransactionsReport(1).csv,1860,2025-01,False,Other Computer Services,Other Computer Services,Other Computer Services
,2025-01-11,8400/000 : FNB,360.00 AICAMP INC. 4XX*5191 09 JAN XX1019 360.00 AICAMP INC. 4XXXXX*5191 09 JAN XXXXXXXXXXXXXXXXXXX1,Account Payment,360.00 AICAMP INC. 4XX*5191 09 JAN XX1019 360.00 AICAMP INC. 4XXXXX*5191 09 JAN XXXXXXXXXXXXXXXXXXX,6970.81,,5014995.05,AccountTransactionsReport(1).csv,1861,2025-01,False,Other Computer Services,Other Computer Services,Other Computer Services
,2025-01-11,8400/000 : FNB,99.00 DMNS.APP BUSI 4XX*5191 10 JAN XX9853 99.00 DMNS.APP BUSI 4XXXXX*5191 10 JAN XXXXXXXXXXXXXXXXXX,Account Payment,99.00 DMNS.APP BUSI 4XX*5191 10 JAN XX9853 99.00 DMNS.APP BUSI 4XXXXX*5191 10 JAN XXXXXXXXXXXXXXXXX,1919.26,,5016914.31,AccountTransactionsReport(1).csv,1862,2025-01,False,Other Computer Services,Other Computer Services,Other Computer Services
,2025-01-11,8400/000 : FNB,"70.00 NOTION LABS, 4XX*5191 10 JAN XX9410 70.00 NOTION LABS, 4XXXXX*5191 10 JAN XXXXXXXXXXXXXXXXXXX9",Account Payment,"70.00 NOTION LABS, 4XX*5191 10 JAN XX9410 70.00 NOTION LABS, 4XXXXX*5191 10 JAN XXXXXXXXXXXXXXXXXXX",1357.06,,5018271.37,AccountTransactionsReport(1).csv,1863,2025-01,False,Other Computer Services,Collaboration Tools,Collaboration Tools
,2025-01-11,8400/000 : FNB,67.85 LEMSQZY* CHAT 4XX*5191 10 JAN XX8779 67.85 LEMSQZY* CHAT 4XXXXX*5191 10 JAN XXXXXXXXXXXXXXXXXX,Account Payment,67.85 LEMSQZY* CHAT 4XX*5191 10 JAN XX8779 67.85 LEMSQZY* CHAT 4XXXXX*5191 10 JAN XXXXXXXXXXXXXXXXX,1315.37,,5019586.74,AccountTransactionsReport(1).csv,1864,2025-01,False,AI Services,AI Services,AI Services
,2025-01-11,8400/000 : FNB,60.00 INSOMNIA TEAM 4XX*5191 10 JAN XX2386 60.00 INSOMNIA TEAM 4XXXXX*5191 10 JAN XXXXXXXXXXXXXXXXXX,Account Payment,60.00 INSOMNIA TEAM 4XX*5191 10 JAN XX2386 60.00 INSOMNIA TEAM 4XXXXX*5191 10 JAN XXXXXXXXXXXXXXXXX,1163.19,,5020749.93,AccountTransactionsReport(1).csv,1865,2025-01,False,Other Computer Services,Other Computer Services,Other Computer Services
,2025-01-11,8400/000 : FNB,49.00 SKRAPP.IO STA 4XX*5191 09 JAN XX2907 49.00 SKRAPP.IO STA 4XXXXX*5191 09 JAN XXXXXXXXXXXXXXXXXX,Account Payment,49.00 SKRAPP.IO STA 4XX*5191 09 JAN XX2907 49.00 SKRAPP.IO STA 4XXXXX*5191 09 JAN XXXXXXXXXXXXXXXXX,948.8,,5021698.73,AccountTransactionsReport(1).csv,1866,2025-01,False,Other Computer Services,Other Computer Services,Other Computer Services
,2025-01-11,8400/000 : FNB,30.00 ISHRAQ LLC 4XX*5191 09 JAN XX0146 30.00 ISHRAQ LLC 4XXXXX*5191 09 JAN XXXXXXXXXXXXXXXXXXX0146,Account Payment,30.00 ISHRAQ LLC 4XX*5191 09 JAN XX0146 30.00 ISHRAQ LLC 4XXXXX*5191 09 JAN XXXXXXXXXXXXXXXXXXX0146,580.9,,5022279.63,AccountTransactionsReport(1).csv,1867,2025-01,False,Other Computer Services,Other Computer Services,Other Computer Services
,2025-01-11,8400/000 : FNB,25.00 BEECEPTOR 4XX*5191 09 JAN XX6787 25.00 BEECEPTOR 4XXXXX*5191 09 JAN XXXXXXXXXXXXXXXXXXX6787,Account Payment,25.00 BEECEPTOR 4XX*5191 09 JAN XX6787 25.00 BEECEPTOR 4XXXXX*5191 09 JAN XXXXXXXXXXXXXXXXXXX6787,484.08,,5022763.71,AccountTransactionsReport(1).csv,1868,2025-01,False,Other Computer Services,Other Computer Services,Other Computer Services
,2025-01-11,8400/000 : FNB,25.00 BEECEPTOR 4XX*5191 09 JAN XX6449 25.00 BEECEPTOR 4XXXXX*5191 09 JAN XXXXXXXXXXXXXXXXXXX6449,Account Payment,25.00 BEECEPTOR 4XX*5191 09 JAN XX6449 25.00 BEECEPTOR 4XXXXX*5191 09 JAN XXXXXXXXXXXXXXXXXXX6449,484.08,,5023247.79,AccountTransactionsReport(1).csv,1869,2025-01,False,Other Computer Services,Other Computer Services,Other Computer Services
,2025-01-11,8400/000 : FNB,20.00 VERCEL INC. 4XX*5191 09 JAN XX9174 20.00 VERCEL INC. 4XXXXX*5191 09 JAN XXXXXXXXXXXXXXXXXXX917,Account Payment,20.00 VERCEL INC. 4XX*5191 09 JAN XX9174 20.00 VERCEL INC. 4XXXXX*5191 09 JAN XXXXXXXXXXXXXXXXXXX91,387.26,,5023635.05,AccountTransactionsReport(1).csv,1870,2025-01,False,Cloud Services,Cloud Services,Cloud Services
,2025-01-11,8400/000 : FNB,Shopify 14.00 SHOPIFY* 3162 4XXXXX*5191 09 JAN XXXXXXXXXXXXXXXXXXX1601 Shopify,Account Payment,Shopify 14.00 SHOPIFY* 3162 4XXXXX*5191 09 JAN XXXXXXXXXXXXXXXXXXX1601 Shopify,271.41,,5023906.46,AccountTransactionsReport(1).csv,1871,2025-01,False,E-commerce Platforms,E-commerce Platforms,E-commerce Platforms
,2025-01-11,8400/000 : FNB,12.00 CODESANDBOX 4XX*5191 09 JAN XX6933 12.00 CODESANDBOX 4XXXXX*5191 09 JAN XXXXXXXXXXXXXXXXXXX693,Account Payment,12.00 CODESANDBOX 4XX*5191 09 JAN XX6933 12.00 CODESANDBOX 4XXXXX*5191 09 JAN XXXXXXXXXXXXXXXXXXX69,232.36,,5024138.82,AccountTransactionsReport(1).csv,1872,2025-01,False,Other Computer Services,Other Computer Services,Other Computer Services
,2025-01-11,8400/000 : FNB,Intuit 171.12 INTUIT *QBoo 4XXXXX*5225 09 JAN XXXXXXXXXXXXXXXXXXX4309 Intuit,Account Payment,Intuit 171.12 INTUIT *QBoo 4XXXXX*5225 09 JAN XXXXXXXXXXXXXXXXXXX4309 Intuit,171.12,,5024309.94,AccountTransactionsReport(1).csv,1873,2025-01,False,Productivity Software,Productivity Software,Productivity Software
,2025-01-11,8400/000 : FNB,7.00 CHATBASE 4XX*5191 10 JAN XX1119 7.00 CHATBASE 4XXXXX*5191 10 JAN XXXXXXXXXXXXXXXXXXX1119,Account Payment,7.00 CHATBASE 4XX*5191 10 JAN XX1119 7.00 CHATBASE 4XXXXX*5191 10 JAN XXXXXXXXXXXXXXXXXXX1119,135.7,,5024445.64,AccountTransactionsReport(1).csv,1874,2025-01,False,Other Computer Services,Other Computer Services,Other Computer Services
,2025-01-13,8400/000 : FNB,Shopify 3633.95 SHOPIFY* 31 4XXXXX*5225 10 JAN XXXXXXXXXXXXXXXXXXX3921 Shopify,Account Payment,Shopify 3633.95 SHOPIFY* 31 4XXXXX*5225 10 JAN XXXXXXXXXXXXXXXXXXX3921 Shopify,70449.62,,5094895.26,AccountTransactionsReport(1).csv,1875,2025-01,False,E-commerce Platforms,E-commerce Platforms,E-commerce Platforms
,2025-01-13,8400/000 : FNB,Paddle 171.35 PADDLE.NET* 4XXXXX*5191 11 JAN XXXXXXXXXXXXXXXXXXX9340 Paddle,Account Payment,Paddle 171.35 PADDLE.NET* 4XXXXX*5191 11 JAN XXXXXXXXXXXXXXXXXXX9340 Paddle,3360.28,,5098255.54,AccountTransactionsReport(1).csv,1876,2025-01,False,Other Computer Services,Subscription Management,Subscription Management
,2025-01-13,8400/000 : FNB,150.00 AUTH0.COM 4XX*5191 10 JAN XX8874 150.00 AUTH0.COM 4XXXXX*5191 10 JAN XXXXXXXXXXXXXXXXXXX8874,Account Payment,150.00 AUTH0.COM 4XX*5191 10 JAN XX8874 150.00 AUTH0.COM 4XXXXX*5191 10 JAN XXXXXXXXXXXXXXXXXXX8874,2907.98,,5101163.52,AccountTransactionsReport(1).csv,1877,2025-01,False,Security Services,Security Services,Security Services
,2025-01-13,8400/000 : FNB,134.00 SINCH MAILGU 4XX*5191 10 JAN XX1816 134.00 SINCH MAILGU 4XXXXX*5191 10 JAN XXXXXXXXXXXXXXXXXX,Account Payment,134.00 SINCH MAILGU 4XX*5191 10 JAN XX1816 134.00 SINCH MAILGU 4XXXXX*5191 10 JAN XXXXXXXXXXXXXXXXX,2597.8,,5103761.32,AccountTransactionsReport(1).csv,1878,2025-01,False,Other Computer Services,Other Computer Services,Other Computer Services
,2025-01-13,8400/000 : FNB,"99.00 PLAYFAB, INC. 4XX*5191 10 JAN XX5825 99.00 PLAYFAB, INC. 4XXXXX*5191 10 JAN XXXXXXXXXXXXXXXXXX",Account Payment,"99.00 PLAYFAB, INC. 4XX*5191 10 JAN XX5825 99.00 PLAYFAB, INC. 4XXXXX*5191 10 JAN XXXXXXXXXXXXXXXXX",1919.26,,5105680.58,AccountTransactionsReport(1).csv,1879,2025-01,False,Other Computer Services,Other Computer Services,Other Computer Services
,2025-01-13,8400/000 : FNB,Shopify 74.75 SHOPIFY* 3163 4XXXXX*5225 10 JAN XXXXXXXXXXXXXXXXXXX5196 Shopify,Account Payment,Shopify 74.75 SHOPIFY* 3163 4XXXXX*5225 10 JAN XXXXXXXXXXXXXXXXXXX5196 Shopify,1449.14,,5107129.72,AccountTransactionsReport(1).csv,1880,2025-01,False,E-commerce Platforms,E-commerce Platforms,E-commerce Platforms
,2025-01-13,8400/000 : FNB,69.00 OPENAI *CHATG 4XX*5191 10 JAN XX7581 69.00 OPENAI *CHATG 4XXXXX*5191 10 JAN XXXXXXXXXXXXXXXXXX,Account Payment,69.00 OPENAI *CHATG 4XX*5191 10 JAN XX7581 69.00 OPENAI *CHATG 4XXXXX*5191 10 JAN XXXXXXXXXXXXXXXXX,1337.67,,5108467.39,AccountTransactionsReport(1).csv,1881,2025-01,False,AI Services,AI Services,AI Services
,2025-01-13,8400/000 : FNB,51.52 FRAPPE CLOUD 4XX*5191 11 JAN XX1902 51.52 FRAPPE CLOUD 4XXXXX*5191 11 JAN XXXXXXXXXXXXXXXXXXX1,Account Payment,51.52 FRAPPE CLOUD 4XX*5191 11 JAN XX1902 51.52 FRAPPE CLOUD 4XXXXX*5191 11 JAN XXXXXXXXXXXXXXXXXXX,1010.34,,5109477.73,AccountTransactionsReport(1).csv,1882,2025-01,False,Other Computer Services,Other Computer Services,Other Computer Services
,2025-01-13,8400/000 : FNB,"40.00 REPLIT, INC. 4XX*5191 10 JAN XX0505 40.00 REPLIT, INC. 4XXXXX*5191 10 JAN XXXXXXXXXXXXXXXXXXX0",Account Payment,"40.00 REPLIT, INC. 4XX*5191 10 JAN XX0505 40.00 REPLIT, INC. 4XXXXX*5191 10 JAN XXXXXXXXXXXXXXXXXXX",775.47,,5110253.2,AccountTransactionsReport(1).csv,1883,2025-01,False,Other Computer Services,Other Computer Services,Other Computer Services
,2025-01-13,8400/000 : FNB,Facebook 454.43 FACEBK *Z29H 4XXXXX*5191 10 JAN XXXXXXXXXXXXXXXXXXX4040 Facebook,Account Payment,Facebook 454.43 FACEBK *Z29H 4XXXXX*5191 10 JAN XXXXXXXXXXXXXXXXXXX4040 Facebook,454.43,,5110707.63,AccountTransactionsReport(1).csv,1884,2025-01,False,Marketing Tools,Marketing Tools,Marketing Tools
,2025-01-13,8400/000 : FNB,21.56 SLACK T0740DV 4XX*5191 10 JAN XX4809 21.56 SLACK T0740DV 4XXXXX*5191 10 JAN XXXXXXXXXXXXXXXXXX,Account Payment,21.56 SLACK T0740DV 4XX*5191 10 JAN XX4809 21.56 SLACK T0740DV 4XXXXX*5191 10 JAN XXXXXXXXXXXXXXXXX,417.98,,5111125.61,AccountTransactionsReport(1).csv,1885,2025-01,False,Communication,Communication,Communication
,2025-01-13,8400/000 : FNB,Shopify 14.00 SHOPIFY* 3162 4XXXXX*5191 10 JAN XXXXXXXXXXXXXXXXXXX7296 Shopify,Account Payment,Shopify 14.00 SHOPIFY* 3162 4XXXXX*5191 10 JAN XXXXXXXXXXXXXXXXXXX7296 Shopify,271.41,,5111397.02,AccountTransactionsReport(1).csv,1886,2025-01,False,E-commerce Platforms,E-commerce Platforms,E-commerce Platforms
,2025-01-13,8400/000 : FNB,"7.00 NPM, INC. 4XX*5191 11 JAN XX3394 7.00 NPM, INC. 4XXXXX*5191 11 JAN XXXXXXXXXXXXXXXXXXX3394",Account Payment,"7.00 NPM, INC. 4XX*5191 11 JAN XX3394 7.00 NPM, INC. 4XXXXX*5191 11 JAN XXXXXXXXXXXXXXXXXXX3394",137.27,,5111534.29,AccountTransactionsReport(1).csv,1887,2025-01,False,Other Computer Services,Other Computer Services,Other Computer Services
,2025-01-13,8400/000 : FNB,"7.00 NPM, INC. 4XX*5191 11 JAN XX9150 7.00 NPM, INC. 4XXXXX*5191 11 JAN XXXXXXXXXXXXXXXXXXX9150",Account Payment,"7.00 NPM, INC. 4XX*5191 11 JAN XX9150 7.00 NPM, INC. 4XXXXX*5191 11 JAN XXXXXXXXXXXXXXXXXXX9150",137.27,,5111671.56,AccountTransactionsReport(1).csv,1888,2025-01,False,Other Computer Services,Other Computer Services,Other Computer Services
,2025-01-13,8400/000 : FNB,Google Store 34.99 Google One 4XXXXX*5191 10 JAN XXXXXXXXXXXXXXXXXXX8026 Google Store,Account Payment,Google Store 34.99 Google One 4XXXXX*5191 10 JAN XXXXXXXXXXXXXXXXXXX8026 Google Store,34.99,,5111706.55,AccountTransactionsReport(1).csv,1889,2025-01,False,Other Computer Services,Analytics & Monitoring,Analytics & Monitoring
,2025-01-14,8400/000 : FNB,"Github Inc. 210.00 GITHUB, INC. 4XXXXX*5225 11 JAN XXXXXXXXXXXXXXXXXXX8437 Github Inc.",Account Payment,"Github Inc. 210.00 GITHUB, INC. 4XXXXX*5225 11 JAN XXXXXXXXXXXXXXXXXXX8437 Github Inc.",4118.23,,5115824.78,AccountTransactionsReport(1).csv,1890,2025-01,False,Development Tools,Development Tools,Development Tools
,2025-01-14,8400/000 : FNB,150.00 OBSIDIAN.MD 4XX*5191 12 JAN XX1574 150.00 OBSIDIAN.MD 4XXXXX*5191 12 JAN XXXXXXXXXXXXXXXXXXX1,Account Payment,150.00 OBSIDIAN.MD 4XX*5191 12 JAN XX1574 150.00 OBSIDIAN.MD 4XXXXX*5191 12 JAN XXXXXXXXXXXXXXXXXXX,2941.59,,5118766.37,AccountTransactionsReport(1).csv,1891,2025-01,False,Other Computer Services,Other Computer Services,Other Computer Services
,2025-01-14,8400/000 : FNB,99.00 DYNAMIC.XYZ 4XX*5191 11 JAN XX8625 99.00 DYNAMIC.XYZ 4XXXXX*5191 11 JAN XXXXXXXXXXXXXXXXXXX862,Account Payment,99.00 DYNAMIC.XYZ 4XX*5191 11 JAN XX8625 99.00 DYNAMIC.XYZ 4XXXXX*5191 11 JAN XXXXXXXXXXXXXXXXXXX86,1941.45,,5120707.82,AccountTransactionsReport(1).csv,1892,2025-01,False,Other Computer Services,Other Computer Services,Other Computer Services
,2025-01-14,8400/000 : FNB,"Github Inc. 73.21 GITHUB, INC. 4XXXXX*5191 11 JAN XXXXXXXXXXXXXXXXXXX3835 Github Inc.",Account Payment,"Github Inc. 73.21 GITHUB, INC. 4XXXXX*5191 11 JAN XXXXXXXXXXXXXXXXXXX3835 Github Inc.",1435.69,,5122143.51,AccountTransactionsReport(1).csv,1893,2025-01,False,Development Tools,Development Tools,Development Tools
,2025-01-14,8400/000 : FNB,Digitalocean 47.84 DIGITALOCEAN. 4XXXXX*5191 11 JAN XXXXXXXXXXXXXXXXXXX6647 Digitalocean,Account Payment,Digitalocean 47.84 DIGITALOCEAN. 4XXXXX*5191 11 JAN XXXXXXXXXXXXXXXXXXX6647 Digitalocean,938.18,,5123081.69,AccountTransactionsReport(1).csv,1894,2025-01,False,Cloud Services,Cloud Services,Cloud Services
,2025-01-14,8400/000 : FNB,"Github Inc. 42.00 GITHUB, INC. 4XXXXX*5191 11 JAN XXXXXXXXXXXXXXXXXXX3141 Github Inc.",Account Payment,"Github Inc. 42.00 GITHUB, INC. 4XXXXX*5191 11 JAN XXXXXXXXXXXXXXXXXXX3141 Github Inc.",823.65,,5123905.34,AccountTransactionsReport(1).csv,1895,2025-01,False,Development Tools,Development Tools,Development Tools
,2025-01-14,8400/000 : FNB,32.00 BUBBLE STARTE 4XX*5191 11 JAN XX1988 32.00 BUBBLE STARTE 4XXXXX*5191 11 JAN XXXXXXXXXXXXXXXXXX,Account Payment,32.00 BUBBLE STARTE 4XX*5191 11 JAN XX1988 32.00 BUBBLE STARTE 4XXXXX*5191 11 JAN XXXXXXXXXXXXXXXXX,627.53,,5124532.87,AccountTransactionsReport(1).csv,1896,2025-01,False,Other Computer Services,Other Computer Services,Other Computer Services
,2025-01-14,8400/000 : FNB,Intuit 570.40 INTUIT *QBoo 4XXXXX*5225 11 JAN XXXXXXXXXXXXXXXXXXX5290 Intuit,Account Payment,Intuit 570.40 INTUIT *QBoo 4XXXXX*5225 11 JAN XXXXXXXXXXXXXXXXXXX5290 Intuit,570.4,,5125103.27,AccountTransactionsReport(1).csv,1897,2025-01,False,Productivity Software,Productivity Software,Productivity Software
,2025-01-14,8400/000 : FNB,Intuit 570.40 INTUIT *QBoo 4XXXXX*5225 11 JAN XXXXXXXXXXXXXXXXXXX5274 Intuit,Account Payment,Intuit 570.40 INTUIT *QBoo 4XXXXX*5225 11 JAN XXXXXXXXXXXXXXXXXXX5274 Intuit,570.4,,5125673.67,AccountTransactionsReport(1).csv,1898,2025-01,False,Productivity Software,Productivity Software,Productivity Software
,2025-01-14,8400/000 : FNB,Hightail 15.00 HIGHTAIL 4XXXXX*5191 12 JAN XXXXXXXXXXXXXXXXXXX4095 Hightail,Account Payment,Hightail 15.00 HIGHTAIL 4XXXXX*5191 12 JAN XXXXXXXXXXXXXXXXXXX4095 Hightail,294.16,,5125967.83,AccountTransactionsReport(1).csv,1899,2025-01,False,Other Computer Services,Other Computer Services,Other Computer Services
,2025-01-14,8400/000 : FNB,15.00 TABNINE 4XX*5191 12 JAN XX8584 15.00 TABNINE 4XXXXX*5191 12 JAN XXXXXXXXXXXXXXXXXXX8584,Account Payment,15.00 TABNINE 4XX*5191 12 JAN XX8584 15.00 TABNINE 4XXXXX*5191 12 JAN XXXXXXXXXXXXXXXXXXX8584,294.16,,5126261.99,AccountTransactionsReport(1).csv,1900,2025-01,False,Other Computer Services,Other Computer Services,Other Computer Services
,2025-01-14,8400/000 : FNB,15.00 CAL.COM 4XX*5191 12 JAN XX8996 15.00 CAL.COM 4XXXXX*5191 12 JAN XXXXXXXXXXXXXXXXXXX8996,Account Payment,15.00 CAL.COM 4XX*5191 12 JAN XX8996 15.00 CAL.COM 4XXXXX*5191 12 JAN XXXXXXXXXXXXXXXXXXX8996,294.16,,5126556.15,AccountTransactionsReport(1).csv,1901,2025-01,False,Other Computer Services,Other Computer Services,Other Computer Services
,2025-01-14,8400/000 : FNB,"7.00 NPM, INC. 4XX*5191 11 JAN XX0705 7.00 NPM, INC. 4XXXXX*5191 11 JAN XXXXXXXXXXXXXXXXXXX0705",Account Payment,"7.00 NPM, INC. 4XX*5191 11 JAN XX0705 7.00 NPM, INC. 4XXXXX*5191 11 JAN XXXXXXXXXXXXXXXXXXX0705",137.27,,5126693.42,AccountTransactionsReport(1).csv,1902,2025-01,False,Other Computer Services,Other Computer Services,Other Computer Services
,2025-01-14,8400/000 : FNB,"7.00 NPM, INC. 4XX*5191 11 JAN XX3961 7.00 NPM, INC. 4XXXXX*5191 11 JAN XXXXXXXXXXXXXXXXXXX3961",Account Payment,"7.00 NPM, INC. 4XX*5191 11 JAN XX3961 7.00 NPM, INC. 4XXXXX*5191 11 JAN XXXXXXXXXXXXXXXXXXX3961",137.27,,5126830.69,AccountTransactionsReport(1).csv,1903,2025-01,False,Other Computer Services,Other Computer Services,Other Computer Services
,2025-01-15,8400/000 : FNB,Google Service Charges/Fees #INT PYMT FEE-34.99 Googl Google,Account Payment,Google Service Charges/Fees INT PYMT FEE-34.99 Googl Google,0.7,,5126831.39,AccountTransactionsReport(1).csv,1904,2025-01,False,Other Computer Services,Analytics & Monitoring,Analytics & Monitoring
,2025-01-15,8400/000 : FNB,5.00 WWW.FLUX.AI 4XX*5191 13 JAN XX6926 5.00 WWW.FLUX.AI 4XXXXX*5191 13 JAN XXXXXXXXXXXXXXXXXXX6926,Account Payment,5.00 WWW.FLUX.AI 4XX*5191 13 JAN XX6926 5.00 WWW.FLUX.AI 4XXXXX*5191 13 JAN XXXXXXXXXXXXXXXXXXX6926,98.05,,5126929.44,AccountTransactionsReport(1).csv,1905,2025-01,False,Other Computer Services,Other Computer Services,Other Computer Services
,2025-01-15,8400/000 : FNB,11.49 GOOGLE *Colab 4XX*5191 14 JAN XX5895 11.49 GOOGLE *Colab 4XXXXX*5191 14 JAN XXXXXXXXXXXXXXXXXX,Account Payment,11.49 GOOGLE *Colab 4XX*5191 14 JAN XX5895 11.49 GOOGLE *Colab 4XXXXX*5191 14 JAN XXXXXXXXXXXXXXXXX,225.57,,5127155.01,AccountTransactionsReport(1).csv,1906,2025-01,False,Other Computer Services,Analytics & Monitoring,Analytics & Monitoring
,2025-01-15,8400/000 : FNB,10.00 SUNO INC. 4XX*5191 13 JAN XX4546 10.00 SUNO INC. 4XXXXX*5191 13 JAN XXXXXXXXXXXXXXXXXXX4546,Account Payment,10.00 SUNO INC. 4XX*5191 13 JAN XX4546 10.00 SUNO INC. 4XXXXX*5191 13 JAN XXXXXXXXXXXXXXXXXXX4546,196.11,,5127351.12,AccountTransactionsReport(1).csv,1907,2025-01,False,Other Computer Services,Other Computer Services,Other Computer Services
,2025-01-15,8400/000 : FNB,Facebook Service Charges/Fees #INT PYMT FEE-135.79 FACE Facebook,Account Payment,Facebook Service Charges/Fees INT PYMT FEE-135.79 FACE Facebook,2.72,,5127353.84,AccountTransactionsReport(1).csv,1908,2025-01,False,Marketing Tools,Marketing Tools,Marketing Tools
,2025-01-15,8400/000 : FNB,Stable 249.00 STABLE 4XXXXX*5191 14 JAN XXXXXXXXXXXXXXXXXXX5677 Stable,Account Payment,Stable 249.00 STABLE 4XXXXX*5191 14 JAN XXXXXXXXXXXXXXXXXXX5677 Stable,4888.47,,5132242.31,AccountTransactionsReport(1).csv,1909,2025-01,False,Other Computer Services,Other Computer Services,Other Computer Services
,2025-01-15,8400/000 : FNB,180.00 AGENCYANALYT 4XX*5225 13 JAN XX1427 180.00 AGENCYANALYT 4XXXXX*5225 13 JAN XXXXXXXXXXXXXXXXXX,Account Payment,180.00 AGENCYANALYT 4XX*5225 13 JAN XX1427 180.00 AGENCYANALYT 4XXXXX*5225 13 JAN XXXXXXXXXXXXXXXXX,3529.9,,5135772.21,AccountTransactionsReport(1).csv,1910,2025-01,False,Other Computer Services,Other Computer Services,Other Computer Services
,2025-01-15,8400/000 : FNB,55.26 PADDLE.NET* W 4XX*5191 14 JAN XX6016 55.26 PADDLE.NET* W 4XXXXX*5191 14 JAN XXXXXXXXXXXXXXXXXX,Account Payment,55.26 PADDLE.NET* W 4XX*5191 14 JAN XX6016 55.26 PADDLE.NET* W 4XXXXX*5191 14 JAN XXXXXXXXXXXXXXXXX,1084.88,,5136857.09,AccountTransactionsReport(1).csv,1911,2025-01,False,Other Computer Services,Subscription Management,Subscription Management
,2025-01-15,8400/000 : FNB,20.00 HUGGINGFACE 4XX*5191 14 JAN XX3083 20.00 HUGGINGFACE 4XXXXX*5191 14 JAN XXXXXXXXXXXXXXXXXXX308,Account Payment,20.00 HUGGINGFACE 4XX*5191 14 JAN XX3083 20.00 HUGGINGFACE 4XXXXX*5191 14 JAN XXXXXXXXXXXXXXXXXXX30,392.65,,5137249.74,AccountTransactionsReport(1).csv,1912,2025-01,False,AI Services,AI Services,AI Services
,2025-01-15,8400/000 : FNB,20.00 RAILWAY 4XX*5191 13 JAN XX6739 20.00 RAILWAY 4XXXXX*5191 13 JAN XXXXXXXXXXXXXXXXXXX6739,Account Payment,20.00 RAILWAY 4XX*5191 13 JAN XX6739 20.00 RAILWAY 4XXXXX*5191 13 JAN XXXXXXXXXXXXXXXXXXX6739,392.21,,5137641.95,AccountTransactionsReport(1).csv,1913,2025-01,False,Other Computer Services,Other Computer Services,Other Computer Services
,2025-01-15,8400/000 : FNB,20.00 HEROKU* DEC-1 4XX*5191 13 JAN XX3657 20.00 HEROKU* DEC-1 4XXXXX*5191 13 JAN XXXXXXXXXXXXXXXXXX,Account Payment,20.00 HEROKU* DEC-1 4XX*5191 13 JAN XX3657 20.00 HEROKU* DEC-1 4XXXXX*5191 13 JAN XXXXXXXXXXXXXXXXX,392.21,,5138034.16,AccountTransactionsReport(1).csv,1914,2025-01,False,Cloud Services,Cloud Services,Cloud Services
,2025-01-15,8400/000 : FNB,20.00 RAILWAY 4XX*5191 13 JAN XX7730 20.00 RAILWAY 4XXXXX*5191 13 JAN XXXXXXXXXXXXXXXXXXX7730,Account Payment,20.00 RAILWAY 4XX*5191 13 JAN XX7730 20.00 RAILWAY 4XXXXX*5191 13 JAN XXXXXXXXXXXXXXXXXXX7730,392.21,,5138426.37,AccountTransactionsReport(1).csv,1915,2025-01,False,Other Computer Services,Other Computer Services,Other Computer Services
,2025-01-16,8400/000 : FNB,"40.00 REPLIT, INC. 4XX*5191 14 JAN XX2108 40.00 REPLIT, INC. 4XXXXX*5191 14 JAN XXXXXXXXXXXXXXXXXXX2",Account Payment,"40.00 REPLIT, INC. 4XX*5191 14 JAN XX2108 40.00 REPLIT, INC. 4XXXXX*5191 14 JAN XXXXXXXXXXXXXXXXXXX",785.3,,5139211.67,AccountTransactionsReport(1).csv,1916,2025-01,False,Other Computer Services,Other Computer Services,Other Computer Services
,2025-01-16,8400/000 : FNB,129.00 LOOKA LOGO M 4XX*5191 14 JAN XX5195 129.00 LOOKA LOGO M 4XXXXX*5191 14 JAN XXXXXXXXXXXXXXXXXX,Account Payment,129.00 LOOKA LOGO M 4XX*5191 14 JAN XX5195 129.00 LOOKA LOGO M 4XXXXX*5191 14 JAN XXXXXXXXXXXXXXXXX,2532.58,,5141744.25,AccountTransactionsReport(1).csv,1917,2025-01,False,Other Computer Services,Other Computer Services,Other Computer Services
,2025-01-16,8400/000 : FNB,129.00 LOOKA LOGO M 4XX*5191 14 JAN XX1343 129.00 LOOKA LOGO M 4XXXXX*5191 14 JAN XXXXXXXXXXXXXXXXXX,Account Payment,129.00 LOOKA LOGO M 4XX*5191 14 JAN XX1343 129.00 LOOKA LOGO M 4XXXXX*5191 14 JAN XXXXXXXXXXXXXXXXX,2532.58,,5144276.83,AccountTransactionsReport(1).csv,1918,2025-01,False,Other Computer Services,Other Computer Services,Other Computer Services
,2025-01-16,8400/000 : FNB,129.00 LOOKA LOGO M 4XX*5191 14 JAN XX1892 129.00 LOOKA LOGO M 4XXXXX*5191 14 JAN XXXXXXXXXXXXXXXXXX,Account Payment,129.00 LOOKA LOGO M 4XX*5191 14 JAN XX1892 129.00 LOOKA LOGO M 4XXXXX*5191 14 JAN XXXXXXXXXXXXXXXXX,2532.58,,5146809.41,AccountTransactionsReport(1).csv,1919,2025-01,False,Other Computer Services,Other Computer Services,Other Computer Services
,2025-01-16,8400/000 : FNB,172.50 OPENAI *CHAT 4XX*5191 14 JAN XX7250 172.50 OPENAI *CHAT 4XXXXX*5191 14 JAN XXXXXXXXXXXXXXXXXX,Account Payment,172.50 OPENAI *CHAT 4XX*5191 14 JAN XX7250 172.50 OPENAI *CHAT 4XXXXX*5191 14 JAN XXXXXXXXXXXXXXXXX,3386.59,,5150196.0,AccountTransactionsReport(1).csv,1920,2025-01,False,AI Services,AI Services,AI Services
,2025-01-16,8400/000 : FNB,280.00 WIZA.CO 4XX*5191 14 JAN XX8582 280.00 WIZA.CO 4XXXXX*5191 14 JAN XXXXXXXXXXXXXXXXXXX8582,Account Payment,280.00 WIZA.CO 4XX*5191 14 JAN XX8582 280.00 WIZA.CO 4XXXXX*5191 14 JAN XXXXXXXXXXXXXXXXXXX8582,5497.08,,5155693.08,AccountTransactionsReport(1).csv,1921,2025-01,False,Other Computer Services,Other Computer Services,Other Computer Services
,2025-01-16,8400/000 : FNB,"Github Inc. 14.00 GITHUB, INC. 4XXXXX*5225 14 JAN XXXXXXXXXXXXXXXXXXX0480 Github Inc.",Account Payment,"Github Inc. 14.00 GITHUB, INC. 4XXXXX*5225 14 JAN XXXXXXXXXXXXXXXXXXX0480 Github Inc.",274.85,,5155967.93,AccountTransactionsReport(1).csv,1922,2025-01,False,Development Tools,Development Tools,Development Tools
,2025-01-16,8400/000 : FNB,21.27 RAILWAY 4XX*5191 14 JAN XX5184 21.27 RAILWAY 4XXXXX*5191 14 JAN XXXXXXXXXXXXXXXXXXX5184,Account Payment,21.27 RAILWAY 4XX*5191 14 JAN XX5184 21.27 RAILWAY 4XXXXX*5191 14 JAN XXXXXXXXXXXXXXXXXXX5184,417.58,,5156385.51,AccountTransactionsReport(1).csv,1923,2025-01,False,Other Computer Services,Other Computer Services,Other Computer Services
,2025-01-16,8400/000 : FNB,Intuit 570.40 INTUIT *QBoo 4XXXXX*5225 14 JAN XXXXXXXXXXXXXXXXXXX4326 Intuit,Account Payment,Intuit 570.40 INTUIT *QBoo 4XXXXX*5225 14 JAN XXXXXXXXXXXXXXXXXXX4326 Intuit,570.4,,5156955.91,AccountTransactionsReport(1).csv,1924,2025-01,False,Productivity Software,Productivity Software,Productivity Software
,2025-01-17,8400/000 : FNB,350.00 FRAMER.COM 4XX*5191 16 JAN XX1183 350.00 FRAMER.COM 4XXXXX*5191 16 JAN XXXXXXXXXXXXXXXXXXX118,Account Payment,350.00 FRAMER.COM 4XX*5191 16 JAN XX1183 350.00 FRAMER.COM 4XXXXX*5191 16 JAN XXXXXXXXXXXXXXXXXXX11,350.0,,5157305.91,AccountTransactionsReport(1).csv,1925,2025-01,False,Other Computer Services,Design Tools,Design Tools
,2025-01-17,8400/000 : FNB,"Github Inc. 91.00 GITHUB, INC. 4XXXXX*5191 15 JAN XXXXXXXXXXXXXXXXXXX9572 Github Inc.",Account Payment,"Github Inc. 91.00 GITHUB, INC. 4XXXXX*5191 15 JAN XXXXXXXXXXXXXXXXXXX9572 Github Inc.",1770.67,,5159076.58,AccountTransactionsReport(1).csv,1926,2025-01,False,Development Tools,Development Tools,Development Tools
,2025-01-17,8400/000 : FNB,174.00 INTERCOM R&D 4XX*5191 15 JAN XX7383 174.00 INTERCOM R&D 4XXXXX*5191 15 JAN XXXXXXXXXXXXXXXXXX,Account Payment,174.00 INTERCOM R&D 4XX*5191 15 JAN XX7383 174.00 INTERCOM R&D 4XXXXX*5191 15 JAN XXXXXXXXXXXXXXXXX,3366.86,,5162443.44,AccountTransactionsReport(1).csv,1927,2025-01,False,Other Computer Services,Customer Support,Customer Support
,2025-01-17,8400/000 : FNB,184.74 SLACK T0MN3D 4XX*5225 15 JAN XX7254 184.74 SLACK T0MN3D 4XXXXX*5225 15 JAN XXXXXXXXXXXXXXXXXX,Account Payment,184.74 SLACK T0MN3D 4XX*5225 15 JAN XX7254 184.74 SLACK T0MN3D 4XXXXX*5225 15 JAN XXXXXXXXXXXXXXXXX,3594.65,,5166038.09,AccountTransactionsReport(1).csv,1928,2025-01,False,Communication,Communication,Communication
,2025-01-17,8400/000 : FNB,231.95 HOLASPIRIT 4XX*5225 15 JAN XX0811 231.95 HOLASPIRIT 4XXXXX*5225 15 JAN XXXXXXXXXXXXXXXXXXX081,Account Payment,231.95 HOLASPIRIT 4XX*5225 15 JAN XX0811 231.95 HOLASPIRIT 4XXXXX*5225 15 JAN XXXXXXXXXXXXXXXXXXX08,4642.84,,5170680.93,AccountTransactionsReport(1).csv,1929,2025-01,False,Other Computer Services,Other Computer Services,Other Computer Services
,2025-01-17,8400/000 : FNB,376.40 HOLASPIRIT 4XX*5225 15 JAN XX8954 376.40 HOLASPIRIT 4XXXXX*5225 15 JAN XXXXXXXXXXXXXXXXXXX895,Account Payment,376.40 HOLASPIRIT 4XX*5225 15 JAN XX8954 376.40 HOLASPIRIT 4XXXXX*5225 15 JAN XXXXXXXXXXXXXXXXXXX89,7534.22,,5178215.15,AccountTransactionsReport(1).csv,1930,2025-01,False,Other Computer Services,Other Computer Services,Other Computer Services
,2025-01-18,8400/000 : FNB,20.00 VERCEL INC. 4XX*5191 16 JAN XX8922 20.00 VERCEL INC. 4XXXXX*5191 16 JAN XXXXXXXXXXXXXXXXXXX892,Account Payment,20.00 VERCEL INC. 4XX*5191 16 JAN XX8922 20.00 VERCEL INC. 4XXXXX*5191 16 JAN XXXXXXXXXXXXXXXXXXX89,387.0,,5178602.15,AccountTransactionsReport(1).csv,1931,2025-01,False,Cloud Services,Cloud Services,Cloud Services
,2025-01-21,8400/000 : FNB,Facebook Service Charges/Fees #INT PYMT FEE-454.43 FACE Facebook,Account Payment,Facebook Service Charges/Fees INT PYMT FEE-454.43 FACE Facebook,9.09,,5178611.24,AccountTransactionsReport(1).csv,1932,2025-01,False,Marketing Tools,Marketing Tools,Marketing Tools
,2025-01-21,8400/000 : FNB,Google Service Charges/Fees #INT PYMT FEE-34.99 Googl Google,Account Payment,Google Service Charges/Fees INT PYMT FEE-34.99 Googl Google,0.7,,5178611.94,AccountTransactionsReport(1).csv,1933,2025-01,False,Other Computer Services,Analytics & Monitoring,Analytics & Monitoring
,2025-01-21,8400/000 : FNB,299.00 MANGOAPPS 4XX*5191 19 JAN XX4836 299.00 MANGOAPPS 4XXXXX*5191 19 JAN XXXXXXXXXXXXXXXXXXX4836,Account Payment,299.00 MANGOAPPS 4XX*5191 19 JAN XX4836 299.00 MANGOAPPS 4XXXXX*5191 19 JAN XXXXXXXXXXXXXXXXXXX4836,5749.18,,5184361.12,AccountTransactionsReport(1).csv,1934,2025-01,False,Other Computer Services,Other Computer Services,Other Computer Services
,2025-01-21,8400/000 : FNB,59.00 GREENBACK.COM 4XX*5225 19 JAN XX8371 59.00 GREENBACK.COM 4XXXXX*5225 19 JAN XXXXXXXXXXXXXXXXXX,Account Payment,59.00 GREENBACK.COM 4XX*5225 19 JAN XX8371 59.00 GREENBACK.COM 4XXXXX*5225 19 JAN XXXXXXXXXXXXXXXXX,1134.45,,5185495.57,AccountTransactionsReport(1).csv,1935,2025-01,False,Other Computer Services,Other Computer Services,Other Computer Services
,2025-01-22,8400/000 : FNB,54.00 AIRTABLE.COM/ 4XX*5191 21 JAN XX1019 54.00 AIRTABLE.COM/ 4XXXXX*5191 21 JAN XXXXXXXXXXXXXXXXXX,Account Payment,54.00 AIRTABLE.COM/ 4XX*5191 21 JAN XX1019 54.00 AIRTABLE.COM/ 4XXXXX*5191 21 JAN XXXXXXXXXXXXXXXXX,1035.2,,5186530.77,AccountTransactionsReport(1).csv,1936,2025-01,False,Other Computer Services,Collaboration Tools,Collaboration Tools
,2025-01-22,8400/000 : FNB,"74.00 PIPEDREAM, IN 4XX*5191 20 JAN XX3588 74.00 PIPEDREAM, IN 4XXXXX*5191 20 JAN XXXXXXXXXXXXXXXXXX",Account Payment,"74.00 PIPEDREAM, IN 4XX*5191 20 JAN XX3588 74.00 PIPEDREAM, IN 4XXXXX*5191 20 JAN XXXXXXXXXXXXXXXXX",1422.87,,5187953.64,AccountTransactionsReport(1).csv,1937,2025-01,False,Other Computer Services,Other Computer Services,Other Computer Services
,2025-01-24,8400/000 : FNB,299.00 ORG CHART 4XX*5191 22 JAN XX2214 299.00 ORG CHART 4XXXXX*5191 22 JAN XXXXXXXXXXXXXXXXXXX2214,Account Payment,299.00 ORG CHART 4XX*5191 22 JAN XX2214 299.00 ORG CHART 4XXXXX*5191 22 JAN XXXXXXXXXXXXXXXXXXX2214,5706.45,,5193660.09,AccountTransactionsReport(1).csv,1938,2025-01,False,Other Computer Services,Other Computer Services,Other Computer Services
,2025-01-25,8400/000 : FNB,68.86 DNH*DOMAINS#3 4XX*5225 23 JAN XX2974 68.86 DNH*DOMAINS#3 4XXXXX*5225 23 JAN XXXXXXXXXXXXXXXXXX,Account Payment,68.86 DNH*DOMAINS3 4XX*5225 23 JAN XX2974 68.86 DNH*DOMAINS3 4XXXXX*5225 23 JAN XXXXXXXXXXXXXXXXX,1305.89,,5194965.98,AccountTransactionsReport(1).csv,1939,2025-01,False,Domain & Hosting,Domain & Hosting,Domain & Hosting
,2025-01-25,8400/000 : FNB,89.00 SENTRY 4XX*5191 24 JAN XX2168 89.00 SENTRY 4XXXXX*5191 24 JAN XXXXXXXXXXXXXXXXXXX2168,Account Payment,89.00 SENTRY 4XX*5191 24 JAN XX2168 89.00 SENTRY 4XXXXX*5191 24 JAN XXXXXXXXXXXXXXXXXXX2168,1690.38,,5196656.36,AccountTransactionsReport(1).csv,1940,2025-01,False,Other Computer Services,Analytics & Monitoring,Analytics & Monitoring
,2025-01-25,8400/000 : FNB,"6.00 DOCKER, INC. 4XX*5191 24 JAN XX1905 6.00 DOCKER, INC. 4XXXXX*5191 24 JAN XXXXXXXXXXXXXXXXXXX190",Account Payment,"6.00 DOCKER, INC. 4XX*5191 24 JAN XX1905 6.00 DOCKER, INC. 4XXXXX*5191 24 JAN XXXXXXXXXXXXXXXXXXX19",113.95,,5196770.31,AccountTransactionsReport(1).csv,1941,2025-01,False,Other Computer Services,Other Computer Services,Other Computer Services
,2025-01-25,8400/000 : FNB,30.00 HASURA 4XX*5191 23 JAN XX3187 30.00 HASURA 4XXXXX*5191 23 JAN XXXXXXXXXXXXXXXXXXX3187,Account Payment,30.00 HASURA 4XX*5191 23 JAN XX3187 30.00 HASURA 4XXXXX*5191 23 JAN XXXXXXXXXXXXXXXXXXX3187,569.79,,5197340.1,AccountTransactionsReport(1).csv,1942,2025-01,False,Other Computer Services,Other Computer Services,Other Computer Services
,2025-01-27,8400/000 : FNB,2123.25 DNH*DOMAINS 4XX*5225 24 JAN XX6140 2123.25 DNH*DOMAINS 4XXXXX*5225 24 JAN XXXXXXXXXXXXXXXXXX,Account Payment,2123.25 DNH*DOMAINS 4XX*5225 24 JAN XX6140 2123.25 DNH*DOMAINS 4XXXXX*5225 24 JAN XXXXXXXXXXXXXXXXX,40327.11,,5237667.21,AccountTransactionsReport(1).csv,1943,2025-01,False,Domain & Hosting,Domain & Hosting,Domain & Hosting
,2025-01-28,8400/000 : FNB,50.00 OBSIDIAN.MD 4XX*5191 26 JAN XX8435 50.00 OBSIDIAN.MD 4XXXXX*5191 26 JAN XXXXXXXXXXXXXXXXXXX843,Account Payment,50.00 OBSIDIAN.MD 4XX*5191 26 JAN XX8435 50.00 OBSIDIAN.MD 4XXXXX*5191 26 JAN XXXXXXXXXXXXXXXXXXX84,945.99,,5238613.2,AccountTransactionsReport(1).csv,1944,2025-01,False,Other Computer Services,Other Computer Services,Other Computer Services
,2025-01-29,8400/000 : FNB,Intuit 546.25 INTUIT *QBoo 4XXXXX*5225 27 JAN XXXXXXXXXXXXXXXXXXX0371 Intuit,Account Payment,Intuit 546.25 INTUIT *QBoo 4XXXXX*5225 27 JAN XXXXXXXXXXXXXXXXXXX0371 Intuit,546.25,,5239159.45,AccountTransactionsReport(1).csv,1945,2025-01,False,Productivity Software,Productivity Software,Productivity Software
,2025-01-29,8400/000 : FNB,Intuit 570.40 INTUIT *QBoo 4XXXXX*5225 27 JAN XXXXXXXXXXXXXXXXXXX7314 Intuit,Account Payment,Intuit 570.40 INTUIT *QBoo 4XXXXX*5225 27 JAN XXXXXXXXXXXXXXXXXXX7314 Intuit,570.4,,5239729.85,AccountTransactionsReport(1).csv,1946,2025-01,False,Productivity Software,Productivity Software,Productivity Software
,2025-01-29,8400/000 : FNB,Intuit 570.40 INTUIT *QBoo 4XXXXX*5225 27 JAN XXXXXXXXXXXXXXXXXXX9531 Intuit,Account Payment,Intuit 570.40 INTUIT *QBoo 4XXXXX*5225 27 JAN XXXXXXXXXXXXXXXXXXX9531 Intuit,570.4,,5240300.25,AccountTransactionsReport(1).csv,1947,2025-01,False,Productivity Software,Productivity Software,Productivity Software
,2025-01-29,8400/000 : FNB,150.00 AUTH0.COM 4XX*5191 27 JAN XX9811 150.00 AUTH0.COM 4XXXXX*5191 27 JAN XXXXXXXXXXXXXXXXXXX9811,Account Payment,150.00 AUTH0.COM 4XX*5191 27 JAN XX9811 150.00 AUTH0.COM 4XXXXX*5191 27 JAN XXXXXXXXXXXXXXXXXXX9811,2837.97,,5243138.22,AccountTransactionsReport(1).csv,1948,2025-01,False,Security Services,Security Services,Security Services
,2025-01-29,8400/000 : FNB,399.99 POE.COM 4XX*5191 28 JAN XX4490 399.99 POE.COM 4XXXXX*5191 28 JAN XXXXXXXXXXXXXXXXXXX4490,Account Payment,399.99 POE.COM 4XX*5191 28 JAN XX4490 399.99 POE.COM 4XXXXX*5191 28 JAN XXXXXXXXXXXXXXXXXXX4490,399.99,,5243538.21,AccountTransactionsReport(1).csv,1949,2025-01,False,Other Computer Services,Other Computer Services,Other Computer Services
,2025-01-29,8400/000 : FNB,1150.00 AUTH0.COM 4XX*5191 28 JAN XX8132 1150.00 AUTH0.COM 4XXXXX*5191 28 JAN XXXXXXXXXXXXXXXXXXX813,Account Payment,1150.00 AUTH0.COM 4XX*5191 28 JAN XX8132 1150.00 AUTH0.COM 4XXXXX*5191 28 JAN XXXXXXXXXXXXXXXXXXX81,22041.83,,5265580.04,AccountTransactionsReport(1).csv,1950,2025-01,False,Security Services,Security Services,Security Services
,2025-01-30,8400/000 : FNB,9.00 GITPOD.IO 4XX*5191 28 JAN XX4157 9.00 GITPOD.IO 4XXXXX*5191 28 JAN XXXXXXXXXXXXXXXXXXX4157,Account Payment,9.00 GITPOD.IO 4XX*5191 28 JAN XX4157 9.00 GITPOD.IO 4XXXXX*5191 28 JAN XXXXXXXXXXXXXXXXXXX4157,172.5,,5265752.54,AccountTransactionsReport(1).csv,1951,2025-01,False,Development Tools,Development Tools,Development Tools
,2025-01-30,8400/000 : FNB,Dropbox 18.38 Dropbox 3HX6D 4XXXXX*5191 28 JAN XXXXXXXXXXXXXXXXXXX7033 Dropbox,Account Payment,Dropbox 18.38 Dropbox 3HX6D 4XXXXX*5191 28 JAN XXXXXXXXXXXXXXXXXXX7033 Dropbox,352.29,,5266104.83,AccountTransactionsReport(1).csv,1952,2025-01,False,Other Computer Services,Other Computer Services,Other Computer Services
,2025-01-30,8400/000 : FNB,430.00 Dlocal *Micr 4XX*5191 28 JAN XX0426 430.00 Dlocal *Micr 4XXXXX*5191 28 JAN XXXXXXXXXXXXXXXXXX,Account Payment,430.00 Dlocal *Micr 4XX*5191 28 JAN XX0426 430.00 Dlocal *Micr 4XXXXX*5191 28 JAN XXXXXXXXXXXXXXXXX,430.0,,5266534.83,AccountTransactionsReport(1).csv,1953,2025-01,False,Other Computer Services,Other Computer Services,Other Computer Services
,2025-01-30,8400/000 : FNB,29.99 BEENVERIFIED 4XX*5191 28 JAN XX2780 29.99 BEENVERIFIED 4XXXXX*5191 28 JAN XXXXXXXXXXXXXXXXXXX2,Account Payment,29.99 BEENVERIFIED 4XX*5191 28 JAN XX2780 29.99 BEENVERIFIED 4XXXXX*5191 28 JAN XXXXXXXXXXXXXXXXXXX,574.81,,5267109.64,AccountTransactionsReport(1).csv,1954,2025-01,False,Other Computer Services,Other Computer Services,Other Computer Services
,2025-01-31,8400/000 : FNB,5050.80 FRESHWORKS 4XX*5225 29 JAN XX7937 5050.80 FRESHWORKS 4XXXXX*5225 29 JAN XXXXXXXXXXXXXXXXXXX7,Account Payment,5050.80 FRESHWORKS 4XX*5225 29 JAN XX7937 5050.80 FRESHWORKS 4XXXXX*5225 29 JAN XXXXXXXXXXXXXXXXXXX,5050.8,,5272160.44,AccountTransactionsReport(1).csv,1955,2025-01,False,Productivity Software,Productivity Software,Productivity Software
,2025-01-31,8400/000 : FNB,Shopify 3421.17 SHOPIFY* 32 4XXXXX*5191 29 JAN XXXXXXXXXXXXXXXXXXX2220 Shopify,Account Payment,Shopify 3421.17 SHOPIFY* 32 4XXXXX*5191 29 JAN XXXXXXXXXXXXXXXXXXX2220 Shopify,65898.08,,5338058.52,AccountTransactionsReport(1).csv,1956,2025-01,False,E-commerce Platforms,E-commerce Platforms,E-commerce Platforms
,2025-01-31,8400/000 : FNB,5.00 COMPONENTS.STU 4XX*5191 29 JAN XX7967 5.00 COMPONENTS.STU 4XXXXX*5191 29 JAN XXXXXXXXXXXXXXXXXX,Account Payment,5.00 COMPONENTS.STU 4XX*5191 29 JAN XX7967 5.00 COMPONENTS.STU 4XXXXX*5191 29 JAN XXXXXXXXXXXXXXXXX,96.31,,5338154.83,AccountTransactionsReport(1).csv,1957,2025-01,False,Other Computer Services,Other Computer Services,Other Computer Services
,2025-01-31,8400/000 : FNB,50.00 ANACONDA INC. 4XX*5191 29 JAN XX7485 50.00 ANACONDA INC. 4XXXXX*5191 29 JAN XXXXXXXXXXXXXXXXXX,Account Payment,50.00 ANACONDA INC. 4XX*5191 29 JAN XX7485 50.00 ANACONDA INC. 4XXXXX*5191 29 JAN XXXXXXXXXXXXXXXXX,963.09,,5339117.92,AccountTransactionsReport(1).csv,1958,2025-01,False,Other Computer Services,Other Computer Services,Other Computer Services
,2025-01-31,8400/000 : FNB,Facebook 1129.79 FACEBK *ZAS 4XXXXX*5191 30 JAN XXXXXXXXXXXXXXXXXXX6939 Facebook,Account Payment,Facebook 1129.79 FACEBK *ZAS 4XXXXX*5191 30 JAN XXXXXXXXXXXXXXXXXXX6939 Facebook,1129.79,,5340247.71,AccountTransactionsReport(1).csv,1959,2025-01,False,Marketing Tools,Marketing Tools,Marketing Tools
,2025-01-31,8400/000 : FNB,67.85 LEMSQZY* CHAT 4XX*5191 30 JAN XX9580 67.85 LEMSQZY* CHAT 4XXXXX*5191 30 JAN XXXXXXXXXXXXXXXXXX,Account Payment,67.85 LEMSQZY* CHAT 4XX*5191 30 JAN XX9580 67.85 LEMSQZY* CHAT 4XXXXX*5191 30 JAN XXXXXXXXXXXXXXXXX,1298.39,,5341546.1,AccountTransactionsReport(1).csv,1960,2025-01,False,AI Services,AI Services,AI Services
,2025-02-01,8400/000 : FNB,Dropbox 18.38 Dropbox 3HX6D 4XXXXX*5191 28 JAN XXXXXXXXXXXXXXXXXXX6035 Dropbox,Account Receipt,Dropbox 18.38 Dropbox 3HX6D 4XXXXX*5191 28 JAN XXXXXXXXXXXXXXXXXXX6035 Dropbox,,333.13,5341212.97,AccountTransactionsReport(1).csv,1961,2025-02,False,Other Computer Services,Other Computer Services,Other Computer Services
,2025-02-01,8400/000 : FNB,20.00 HUGGINGFACE 4XX*5191 31 JAN XX2178 20.00 HUGGINGFACE 4XXXXX*5191 31 JAN XXXXXXXXXXXXXXXXXXX217,Account Payment,20.00 HUGGINGFACE 4XX*5191 31 JAN XX2178 20.00 HUGGINGFACE 4XXXXX*5191 31 JAN XXXXXXXXXXXXXXXXXXX21,379.91,,5341592.88,AccountTransactionsReport(1).csv,1962,2025-02,False,AI Services,AI Services,AI Services
,2025-02-01,8400/000 : FNB,100.00 REG AGENT ST 4XX*5191 31 JAN XX4014 100.00 REG AGENT ST 4XXXXX*5191 31 JAN XXXXXXXXXXXXXXXXXX,Account Payment,100.00 REG AGENT ST 4XX*5191 31 JAN XX4014 100.00 REG AGENT ST 4XXXXX*5191 31 JAN XXXXXXXXXXXXXXXXX,1899.53,,5343492.41,AccountTransactionsReport(1).csv,1963,2025-02,False,Other Computer Services,Other Computer Services,Other Computer Services
,2025-02-03,8400/000 : FNB,10.00 MATTERMOST 4XX*5191 31 JAN XX2313 10.00 MATTERMOST 4XXXXX*5191 31 JAN XXXXXXXXXXXXXXXXXXX2313,Account Payment,10.00 MATTERMOST 4XX*5191 31 JAN XX2313 10.00 MATTERMOST 4XXXXX*5191 31 JAN XXXXXXXXXXXXXXXXXXX2313,189.95,,5343682.36,AccountTransactionsReport(1).csv,1964,2025-02,False,Other Computer Services,Other Computer Services,Other Computer Services
,2025-02-03,8400/000 : FNB,883.20 SQSP* INV167 4XX*5191 31 JAN XX4910 883.20 SQSP* INV167 4XXXXX*5191 31 JAN XXXXXXXXXXXXXXXXXX,Account Payment,883.20 SQSP* INV167 4XX*5191 31 JAN XX4910 883.20 SQSP* INV167 4XXXXX*5191 31 JAN XXXXXXXXXXXXXXXXX,883.2,,5344565.56,AccountTransactionsReport(1).csv,1965,2025-02,False,Other Computer Services,Other Computer Services,Other Computer Services
,2025-02-03,8400/000 : FNB,Digitalocean 47.84 DIGITALOCEAN. 4XXXXX*5191 01 FEB XXXXXXXXXXXXXXXXXXX1076 Digitalocean,Account Payment,Digitalocean 47.84 DIGITALOCEAN. 4XXXXX*5191 01 FEB XXXXXXXXXXXXXXXXXXX1076 Digitalocean,914.86,,5345480.42,AccountTransactionsReport(1).csv,1966,2025-02,False,Cloud Services,Cloud Services,Cloud Services
,2025-02-03,8400/000 : FNB,48.30 FRAPPE CLOUD 4XX*5191 31 JAN XX7317 48.30 FRAPPE CLOUD 4XXXXX*5191 31 JAN XXXXXXXXXXXXXXXXXXX7,Account Payment,48.30 FRAPPE CLOUD 4XX*5191 31 JAN XX7317 48.30 FRAPPE CLOUD 4XXXXX*5191 31 JAN XXXXXXXXXXXXXXXXXXX,917.47,,5346397.89,AccountTransactionsReport(1).csv,1967,2025-02,False,Other Computer Services,Other Computer Services,Other Computer Services
,2025-02-04,8400/000 : FNB,1.00 VERCEL INC. 4XX*5225 01 FEB XX5683 1.00 VERCEL INC. 4XXXXX*5225 01 FEB XXXXXXXXXXXXXXXXXXX5683,Account Payment,1.00 VERCEL INC. 4XX*5225 01 FEB XX5683 1.00 VERCEL INC. 4XXXXX*5225 01 FEB XXXXXXXXXXXXXXXXXXX5683,19.13,,5346417.02,AccountTransactionsReport(1).csv,1968,2025-02,False,Cloud Services,Cloud Services,Cloud Services
,2025-02-04,8400/000 : FNB,Facebook 4.60 FACEBK *5H6YVJ 4XXXXX*5191 01 FEB XXXXXXXXXXXXXXXXXXX9021 Facebook,Account Payment,Facebook 4.60 FACEBK *5H6YVJ 4XXXXX*5191 01 FEB XXXXXXXXXXXXXXXXXXX9021 Facebook,87.96,,5346504.98,AccountTransactionsReport(1).csv,1969,2025-02,False,Marketing Tools,Marketing Tools,Marketing Tools
,2025-02-04,8400/000 : FNB,Facebook 13.80 FACEBK *D6KPS 4XXXXX*5191 01 FEB XXXXXXXXXXXXXXXXXXX3047 Facebook,Account Payment,Facebook 13.80 FACEBK *D6KPS 4XXXXX*5191 01 FEB XXXXXXXXXXXXXXXXXXX3047 Facebook,263.9,,5346768.88,AccountTransactionsReport(1).csv,1970,2025-02,False,Marketing Tools,Marketing Tools,Marketing Tools
,2025-02-04,8400/000 : FNB,17.25 SLACK T06A3T4 4XX*5191 01 FEB XX3448 17.25 SLACK T06A3T4 4XXXXX*5191 01 FEB XXXXXXXXXXXXXXXXXX,Account Payment,17.25 SLACK T06A3T4 4XX*5191 01 FEB XX3448 17.25 SLACK T06A3T4 4XXXXX*5191 01 FEB XXXXXXXXXXXXXXXXX,329.88,,5347098.76,AccountTransactionsReport(1).csv,1971,2025-02,False,Communication,Communication,Communication
,2025-02-04,8400/000 : FNB,Dropbox 18.38 DROPBOX*3HX6D 4XXXXX*5191 01 FEB XXXXXXXXXXXXXXXXXXX0826 Dropbox,Account Payment,Dropbox 18.38 DROPBOX*3HX6D 4XXXXX*5191 01 FEB XXXXXXXXXXXXXXXXXXX0826 Dropbox,351.49,,5347450.25,AccountTransactionsReport(1).csv,1972,2025-02,False,Other Computer Services,Other Computer Services,Other Computer Services
,2025-02-04,8400/000 : FNB,Facebook 23.00 FACEBK *KSFQ2 4XXXXX*5191 01 FEB XXXXXXXXXXXXXXXXXXX9060 Facebook,Account Payment,Facebook 23.00 FACEBK *KSFQ2 4XXXXX*5191 01 FEB XXXXXXXXXXXXXXXXXXX9060 Facebook,439.83,,5347890.08,AccountTransactionsReport(1).csv,1973,2025-02,False,Marketing Tools,Marketing Tools,Marketing Tools
,2025-02-04,8400/000 : FNB,441.60 SQSP* INV167 4XX*5191 02 FEB XX6561 441.60 SQSP* INV167 4XXXXX*5191 02 FEB XXXXXXXXXXXXXXXXXX,Account Payment,441.60 SQSP* INV167 4XX*5191 02 FEB XX6561 441.60 SQSP* INV167 4XXXXX*5191 02 FEB XXXXXXXXXXXXXXXXX,441.6,,5348331.68,AccountTransactionsReport(1).csv,1974,2025-02,False,Other Computer Services,Other Computer Services,Other Computer Services
,2025-02-04,8400/000 : FNB,Google Store 39.82 Google GSUITE 4XXXXX*5191 01 FEB XXXXXXXXXXXXXXXXXXX6088 Google Store,Account Payment,Google Store 39.82 Google GSUITE 4XXXXX*5191 01 FEB XXXXXXXXXXXXXXXXXXX6088 Google Store,789.23,,5349120.91,AccountTransactionsReport(1).csv,1975,2025-02,False,Other Computer Services,Analytics & Monitoring,Analytics & Monitoring
,2025-02-04,8400/000 : FNB,134.00 SINCH MAILGU 4XX*5191 01 FEB XX2824 134.00 SINCH MAILGU 4XXXXX*5191 01 FEB XXXXXXXXXXXXXXXXXX,Account Payment,134.00 SINCH MAILGU 4XX*5191 01 FEB XX2824 134.00 SINCH MAILGU 4XXXXX*5191 01 FEB XXXXXXXXXXXXXXXXX,2562.53,,5351683.44,AccountTransactionsReport(1).csv,1976,2025-02,False,Other Computer Services,Other Computer Services,Other Computer Services
,2025-02-04,8400/000 : FNB,Google 389.02 GOOGLE*GSUIT 4XXXXX*5225 01 FEB XXXXXXXXXXXXXXXXXXX9826 Google,Account Payment,Google 389.02 GOOGLE*GSUIT 4XXXXX*5225 01 FEB XXXXXXXXXXXXXXXXXXX9826 Google,7710.27,,5359393.71,AccountTransactionsReport(1).csv,1977,2025-02,False,Other Computer Services,Analytics & Monitoring,Analytics & Monitoring
,2025-02-04,8400/000 : FNB,450.00 WAPPALYZER 4XX*5191 02 FEB XX0849 450.00 WAPPALYZER 4XXXXX*5191 02 FEB XXXXXXXXXXXXXXXXXXX084,Account Payment,450.00 WAPPALYZER 4XX*5191 02 FEB XX0849 450.00 WAPPALYZER 4XXXXX*5191 02 FEB XXXXXXXXXXXXXXXXXXX08,8605.52,,5367999.23,AccountTransactionsReport(1).csv,1978,2025-02,False,Other Computer Services,Other Computer Services,Other Computer Services
,2025-02-05,8400/000 : FNB,920.00 AUTH0.COM 4XX*5191 03 FEB XX9370 920.00 AUTH0.COM 4XXXXX*5191 03 FEB XXXXXXXXXXXXXXXXXXX9370,Account Payment,920.00 AUTH0.COM 4XX*5191 03 FEB XX9370 920.00 AUTH0.COM 4XXXXX*5191 03 FEB XXXXXXXXXXXXXXXXXXX9370,17593.49,,5385592.72,AccountTransactionsReport(1).csv,1979,2025-02,False,Security Services,Security Services,Security Services
,2025-02-05,8400/000 : FNB,Stable 249.00 STABLE 4XXXXX*5191 04 FEB XXXXXXXXXXXXXXXXXXX1948 Stable,Account Payment,Stable 249.00 STABLE 4XXXXX*5191 04 FEB XXXXXXXXXXXXXXXXXXX1948 Stable,4842.07,,5390434.79,AccountTransactionsReport(1).csv,1980,2025-02,False,Other Computer Services,Other Computer Services,Other Computer Services
,2025-02-05,8400/000 : FNB,179.00 MOZSEO:HELP@ 4XX*5191 03 FEB XX5465 179.00 MOZSEO:HELP@ 4XXXXX*5191 03 FEB XXXXXXXXXXXXXXXXXX,Account Payment,179.00 MOZSEO:HELP@ 4XX*5191 03 FEB XX5465 179.00 MOZSEO:HELP@ 4XXXXX*5191 03 FEB XXXXXXXXXXXXXXXXX,3423.08,,5393857.87,AccountTransactionsReport(1).csv,1981,2025-02,False,Other Computer Services,Other Computer Services,Other Computer Services
,2025-02-05,8400/000 : FNB,99.00 DMNS.APP BUSI 4XX*5191 04 FEB XX5625 99.00 DMNS.APP BUSI 4XXXXX*5191 04 FEB XXXXXXXXXXXXXXXXXX,Account Payment,99.00 DMNS.APP BUSI 4XX*5191 04 FEB XX5625 99.00 DMNS.APP BUSI 4XXXXX*5191 04 FEB XXXXXXXXXXXXXXXXX,1925.16,,5395783.03,AccountTransactionsReport(1).csv,1982,2025-02,False,Other Computer Services,Other Computer Services,Other Computer Services
,2025-02-05,8400/000 : FNB,60.00 INSOMNIA TEAM 4XX*5191 03 FEB XX7586 60.00 INSOMNIA TEAM 4XXXXX*5191 03 FEB XXXXXXXXXXXXXXXXXX,Account Payment,60.00 INSOMNIA TEAM 4XX*5191 03 FEB XX7586 60.00 INSOMNIA TEAM 4XXXXX*5191 03 FEB XXXXXXXXXXXXXXXXX,1166.77,,5396949.8,AccountTransactionsReport(1).csv,1983,2025-02,False,Other Computer Services,Other Computer Services,Other Computer Services
,2025-02-05,8400/000 : FNB,56.06 PADDLE.NET* W 4XX*5191 04 FEB XX2691 56.06 PADDLE.NET* W 4XXXXX*5191 04 FEB XXXXXXXXXXXXXXXXXX,Account Payment,56.06 PADDLE.NET* W 4XX*5191 04 FEB XX2691 56.06 PADDLE.NET* W 4XXXXX*5191 04 FEB XXXXXXXXXXXXXXXXX,1090.15,,5398039.95,AccountTransactionsReport(1).csv,1984,2025-02,False,Other Computer Services,Subscription Management,Subscription Management
,2025-02-06,8400/000 : FNB,4.21 OPENAI 4XX*5191 05 FEB XX7953 4.21 OPENAI 4XXXXX*5191 05 FEB XXXXXXXXXXXXXXXXXXX7953,Account Payment,4.21 OPENAI 4XX*5191 05 FEB XX7953 4.21 OPENAI 4XXXXX*5191 05 FEB XXXXXXXXXXXXXXXXXXX7953,80.96,,5398120.91,AccountTransactionsReport(1).csv,1985,2025-02,False,AI Services,AI Services,AI Services
,2025-02-06,8400/000 : FNB,19.00 CHATBASE 4XX*5191 05 FEB XX4249 19.00 CHATBASE 4XXXXX*5191 05 FEB XXXXXXXXXXXXXXXXXXX4249,Account Payment,19.00 CHATBASE 4XX*5191 05 FEB XX4249 19.00 CHATBASE 4XXXXX*5191 05 FEB XXXXXXXXXXXXXXXXXXX4249,365.38,,5398486.29,AccountTransactionsReport(1).csv,1986,2025-02,False,Other Computer Services,Other Computer Services,Other Computer Services
,2025-02-06,8400/000 : FNB,"Github Inc. 19.00 GITHUB, INC. 4XXXXX*5225 04 FEB XXXXXXXXXXXXXXXXXXX9617 Github Inc.",Account Payment,"Github Inc. 19.00 GITHUB, INC. 4XXXXX*5225 04 FEB XXXXXXXXXXXXXXXXXXX9617 Github Inc.",369.47,,5398855.76,AccountTransactionsReport(1).csv,1987,2025-02,False,Development Tools,Development Tools,Development Tools
,2025-02-06,8400/000 : FNB,"Github Inc. 31.67 GITHUB, INC. 4XXXXX*5225 04 FEB XXXXXXXXXXXXXXXXXXX8730 Github Inc.",Account Payment,"Github Inc. 31.67 GITHUB, INC. 4XXXXX*5225 04 FEB XXXXXXXXXXXXXXXXXXX8730 Github Inc.",615.86,,5399471.62,AccountTransactionsReport(1).csv,1988,2025-02,False,Development Tools,Development Tools,Development Tools
,2025-02-06,8400/000 : FNB,Google Play 999.99 Google Malwa 4XXXXX*5191 03 FEB XXXXXXXXXXXXXXXXXXX8098 Google Play,Account Payment,Google Play 999.99 Google Malwa 4XXXXX*5191 03 FEB XXXXXXXXXXXXXXXXXXX8098 Google Play,999.99,,5400471.61,AccountTransactionsReport(1).csv,1989,2025-02,False,Other Computer Services,Analytics & Monitoring,Analytics & Monitoring
,2025-02-06,8400/000 : FNB,99.99 JINA.AI 4XX*5191 04 FEB XX0192 99.99 JINA.AI 4XXXXX*5191 04 FEB XXXXXXXXXXXXXXXXXXX0192,Account Payment,99.99 JINA.AI 4XX*5191 04 FEB XX0192 99.99 JINA.AI 4XXXXX*5191 04 FEB XXXXXXXXXXXXXXXXXXX0192,1944.42,,5402416.03,AccountTransactionsReport(1).csv,1990,2025-02,False,Other Computer Services,Other Computer Services,Other Computer Services
,2025-02-06,8400/000 : FNB,ManageWP 120.75 MANAGEWP 4XXXXX*5225 05 FEB XXXXXXXXXXXXXXXXXXX1207 ManageWP,Account Payment,ManageWP 120.75 MANAGEWP 4XXXXX*5225 05 FEB XXXXXXXXXXXXXXXXXXX1207 ManageWP,2322.11,,5404738.14,AccountTransactionsReport(1).csv,1991,2025-02,False,Other Computer Services,Other Computer Services,Other Computer Services
,2025-02-06,8400/000 : FNB,ManageWP 120.75 MANAGEWP 4XXXXX*5225 05 FEB XXXXXXXXXXXXXXXXXXX2895 ManageWP,Account Payment,ManageWP 120.75 MANAGEWP 4XXXXX*5225 05 FEB XXXXXXXXXXXXXXXXXXX2895 ManageWP,2322.11,,5407060.25,AccountTransactionsReport(1).csv,1992,2025-02,False,Other Computer Services,Other Computer Services,Other Computer Services
,2025-02-06,8400/000 : FNB,599.00 TRIPLE WHALE 4XX*5191 04 FEB XX8548 599.00 TRIPLE WHALE 4XXXXX*5191 04 FEB XXXXXXXXXXXXXXXXXX,Account Payment,599.00 TRIPLE WHALE 4XX*5191 04 FEB XX8548 599.00 TRIPLE WHALE 4XXXXX*5191 04 FEB XXXXXXXXXXXXXXXXX,11648.21,,5418708.46,AccountTransactionsReport(1).csv,1993,2025-02,False,Other Computer Services,Other Computer Services,Other Computer Services
,2025-02-06,8400/000 : FNB,1499.00 APPDIRECT 4XX*5225 04 FEB XX4906 1499.00 APPDIRECT 4XXXXX*5225 04 FEB XXXXXXXXXXXXXXXXXXX490,Account Payment,1499.00 APPDIRECT 4XX*5225 04 FEB XX4906 1499.00 APPDIRECT 4XXXXX*5225 04 FEB XXXXXXXXXXXXXXXXXXX49,29149.69,,5447858.15,AccountTransactionsReport(1).csv,1994,2025-02,False,Other Computer Services,Other Computer Services,Other Computer Services
,2025-02-06,8400/000 : FNB,Shopify 2566.98 SHOPIFY* 32 4XXXXX*5191 04 FEB XXXXXXXXXXXXXXXXXXX4504 Shopify,Account Payment,Shopify 2566.98 SHOPIFY* 32 4XXXXX*5191 04 FEB XXXXXXXXXXXXXXXXXXX4504 Shopify,49917.73,,5497775.88,AccountTransactionsReport(1).csv,1995,2025-02,False,E-commerce Platforms,E-commerce Platforms,E-commerce Platforms
,2025-02-07,8400/000 : FNB,99.00 CHATBASE 4XX*5191 05 FEB XX2980 99.00 CHATBASE 4XXXXX*5191 05 FEB XXXXXXXXXXXXXXXXXXX2980,Account Payment,99.00 CHATBASE 4XX*5191 05 FEB XX2980 99.00 CHATBASE 4XXXXX*5191 05 FEB XXXXXXXXXXXXXXXXXXX2980,1903.85,,5499679.73,AccountTransactionsReport(1).csv,1996,2025-02,False,Other Computer Services,Other Computer Services,Other Computer Services
,2025-02-07,8400/000 : FNB,Paddle 187.94 PADDLE.NET* 4XXXXX*5191 05 FEB XXXXXXXXXXXXXXXXXXX2578 Paddle,Account Payment,Paddle 187.94 PADDLE.NET* 4XXXXX*5191 05 FEB XXXXXXXXXXXXXXXXXXX2578 Paddle,187.94,,5499867.67,AccountTransactionsReport(1).csv,1997,2025-02,False,Other Computer Services,Subscription Management,Subscription Management
,2025-02-08,8400/000 : FNB,3.60 GETADDRESS.IO 4XX*5225 07 FEB XX6649 3.60 GETADDRESS.IO 4XXXXX*5225 07 FEB XXXXXXXXXXXXXXXXXXX6,Account Payment,3.60 GETADDRESS.IO 4XX*5225 07 FEB XX6649 3.60 GETADDRESS.IO 4XXXXX*5225 07 FEB XXXXXXXXXXXXXXXXXXX,85.83,,5499953.5,AccountTransactionsReport(1).csv,1998,2025-02,False,Other Computer Services,Other Computer Services,Other Computer Services
,2025-02-08,8400/000 : FNB,20.00 VERCEL INC. 4XX*5225 07 FEB XX2098 20.00 VERCEL INC. 4XXXXX*5225 07 FEB XXXXXXXXXXXXXXXXXXX209,Account Payment,20.00 VERCEL INC. 4XX*5225 07 FEB XX2098 20.00 VERCEL INC. 4XXXXX*5225 07 FEB XXXXXXXXXXXXXXXXXXX20,381.43,,5500334.93,AccountTransactionsReport(1).csv,1999,2025-02,False,Cloud Services,Cloud Services,Cloud Services
,2025-02-08,8400/000 : FNB,Woocommerce 19.99 WOOCOMMERCE S 4XXXXX*5225 06 FEB XXXXXXXXXXXXXXXXXXX8954 Woocommerce,Account Payment,Woocommerce 19.99 WOOCOMMERCE S 4XXXXX*5225 06 FEB XXXXXXXXXXXXXXXXXXX8954 Woocommerce,381.85,,5500716.78,AccountTransactionsReport(1).csv,2000,2025-02,False,Other Computer Services,Other Computer Services,Other Computer Services
,2025-02-08,8400/000 : FNB,41.00 VERCEL INC. 4XX*5225 07 FEB XX9184 41.00 VERCEL INC. 4XXXXX*5225 07 FEB XXXXXXXXXXXXXXXXXXX918,Account Payment,41.00 VERCEL INC. 4XX*5225 07 FEB XX9184 41.00 VERCEL INC. 4XXXXX*5225 07 FEB XXXXXXXXXXXXXXXXXXX91,781.93,,5501498.71,AccountTransactionsReport(1).csv,2001,2025-02,False,Cloud Services,Cloud Services,Cloud Services
,2025-02-10,8400/000 : FNB,"105.00 NOTION LABS, 4XX*5225 07 FEB XX8447 105.00 NOTION LABS, 4XXXXX*5225 07 FEB XXXXXXXXXXXXXXXXXX",Account Payment,"105.00 NOTION LABS, 4XX*5225 07 FEB XX8447 105.00 NOTION LABS, 4XXXXX*5225 07 FEB XXXXXXXXXXXXXXXXX",2002.53,,5503501.24,AccountTransactionsReport(1).csv,2002,2025-02,False,Other Computer Services,Collaboration Tools,Collaboration Tools
,2025-02-10,8400/000 : FNB,Intuit 570.40 INTUIT *QBoo 4XXXXX*5225 07 FEB XXXXXXXXXXXXXXXXXXX3631 Intuit,Account Payment,Intuit 570.40 INTUIT *QBoo 4XXXXX*5225 07 FEB XXXXXXXXXXXXXXXXXXX3631 Intuit,570.4,,5504071.64,AccountTransactionsReport(1).csv,2003,2025-02,False,Productivity Software,Productivity Software,Productivity Software
,2025-02-11,8400/000 : FNB,Intuit 570.40 INTUIT *QBoo 4XXXXX*5225 09 FEB XXXXXXXXXXXXXXXXXXX1419 Intuit,Account Payment,Intuit 570.40 INTUIT *QBoo 4XXXXX*5225 09 FEB XXXXXXXXXXXXXXXXXXX1419 Intuit,570.4,,5504642.04,AccountTransactionsReport(1).csv,2004,2025-02,False,Productivity Software,Productivity Software,Productivity Software
,2025-02-11,8400/000 : FNB,"25.00 NOTION LABS, 4XX*5225 08 FEB XX1773 25.00 NOTION LABS, 4XXXXX*5225 08 FEB XXXXXXXXXXXXXXXXXXX1",Account Payment,"25.00 NOTION LABS, 4XX*5225 08 FEB XX1773 25.00 NOTION LABS, 4XXXXX*5225 08 FEB XXXXXXXXXXXXXXXXXXX",472.46,,5505114.5,AccountTransactionsReport(1).csv,2005,2025-02,False,Other Computer Services,Collaboration Tools,Collaboration Tools
,2025-02-11,8400/000 : FNB,499.00 CASSIDYAI.CO 4XX*5225 09 FEB XX5990 499.00 CASSIDYAI.CO 4XXXXX*5225 09 FEB XXXXXXXXXXXXXXXXXX,Account Payment,499.00 CASSIDYAI.CO 4XX*5225 09 FEB XX5990 499.00 CASSIDYAI.CO 4XXXXX*5225 09 FEB XXXXXXXXXXXXXXXXX,9430.38,,5514544.88,AccountTransactionsReport(1).csv,2006,2025-02,False,Other Computer Services,Other Computer Services,Other Computer Services
,2025-02-11,8400/000 : FNB,Shopify 74.75 SHOPIFY* 3283 4XXXXX*5225 09 FEB XXXXXXXXXXXXXXXXXXX7184 Shopify,Account Payment,Shopify 74.75 SHOPIFY* 3283 4XXXXX*5225 09 FEB XXXXXXXXXXXXXXXXXXX7184 Shopify,1412.67,,5515957.55,AccountTransactionsReport(1).csv,2007,2025-02,False,E-commerce Platforms,E-commerce Platforms,E-commerce Platforms
,2025-02-12,8400/000 : FNB,Shopify 3633.95 SHOPIFY* 32 4XXXXX*5225 10 FEB XXXXXXXXXXXXXXXXXXX4625 Shopify,Account Payment,Shopify 3633.95 SHOPIFY* 32 4XXXXX*5225 10 FEB XXXXXXXXXXXXXXXXXXX4625 Shopify,68676.38,,5584633.93,AccountTransactionsReport(1).csv,2008,2025-02,False,E-commerce Platforms,E-commerce Platforms,E-commerce Platforms
,2025-02-13,8400/000 : FNB,"Github Inc. 210.00 GITHUB, INC. 4XXXXX*5225 11 FEB XXXXXXXXXXXXXXXXXXX1808 Github Inc.",Account Payment,"Github Inc. 210.00 GITHUB, INC. 4XXXXX*5225 11 FEB XXXXXXXXXXXXXXXXXXX1808 Github Inc.",3999.95,,5588633.88,AccountTransactionsReport(1).csv,2009,2025-02,False,Development Tools,Development Tools,Development Tools
,2025-02-13,8400/000 : FNB,Intuit 570.40 INTUIT *QBoo 4XXXXX*5225 11 FEB XXXXXXXXXXXXXXXXXXX5353 Intuit,Account Payment,Intuit 570.40 INTUIT *QBoo 4XXXXX*5225 11 FEB XXXXXXXXXXXXXXXXXXX5353 Intuit,570.4,,5589204.28,AccountTransactionsReport(1).csv,2010,2025-02,False,Productivity Software,Productivity Software,Productivity Software
,2025-02-13,8400/000 : FNB,Intuit 570.40 INTUIT *QBoo 4XXXXX*5225 11 FEB XXXXXXXXXXXXXXXXXXX5312 Intuit,Account Payment,Intuit 570.40 INTUIT *QBoo 4XXXXX*5225 11 FEB XXXXXXXXXXXXXXXXXXX5312 Intuit,570.4,,5589774.68,AccountTransactionsReport(1).csv,2011,2025-02,False,Productivity Software,Productivity Software,Productivity Software
,2025-02-15,8400/000 : FNB,5.00 WWW.FLUX.AI 4XX*5225 13 FEB XX4422 5.00 WWW.FLUX.AI 4XXXXX*5225 13 FEB XXXXXXXXXXXXXXXXXXX4422,Account Payment,5.00 WWW.FLUX.AI 4XX*5225 13 FEB XX4422 5.00 WWW.FLUX.AI 4XXXXX*5225 13 FEB XXXXXXXXXXXXXXXXXXX4422,94.77,,5589869.45,AccountTransactionsReport(1).csv,2012,2025-02,False,Other Computer Services,Other Computer Services,Other Computer Services
,2025-02-15,8400/000 : FNB,180.00 AGENCYANALYT 4XX*5225 13 FEB XX6321 180.00 AGENCYANALYT 4XXXXX*5225 13 FEB XXXXXXXXXXXXXXXXXX,Account Payment,180.00 AGENCYANALYT 4XX*5225 13 FEB XX6321 180.00 AGENCYANALYT 4XXXXX*5225 13 FEB XXXXXXXXXXXXXXXXX,3411.56,,5593281.01,AccountTransactionsReport(1).csv,2013,2025-02,False,Other Computer Services,Other Computer Services,Other Computer Services
,2025-02-17,8400/000 : FNB,Payment to Linkedin X1999.88 LinkedIn S 4XXXXX*5191 15 FEB XXXXXXXXXXXXXXXXXXX0094 Linkedin,Account Payment,Payment to Linkedin X1999.88 LinkedIn S 4XXXXX*5191 15 FEB XXXXXXXXXXXXXXXXXXX0094 Linkedin,11999.88,,5605280.89,AccountTransactionsReport(1).csv,2014,2025-02,False,Other Computer Services,Other Computer Services,Other Computer Services
,2025-02-17,8400/000 : FNB,280.00 WIZA.CO 4XX*5191 14 FEB XX4281 280.00 WIZA.CO 4XXXXX*5191 14 FEB XXXXXXXXXXXXXXXXXXX4281,Account Payment,280.00 WIZA.CO 4XX*5191 14 FEB XX4281 280.00 WIZA.CO 4XXXXX*5191 14 FEB XXXXXXXXXXXXXXXXXXX4281,5328.12,,5610609.01,AccountTransactionsReport(1).csv,2015,2025-02,False,Other Computer Services,Other Computer Services,Other Computer Services
,2025-02-17,8400/000 : FNB,174.00 INTERCOM R&D 4XX*5191 15 FEB XX4977 174.00 INTERCOM R&D 4XXXXX*5191 15 FEB XXXXXXXXXXXXXXXXXX,Account Payment,174.00 INTERCOM R&D 4XX*5191 15 FEB XX4977 174.00 INTERCOM R&D 4XXXXX*5191 15 FEB XXXXXXXXXXXXXXXXX,3296.77,,5613905.78,AccountTransactionsReport(1).csv,2016,2025-02,False,Other Computer Services,Customer Support,Customer Support
,2025-02-17,8400/000 : FNB,172.50 OPENAI *CHAT 4XX*5191 14 FEB XX4333 172.50 OPENAI *CHAT 4XXXXX*5191 14 FEB XXXXXXXXXXXXXXXXXX,Account Payment,172.50 OPENAI *CHAT 4XX*5191 14 FEB XX4333 172.50 OPENAI *CHAT 4XXXXX*5191 14 FEB XXXXXXXXXXXXXXXXX,3282.5,,5617188.28,AccountTransactionsReport(1).csv,2017,2025-02,False,AI Services,AI Services,AI Services
,2025-02-17,8400/000 : FNB,49.00 SKRAPP.IO STA 4XX*5191 14 FEB XX7410 49.00 SKRAPP.IO STA 4XXXXX*5191 14 FEB XXXXXXXXXXXXXXXXXX,Account Payment,49.00 SKRAPP.IO STA 4XX*5191 14 FEB XX7410 49.00 SKRAPP.IO STA 4XXXXX*5191 14 FEB XXXXXXXXXXXXXXXXX,932.42,,5618120.7,AccountTransactionsReport(1).csv,2018,2025-02,False,Other Computer Services,Other Computer Services,Other Computer Services
,2025-02-17,8400/000 : FNB,43.84 RAILWAY 4XX*5191 14 FEB XX1011 43.84 RAILWAY 4XXXXX*5191 14 FEB XXXXXXXXXXXXXXXXXXX1011,Account Payment,43.84 RAILWAY 4XX*5191 14 FEB XX1011 43.84 RAILWAY 4XXXXX*5191 14 FEB XXXXXXXXXXXXXXXXXXX1011,834.23,,5618954.93,AccountTransactionsReport(1).csv,2019,2025-02,False,Other Computer Services,Other Computer Services,Other Computer Services
,2025-02-17,8400/000 : FNB,"40.00 REPLIT, INC. 4XX*5191 14 FEB XX9270 40.00 REPLIT, INC. 4XXXXX*5191 14 FEB XXXXXXXXXXXXXXXXXXX9",Account Payment,"40.00 REPLIT, INC. 4XX*5191 14 FEB XX9270 40.00 REPLIT, INC. 4XXXXX*5191 14 FEB XXXXXXXXXXXXXXXXXXX",761.16,,5619716.09,AccountTransactionsReport(1).csv,2020,2025-02,False,Other Computer Services,Other Computer Services,Other Computer Services
,2025-02-17,8400/000 : FNB,Intuit 570.40 INTUIT *QBoo 4XXXXX*5225 14 FEB XXXXXXXXXXXXXXXXXXX5038 Intuit,Account Payment,Intuit 570.40 INTUIT *QBoo 4XXXXX*5225 14 FEB XXXXXXXXXXXXXXXXXXX5038 Intuit,570.4,,5620286.49,AccountTransactionsReport(1).csv,2021,2025-02,False,Productivity Software,Productivity Software,Productivity Software
,2025-02-17,8400/000 : FNB,28.85 RAILWAY 4XX*5191 14 FEB XX0200 28.85 RAILWAY 4XXXXX*5191 14 FEB XXXXXXXXXXXXXXXXXXX0200,Account Payment,28.85 RAILWAY 4XX*5191 14 FEB XX0200 28.85 RAILWAY 4XXXXX*5191 14 FEB XXXXXXXXXXXXXXXXXXX0200,548.98,,5620835.47,AccountTransactionsReport(1).csv,2022,2025-02,False,Other Computer Services,Other Computer Services,Other Computer Services
,2025-02-17,8400/000 : FNB,21.56 SLACK T0740DV 4XX*5191 14 FEB XX5891 21.56 SLACK T0740DV 4XXXXX*5191 14 FEB XXXXXXXXXXXXXXXXXX,Account Payment,21.56 SLACK T0740DV 4XX*5191 14 FEB XX5891 21.56 SLACK T0740DV 4XXXXX*5191 14 FEB XXXXXXXXXXXXXXXXX,410.26,,5621245.73,AccountTransactionsReport(1).csv,2023,2025-02,False,Communication,Communication,Communication
,2025-02-17,8400/000 : FNB,20.00 VERCEL INC. 4XX*5191 14 FEB XX1606 20.00 VERCEL INC. 4XXXXX*5191 14 FEB XXXXXXXXXXXXXXXXXXX160,Account Payment,20.00 VERCEL INC. 4XX*5191 14 FEB XX1606 20.00 VERCEL INC. 4XXXXX*5191 14 FEB XXXXXXXXXXXXXXXXXXX16,380.58,,5621626.31,AccountTransactionsReport(1).csv,2024,2025-02,False,Cloud Services,Cloud Services,Cloud Services
,2025-02-17,8400/000 : FNB,"Github Inc. 14.00 GITHUB, INC. 4XXXXX*5225 14 FEB XXXXXXXXXXXXXXXXXXX6548 Github Inc.",Account Payment,"Github Inc. 14.00 GITHUB, INC. 4XXXXX*5225 14 FEB XXXXXXXXXXXXXXXXXXX6548 Github Inc.",266.4,,5621892.71,AccountTransactionsReport(1).csv,2025,2025-02,False,Development Tools,Development Tools,Development Tools
,2025-02-17,8400/000 : FNB,12.00 CODESANDBOX 4XX*5191 14 FEB XX4819 12.00 CODESANDBOX 4XXXXX*5191 14 FEB XXXXXXXXXXXXXXXXXXX481,Account Payment,12.00 CODESANDBOX 4XX*5191 14 FEB XX4819 12.00 CODESANDBOX 4XXXXX*5191 14 FEB XXXXXXXXXXXXXXXXXXX48,228.35,,5622121.06,AccountTransactionsReport(1).csv,2026,2025-02,False,Other Computer Services,Other Computer Services,Other Computer Services
,2025-02-17,8400/000 : FNB,11.49 GOOGLE *Colab 4XX*5191 14 FEB XX8761 11.49 GOOGLE *Colab 4XXXXX*5191 14 FEB XXXXXXXXXXXXXXXXXX,Account Payment,11.49 GOOGLE *Colab 4XX*5191 14 FEB XX8761 11.49 GOOGLE *Colab 4XXXXX*5191 14 FEB XXXXXXXXXXXXXXXXX,218.65,,5622339.71,AccountTransactionsReport(1).csv,2027,2025-02,False,Other Computer Services,Analytics & Monitoring,Analytics & Monitoring
,2025-02-17,8400/000 : FNB,Google Store 34.99 Google One 4XXXXX*5191 14 FEB XXXXXXXXXXXXXXXXXXX9069 Google Store,Account Payment,Google Store 34.99 Google One 4XXXXX*5191 14 FEB XXXXXXXXXXXXXXXXXXX9069 Google Store,34.99,,5622374.7,AccountTransactionsReport(1).csv,2028,2025-02,False,Other Computer Services,Analytics & Monitoring,Analytics & Monitoring
,2025-02-18,8400/000 : FNB,780.00 ACQUIRE.COM 4XX*5191 16 FEB XX9459 780.00 ACQUIRE.COM 4XXXXX*5191 16 FEB XXXXXXXXXXXXXXXXXXX9,Account Payment,780.00 ACQUIRE.COM 4XX*5191 16 FEB XX9459 780.00 ACQUIRE.COM 4XXXXX*5191 16 FEB XXXXXXXXXXXXXXXXXXX,14778.66,,5637153.36,AccountTransactionsReport(1).csv,2029,2025-02,False,Other Computer Services,Other Computer Services,Other Computer Services
,2025-02-18,8400/000 : FNB,376.40 HOLASPIRIT 4XX*5225 15 FEB XX4995 376.40 HOLASPIRIT 4XXXXX*5225 15 FEB XXXXXXXXXXXXXXXXXXX499,Account Payment,376.40 HOLASPIRIT 4XX*5225 15 FEB XX4995 376.40 HOLASPIRIT 4XXXXX*5225 15 FEB XXXXXXXXXXXXXXXXXXX49,7450.52,,5644603.88,AccountTransactionsReport(1).csv,2030,2025-02,False,Other Computer Services,Other Computer Services,Other Computer Services
,2025-02-18,8400/000 : FNB,231.95 HOLASPIRIT 4XX*5225 15 FEB XX8871 231.95 HOLASPIRIT 4XXXXX*5225 15 FEB XXXXXXXXXXXXXXXXXXX887,Account Payment,231.95 HOLASPIRIT 4XX*5225 15 FEB XX8871 231.95 HOLASPIRIT 4XXXXX*5225 15 FEB XXXXXXXXXXXXXXXXXXX88,4591.25,,5649195.13,AccountTransactionsReport(1).csv,2031,2025-02,False,Other Computer Services,Other Computer Services,Other Computer Services
,2025-02-18,8400/000 : FNB,223.70 SLACK T0MN3D 4XX*5225 15 FEB XX7568 223.70 SLACK T0MN3D 4XXXXX*5225 15 FEB XXXXXXXXXXXXXXXXXX,Account Payment,223.70 SLACK T0MN3D 4XX*5225 15 FEB XX7568 223.70 SLACK T0MN3D 4XXXXX*5225 15 FEB XXXXXXXXXXXXXXXXX,4238.45,,5653433.58,AccountTransactionsReport(1).csv,2032,2025-02,False,Communication,Communication,Communication
,2025-02-18,8400/000 : FNB,Paddle 171.35 PADDLE.NET* 4XXXXX*5191 15 FEB XXXXXXXXXXXXXXXXXXX8182 Paddle,Account Payment,Paddle 171.35 PADDLE.NET* 4XXXXX*5191 15 FEB XXXXXXXXXXXXXXXXXXX8182 Paddle,3246.57,,5656680.15,AccountTransactionsReport(1).csv,2033,2025-02,False,Other Computer Services,Subscription Management,Subscription Management
,2025-02-18,8400/000 : FNB,150.00 AUTH0.COM 4XX*5191 16 FEB XX6241 150.00 AUTH0.COM 4XXXXX*5191 16 FEB XXXXXXXXXXXXXXXXXXX6241,Account Payment,150.00 AUTH0.COM 4XX*5191 16 FEB XX6241 150.00 AUTH0.COM 4XXXXX*5191 16 FEB XXXXXXXXXXXXXXXXXXX6241,2842.05,,5659522.2,AccountTransactionsReport(1).csv,2034,2025-02,False,Security Services,Security Services,Security Services
,2025-02-18,8400/000 : FNB,"Github Inc. 91.00 GITHUB, INC. 4XXXXX*5191 15 FEB XXXXXXXXXXXXXXXXXXX0751 Github Inc.",Account Payment,"Github Inc. 91.00 GITHUB, INC. 4XXXXX*5191 15 FEB XXXXXXXXXXXXXXXXXXX0751 Github Inc.",1724.18,,5661246.38,AccountTransactionsReport(1).csv,2035,2025-02,False,Development Tools,Development Tools,Development Tools
,2025-02-18,8400/000 : FNB,72.00 TERMIUS CORPO 4XX*5191 15 FEB XX4371 72.00 TERMIUS CORPO 4XXXXX*5191 15 FEB XXXXXXXXXXXXXXXXXX,Account Payment,72.00 TERMIUS CORPO 4XX*5191 15 FEB XX4371 72.00 TERMIUS CORPO 4XXXXX*5191 15 FEB XXXXXXXXXXXXXXXXX,1364.18,,5662610.56,AccountTransactionsReport(1).csv,2036,2025-02,False,Other Computer Services,Other Computer Services,Other Computer Services
,2025-02-18,8400/000 : FNB,"70.00 NOTION LABS, 4XX*5191 16 FEB XX6358 70.00 NOTION LABS, 4XXXXX*5191 16 FEB XXXXXXXXXXXXXXXXXXX6",Account Payment,"70.00 NOTION LABS, 4XX*5191 16 FEB XX6358 70.00 NOTION LABS, 4XXXXX*5191 16 FEB XXXXXXXXXXXXXXXXXXX",1326.29,,5663936.85,AccountTransactionsReport(1).csv,2037,2025-02,False,Other Computer Services,Collaboration Tools,Collaboration Tools
,2025-02-18,8400/000 : FNB,69.00 OPENAI *CHATG 4XX*5191 16 FEB XX3058 69.00 OPENAI *CHATG 4XXXXX*5191 16 FEB XXXXXXXXXXXXXXXXXX,Account Payment,69.00 OPENAI *CHATG 4XX*5191 16 FEB XX3058 69.00 OPENAI *CHATG 4XXXXX*5191 16 FEB XXXXXXXXXXXXXXXXX,1307.34,,5665244.19,AccountTransactionsReport(1).csv,2038,2025-02,False,AI Services,AI Services,AI Services
,2025-02-18,8400/000 : FNB,Facebook 1265.00 FACEBK* 4XXXXX*5191 16 FEB XXXXXXXXXXXXXXXXXXX3075 Facebook,Account Payment,Facebook 1265.00 FACEBK* 4XXXXX*5191 16 FEB XXXXXXXXXXXXXXXXXXX3075 Facebook,1265.0,,5666509.19,AccountTransactionsReport(1).csv,2039,2025-02,False,Marketing Tools,Marketing Tools,Marketing Tools
,2025-02-18,8400/000 : FNB,"40.00 REPLIT, INC. 4XX*5191 15 FEB XX2123 40.00 REPLIT, INC. 4XXXXX*5191 15 FEB XXXXXXXXXXXXXXXXXXX2",Account Payment,"40.00 REPLIT, INC. 4XX*5191 15 FEB XX2123 40.00 REPLIT, INC. 4XXXXX*5191 15 FEB XXXXXXXXXXXXXXXXXXX",757.88,,5667267.07,AccountTransactionsReport(1).csv,2040,2025-02,False,Other Computer Services,Other Computer Services,Other Computer Services
,2025-02-18,8400/000 : FNB,32.00 BUBBLE STARTE 4XX*5191 16 FEB XX3894 32.00 BUBBLE STARTE 4XXXXX*5191 16 FEB XXXXXXXXXXXXXXXXXX,Account Payment,32.00 BUBBLE STARTE 4XX*5191 16 FEB XX3894 32.00 BUBBLE STARTE 4XXXXX*5191 16 FEB XXXXXXXXXXXXXXXXX,606.31,,5667873.38,AccountTransactionsReport(1).csv,2041,2025-02,False,Other Computer Services,Other Computer Services,Other Computer Services
,2025-02-18,8400/000 : FNB,30.00 ISHRAQ LLC 4XX*5191 14 FEB XX9708 30.00 ISHRAQ LLC 4XXXXX*5191 14 FEB XXXXXXXXXXXXXXXXXXX9708,Account Payment,30.00 ISHRAQ LLC 4XX*5191 14 FEB XX9708 30.00 ISHRAQ LLC 4XXXXX*5191 14 FEB XXXXXXXXXXXXXXXXXXX9708,568.41,,5668441.79,AccountTransactionsReport(1).csv,2042,2025-02,False,Other Computer Services,Other Computer Services,Other Computer Services
,2025-02-18,8400/000 : FNB,25.00 BEECEPTOR 4XX*5191 16 FEB XX3904 25.00 BEECEPTOR 4XXXXX*5191 16 FEB XXXXXXXXXXXXXXXXXXX3904,Account Payment,25.00 BEECEPTOR 4XX*5191 16 FEB XX3904 25.00 BEECEPTOR 4XXXXX*5191 16 FEB XXXXXXXXXXXXXXXXXXX3904,473.68,,5668915.47,AccountTransactionsReport(1).csv,2043,2025-02,False,Other Computer Services,Other Computer Services,Other Computer Services
,2025-02-18,8400/000 : FNB,25.00 BEECEPTOR 4XX*5191 16 FEB XX3672 25.00 BEECEPTOR 4XXXXX*5191 16 FEB XXXXXXXXXXXXXXXXXXX3672,Account Payment,25.00 BEECEPTOR 4XX*5191 16 FEB XX3672 25.00 BEECEPTOR 4XXXXX*5191 16 FEB XXXXXXXXXXXXXXXXXXX3672,473.68,,5669389.15,AccountTransactionsReport(1).csv,2044,2025-02,False,Other Computer Services,Other Computer Services,Other Computer Services
,2025-02-18,8400/000 : FNB,20.00 VERCEL INC. 4XX*5191 16 FEB XX2514 20.00 VERCEL INC. 4XXXXX*5191 16 FEB XXXXXXXXXXXXXXXXXXX251,Account Payment,20.00 VERCEL INC. 4XX*5191 16 FEB XX2514 20.00 VERCEL INC. 4XXXXX*5191 16 FEB XXXXXXXXXXXXXXXXXXX25,378.94,,5669768.09,AccountTransactionsReport(1).csv,2045,2025-02,False,Cloud Services,Cloud Services,Cloud Services
,2025-02-18,8400/000 : FNB,20.00 HUGGINGFACE 4XX*5191 15 FEB XX1548 20.00 HUGGINGFACE 4XXXXX*5191 15 FEB XXXXXXXXXXXXXXXXXXX154,Account Payment,20.00 HUGGINGFACE 4XX*5191 15 FEB XX1548 20.00 HUGGINGFACE 4XXXXX*5191 15 FEB XXXXXXXXXXXXXXXXXXX15,378.94,,5670147.03,AccountTransactionsReport(1).csv,2046,2025-02,False,AI Services,AI Services,AI Services
,2025-02-18,8400/000 : FNB,350.00 FRAMER.COM 4XX*5191 16 FEB XX6518 350.00 FRAMER.COM 4XXXXX*5191 16 FEB XXXXXXXXXXXXXXXXXXX651,Account Payment,350.00 FRAMER.COM 4XX*5191 16 FEB XX6518 350.00 FRAMER.COM 4XXXXX*5191 16 FEB XXXXXXXXXXXXXXXXXXX65,350.0,,5670497.03,AccountTransactionsReport(1).csv,2047,2025-02,False,Other Computer Services,Design Tools,Design Tools
,2025-02-18,8400/000 : FNB,9.00 TWENTY.COM 4XX*5191 16 FEB XX6359 9.00 TWENTY.COM 4XXXXX*5191 16 FEB XXXXXXXXXXXXXXXXXXX6359,Account Payment,9.00 TWENTY.COM 4XX*5191 16 FEB XX6359 9.00 TWENTY.COM 4XXXXX*5191 16 FEB XXXXXXXXXXXXXXXXXXX6359,170.52,,5670667.55,AccountTransactionsReport(1).csv,2048,2025-02,False,Other Computer Services,Other Computer Services,Other Computer Services
,2025-02-18,8400/000 : FNB,"7.00 NPM, INC. 4XX*5191 16 FEB XX7722 7.00 NPM, INC. 4XXXXX*5191 16 FEB XXXXXXXXXXXXXXXXXXX7722",Account Payment,"7.00 NPM, INC. 4XX*5191 16 FEB XX7722 7.00 NPM, INC. 4XXXXX*5191 16 FEB XXXXXXXXXXXXXXXXXXX7722",132.63,,5670800.18,AccountTransactionsReport(1).csv,2049,2025-02,False,Other Computer Services,Other Computer Services,Other Computer Services
,2025-02-18,8400/000 : FNB,"7.00 NPM, INC. 4XX*5191 16 FEB XX2340 7.00 NPM, INC. 4XXXXX*5191 16 FEB XXXXXXXXXXXXXXXXXXX2340",Account Payment,"7.00 NPM, INC. 4XX*5191 16 FEB XX2340 7.00 NPM, INC. 4XXXXX*5191 16 FEB XXXXXXXXXXXXXXXXXXX2340",132.63,,5670932.81,AccountTransactionsReport(1).csv,2050,2025-02,False,Other Computer Services,Other Computer Services,Other Computer Services
,2025-02-18,8400/000 : FNB,7.00 CHATBASE 4XX*5191 17 FEB XX0705 7.00 CHATBASE 4XXXXX*5191 17 FEB XXXXXXXXXXXXXXXXXXX0705,Account Payment,7.00 CHATBASE 4XX*5191 17 FEB XX0705 7.00 CHATBASE 4XXXXX*5191 17 FEB XXXXXXXXXXXXXXXXXXX0705,132.63,,5671065.44,AccountTransactionsReport(1).csv,2051,2025-02,False,Other Computer Services,Other Computer Services,Other Computer Services
,2025-02-18,8400/000 : FNB,"7.00 NPM, INC. 4XX*5191 16 FEB XX9392 7.00 NPM, INC. 4XXXXX*5191 16 FEB XXXXXXXXXXXXXXXXXXX9392",Account Payment,"7.00 NPM, INC. 4XX*5191 16 FEB XX9392 7.00 NPM, INC. 4XXXXX*5191 16 FEB XXXXXXXXXXXXXXXXXXX9392",132.63,,5671198.07,AccountTransactionsReport(1).csv,2052,2025-02,False,Other Computer Services,Other Computer Services,Other Computer Services
,2025-02-18,8400/000 : FNB,"7.00 NPM, INC. 4XX*5191 16 FEB XX7784 7.00 NPM, INC. 4XXXXX*5191 16 FEB XXXXXXXXXXXXXXXXXXX7784",Account Payment,"7.00 NPM, INC. 4XX*5191 16 FEB XX7784 7.00 NPM, INC. 4XXXXX*5191 16 FEB XXXXXXXXXXXXXXXXXXX7784",132.63,,5671330.7,AccountTransactionsReport(1).csv,2053,2025-02,False,Other Computer Services,Other Computer Services,Other Computer Services
,2025-02-19,8400/000 : FNB,Hightail 15.00 HIGHTAIL 4XXXXX*5191 18 FEB XXXXXXXXXXXXXXXXXXX1779 Hightail,Account Payment,Hightail 15.00 HIGHTAIL 4XXXXX*5191 18 FEB XXXXXXXXXXXXXXXXXXX1779 Hightail,282.64,,5671613.34,AccountTransactionsReport(1).csv,2054,2025-02,False,Other Computer Services,Other Computer Services,Other Computer Services
,2025-02-19,8400/000 : FNB,15.00 TABNINE 4XX*5191 17 FEB XX2006 15.00 TABNINE 4XXXXX*5191 17 FEB XXXXXXXXXXXXXXXXXXX2006,Account Payment,15.00 TABNINE 4XX*5191 17 FEB XX2006 15.00 TABNINE 4XXXXX*5191 17 FEB XXXXXXXXXXXXXXXXXXX2006,284.2,,5671897.54,AccountTransactionsReport(1).csv,2055,2025-02,False,Other Computer Services,Other Computer Services,Other Computer Services
,2025-02-19,8400/000 : FNB,"99.00 PLAYFAB, INC. 4XX*5191 17 FEB XX5592 99.00 PLAYFAB, INC. 4XXXXX*5191 17 FEB XXXXXXXXXXXXXXXXXX",Account Payment,"99.00 PLAYFAB, INC. 4XX*5191 17 FEB XX5592 99.00 PLAYFAB, INC. 4XXXXX*5191 17 FEB XXXXXXXXXXXXXXXXX",1875.75,,5673773.29,AccountTransactionsReport(1).csv,2056,2025-02,False,Other Computer Services,Other Computer Services,Other Computer Services
,2025-02-20,8400/000 : FNB,99.00 DYNAMIC.XYZ 4XX*5191 19 FEB XX7688 99.00 DYNAMIC.XYZ 4XXXXX*5191 19 FEB XXXXXXXXXXXXXXXXXXX768,Account Payment,99.00 DYNAMIC.XYZ 4XX*5191 19 FEB XX7688 99.00 DYNAMIC.XYZ 4XXXXX*5191 19 FEB XXXXXXXXXXXXXXXXXXX76,1868.02,,5675641.31,AccountTransactionsReport(1).csv,2057,2025-02,False,Other Computer Services,Other Computer Services,Other Computer Services
,2025-02-20,8400/000 : FNB,"Github Inc. 70.65 GITHUB, INC. 4XXXXX*5191 18 FEB XXXXXXXXXXXXXXXXXXX0538 Github Inc.",Account Payment,"Github Inc. 70.65 GITHUB, INC. 4XXXXX*5191 18 FEB XXXXXXXXXXXXXXXXXXX0538 Github Inc.",1331.23,,5676972.54,AccountTransactionsReport(1).csv,2058,2025-02,False,Development Tools,Development Tools,Development Tools
,2025-02-20,8400/000 : FNB,"Github Inc. 42.00 GITHUB, INC. 4XXXXX*5191 18 FEB XXXXXXXXXXXXXXXXXXX8266 Github Inc.",Account Payment,"Github Inc. 42.00 GITHUB, INC. 4XXXXX*5191 18 FEB XXXXXXXXXXXXXXXXXXX8266 Github Inc.",791.39,,5677763.93,AccountTransactionsReport(1).csv,2059,2025-02,False,Development Tools,Development Tools,Development Tools
,2025-02-21,8400/000 : FNB,374.00 MANGOAPPS 4XX*5191 19 FEB XX2167 374.00 MANGOAPPS 4XXXXX*5191 19 FEB XXXXXXXXXXXXXXXXXXX2167,Account Payment,374.00 MANGOAPPS 4XX*5191 19 FEB XX2167 374.00 MANGOAPPS 4XXXXX*5191 19 FEB XXXXXXXXXXXXXXXXXXX2167,7056.95,,5684820.88,AccountTransactionsReport(1).csv,2060,2025-02,False,Other Computer Services,Other Computer Services,Other Computer Services
,2025-02-21,8400/000 : FNB,59.00 GREENBACK.COM 4XX*5225 19 FEB XX0465 59.00 GREENBACK.COM 4XXXXX*5225 19 FEB XXXXXXXXXXXXXXXXXX,Account Payment,59.00 GREENBACK.COM 4XX*5225 19 FEB XX0465 59.00 GREENBACK.COM 4XXXXX*5225 19 FEB XXXXXXXXXXXXXXXXX,1113.26,,5685934.14,AccountTransactionsReport(1).csv,2061,2025-02,False,Other Computer Services,Other Computer Services,Other Computer Services
,2025-02-22,8400/000 : FNB,115.00 OPENAI 4XX*5191 21 FEB XX5990 115.00 OPENAI 4XXXXX*5191 21 FEB XXXXXXXXXXXXXXXXXXX5990,Account Payment,115.00 OPENAI 4XX*5191 21 FEB XX5990 115.00 OPENAI 4XXXXX*5191 21 FEB XXXXXXXXXXXXXXXXXXX5990,2180.61,,5688114.75,AccountTransactionsReport(1).csv,2062,2025-02,False,AI Services,AI Services,AI Services
,2025-02-22,8400/000 : FNB,"74.00 PIPEDREAM, IN 4XX*5191 20 FEB XX7660 74.00 PIPEDREAM, IN 4XXXXX*5191 20 FEB XXXXXXXXXXXXXXXXXX",Account Payment,"74.00 PIPEDREAM, IN 4XX*5191 20 FEB XX7660 74.00 PIPEDREAM, IN 4XXXXX*5191 20 FEB XXXXXXXXXXXXXXXXX",1404.75,,5689519.5,AccountTransactionsReport(1).csv,2063,2025-02,False,Other Computer Services,Other Computer Services,Other Computer Services
,2025-02-22,8400/000 : FNB,54.00 AIRTABLE.COM/ 4XX*5191 21 FEB XX5639 54.00 AIRTABLE.COM/ 4XXXXX*5191 21 FEB XXXXXXXXXXXXXXXXXX,Account Payment,54.00 AIRTABLE.COM/ 4XX*5191 21 FEB XX5639 54.00 AIRTABLE.COM/ 4XXXXX*5191 21 FEB XXXXXXXXXXXXXXXXX,1023.94,,5690543.44,AccountTransactionsReport(1).csv,2064,2025-02,False,Other Computer Services,Collaboration Tools,Collaboration Tools
,2025-02-25,8400/000 : FNB,Google Service Charges/Fees #INT PYMT FEE-34.99 Googl Google,Account Payment,Google Service Charges/Fees INT PYMT FEE-34.99 Googl Google,0.7,,5690544.14,AccountTransactionsReport(1).csv,2065,2025-02,False,Other Computer Services,Analytics & Monitoring,Analytics & Monitoring
,2025-02-25,8400/000 : FNB,299.00 ORG CHART 4XX*5191 22 FEB XX6625 299.00 ORG CHART 4XXXXX*5191 22 FEB XXXXXXXXXXXXXXXXXXX6625,Account Payment,299.00 ORG CHART 4XX*5191 22 FEB XX6625 299.00 ORG CHART 4XXXXX*5191 22 FEB XXXXXXXXXXXXXXXXXXX6625,5626.87,,5696171.01,AccountTransactionsReport(1).csv,2066,2025-02,False,Other Computer Services,Other Computer Services,Other Computer Services
,2025-02-25,8400/000 : FNB,199.00 TINYACQUISIT 4XX*5191 23 FEB XX5789 199.00 TINYACQUISIT 4XXXXX*5191 23 FEB XXXXXXXXXXXXXXXXXX,Account Payment,199.00 TINYACQUISIT 4XX*5191 23 FEB XX5789 199.00 TINYACQUISIT 4XXXXX*5191 23 FEB XXXXXXXXXXXXXXXXX,3744.98,,5699915.99,AccountTransactionsReport(1).csv,2067,2025-02,False,Other Computer Services,Other Computer Services,Other Computer Services
,2025-02-25,8400/000 : FNB,103.83 OPENAI 4XX*5191 23 FEB XX5450 103.83 OPENAI 4XXXXX*5191 23 FEB XXXXXXXXXXXXXXXXXXX5450,Account Payment,103.83 OPENAI 4XX*5191 23 FEB XX5450 103.83 OPENAI 4XXXXX*5191 23 FEB XXXXXXXXXXXXXXXXXXX5450,1953.97,,5701869.96,AccountTransactionsReport(1).csv,2068,2025-02,False,AI Services,AI Services,AI Services
,2025-02-25,8400/000 : FNB,89.00 SENTRY 4XX*5191 24 FEB XX8551 89.00 SENTRY 4XXXXX*5191 24 FEB XXXXXXXXXXXXXXXXXXX8551,Account Payment,89.00 SENTRY 4XX*5191 24 FEB XX8551 89.00 SENTRY 4XXXXX*5191 24 FEB XXXXXXXXXXXXXXXXXXX8551,1674.89,,5703544.85,AccountTransactionsReport(1).csv,2069,2025-02,False,Other Computer Services,Analytics & Monitoring,Analytics & Monitoring
,2025-02-25,8400/000 : FNB,30.00 HASURA 4XX*5191 23 FEB XX5126 30.00 HASURA 4XXXXX*5191 23 FEB XXXXXXXXXXXXXXXXXXX5126,Account Payment,30.00 HASURA 4XX*5191 23 FEB XX5126 30.00 HASURA 4XXXXX*5191 23 FEB XXXXXXXXXXXXXXXXXXX5126,564.57,,5704109.42,AccountTransactionsReport(1).csv,2070,2025-02,False,Other Computer Services,Other Computer Services,Other Computer Services
,2025-02-25,8400/000 : FNB,"6.00 DOCKER, INC. 4XX*5191 24 FEB XX0151 6.00 DOCKER, INC. 4XXXXX*5191 24 FEB XXXXXXXXXXXXXXXXXXX015",Account Payment,"6.00 DOCKER, INC. 4XX*5191 24 FEB XX0151 6.00 DOCKER, INC. 4XXXXX*5191 24 FEB XXXXXXXXXXXXXXXXXXX01",112.91,,5704222.33,AccountTransactionsReport(1).csv,2071,2025-02,False,Other Computer Services,Other Computer Services,Other Computer Services
,2025-02-26,8400/000 : FNB,104.64 OPENAI 4XX*5191 24 FEB XX9793 104.64 OPENAI 4XXXXX*5191 24 FEB XXXXXXXXXXXXXXXXXXX9793,Account Payment,104.64 OPENAI 4XX*5191 24 FEB XX9793 104.64 OPENAI 4XXXXX*5191 24 FEB XXXXXXXXXXXXXXXXXXX9793,1969.44,,5706191.77,AccountTransactionsReport(1).csv,2072,2025-02,False,AI Services,AI Services,AI Services
,2025-02-26,8400/000 : FNB,104.52 OPENAI 4XX*5191 25 FEB XX9188 104.52 OPENAI 4XXXXX*5191 25 FEB XXXXXXXXXXXXXXXXXXX9188,Account Payment,104.52 OPENAI 4XX*5191 25 FEB XX9188 104.52 OPENAI 4XXXXX*5191 25 FEB XXXXXXXXXXXXXXXXXXX9188,1967.17,,5708158.94,AccountTransactionsReport(1).csv,2073,2025-02,False,AI Services,AI Services,AI Services
,2025-02-26,8400/000 : FNB,104.01 OPENAI 4XX*5191 24 FEB XX5427 104.01 OPENAI 4XXXXX*5191 24 FEB XXXXXXXXXXXXXXXXXXX5427,Account Payment,104.01 OPENAI 4XX*5191 24 FEB XX5427 104.01 OPENAI 4XXXXX*5191 24 FEB XXXXXXXXXXXXXXXXXXX5427,1957.36,,5710116.3,AccountTransactionsReport(1).csv,2074,2025-02,False,AI Services,AI Services,AI Services
,2025-02-26,8400/000 : FNB,18.38 DROPBOX*R4CGK 4XX*5191 24 FEB XX0671 18.38 DROPBOX*R4CGK 4XXXXX*5191 24 FEB XXXXXXXXXXXXXXXXXX,Account Payment,18.38 DROPBOX*R4CGK 4XX*5191 24 FEB XX0671 18.38 DROPBOX*R4CGK 4XXXXX*5191 24 FEB XXXXXXXXXXXXXXXXX,345.89,,5710462.19,AccountTransactionsReport(1).csv,2075,2025-02,False,Other Computer Services,Other Computer Services,Other Computer Services
,2025-02-26,8400/000 : FNB,10.00 MATTERMOST 4XX*5191 24 FEB XX0203 10.00 MATTERMOST 4XXXXX*5191 24 FEB XXXXXXXXXXXXXXXXXXX0203,Account Payment,10.00 MATTERMOST 4XX*5191 24 FEB XX0203 10.00 MATTERMOST 4XXXXX*5191 24 FEB XXXXXXXXXXXXXXXXXXX0203,188.19,,5710650.38,AccountTransactionsReport(1).csv,2076,2025-02,False,Other Computer Services,Other Computer Services,Other Computer Services
,2025-02-27,8400/000 : FNB,150.00 AUTH0.COM 4XX*5191 25 FEB XX3696 150.00 AUTH0.COM 4XXXXX*5191 25 FEB XXXXXXXXXXXXXXXXXXX3696,Account Payment,150.00 AUTH0.COM 4XX*5191 25 FEB XX3696 150.00 AUTH0.COM 4XXXXX*5191 25 FEB XXXXXXXXXXXXXXXXXXX3696,2827.26,,5713477.64,AccountTransactionsReport(1).csv,2077,2025-02,False,Security Services,Security Services,Security Services
,2025-02-27,8400/000 : FNB,103.74 OPENAI 4XX*5191 25 FEB XX5538 103.74 OPENAI 4XXXXX*5191 25 FEB XXXXXXXXXXXXXXXXXXX5538,Account Payment,103.74 OPENAI 4XX*5191 25 FEB XX5538 103.74 OPENAI 4XXXXX*5191 25 FEB XXXXXXXXXXXXXXXXXXX5538,1952.49,,5715430.13,AccountTransactionsReport(1).csv,2078,2025-02,False,AI Services,AI Services,AI Services
,2025-02-27,8400/000 : FNB,103.58 OPENAI 4XX*5191 25 FEB XX2987 103.58 OPENAI 4XXXXX*5191 25 FEB XXXXXXXXXXXXXXXXXXX2987,Account Payment,103.58 OPENAI 4XX*5191 25 FEB XX2987 103.58 OPENAI 4XXXXX*5191 25 FEB XXXXXXXXXXXXXXXXXXX2987,1949.49,,5717379.62,AccountTransactionsReport(1).csv,2079,2025-02,False,AI Services,AI Services,AI Services
,2025-02-28,8400/000 : FNB,50.00 OBSIDIAN.MD 4XX*5191 27 FEB XX8958 50.00 OBSIDIAN.MD 4XXXXX*5191 27 FEB XXXXXXXXXXXXXXXXXXX895,Account Payment,50.00 OBSIDIAN.MD 4XX*5191 27 FEB XX8958 50.00 OBSIDIAN.MD 4XXXXX*5191 27 FEB XXXXXXXXXXXXXXXXXXX89,942.14,,5718321.76,AccountTransactionsReport(1).csv,2080,2025-02,False,Other Computer Services,Other Computer Services,Other Computer Services
3300/020 : Computer - Platforms,Closing Balance as at: 28/02/2025,,,,,5718321.76,,,AccountTransactionsReport(1).csv,2081,Unknown,False,Other Computer Services,Other Computer Services,Other Computer Services
,Movement for the period,,,,,5718321.76,,,AccountTransactionsReport(1).csv,2082,Unknown,False,Other Computer Services,Other Computer Services,Other Computer Services
,2023-03-28,STOCK2SHOP (PTY) LTD,WWI30902,Supplier Invoice,3300/020 : Computer - Platforms - Stock2shop,2219.0,,2219.0,AccountTransactionsReport(2).csv,2083,2023-03,False,E-commerce Platforms,E-commerce Platforms,E-commerce Platforms
,2023-04-28,STOCK2SHOP (PTY) LTD,WWI30937,Supplier Invoice,3300/020 : Computer - Platforms Stock2shop,2219.0,,4438.0,AccountTransactionsReport(2).csv,2084,2023-04,False,E-commerce Platforms,E-commerce Platforms,E-commerce Platforms
,2023-05-28,STOCK2SHOP (PTY) LTD,WWI30972,Supplier Invoice,3300/020 : Computer - Platforms,2219.0,,6657.0,AccountTransactionsReport(2).csv,2085,2023-05,False,E-commerce Platforms,E-commerce Platforms,E-commerce Platforms
,2023-06-01,REZONANCE (PTY) LTD,WWI31033,Supplier Invoice,3300/020 : Computer - Platforms,51740.36,,58397.36,AccountTransactionsReport(2).csv,2086,2023-06,False,Other Computer Services,Other Computer Services,Other Computer Services
,2023-06-01,REZONANCE (PTY) LTD,WWI31034,Supplier Invoice,3300/020 : Computer - Platforms,65148.6,,123545.96,AccountTransactionsReport(2).csv,2087,2023-06,False,Other Computer Services,Other Computer Services,Other Computer Services
,2023-06-01,REZONANCE (PTY) LTD,WWI31035,Supplier Invoice,3300/020 : Computer - Platforms,74196.41,,197742.37,AccountTransactionsReport(2).csv,2088,2023-06,False,Other Computer Services,Other Computer Services,Other Computer Services
,2023-06-01,REZONANCE (PTY) LTD,WWI31036,Supplier Invoice,3300/020 : Computer - Platforms,67384.66,,265127.03,AccountTransactionsReport(2).csv,2089,2023-06,False,Other Computer Services,Other Computer Services,Other Computer Services
,2023-06-28,STOCK2SHOP (PTY) LTD,WWI31008,Supplier Invoice,3300/020 : Computer - Platforms - Stock2shop,2219.0,,267346.03,AccountTransactionsReport(2).csv,2090,2023-06,False,E-commerce Platforms,E-commerce Platforms,E-commerce Platforms
,2023-07-28,STOCK2SHOP (PTY) LTD,WWI31044,Supplier Invoice,3300/020 : Computer - Platforms,2219.0,,269565.03,AccountTransactionsReport(2).csv,2091,2023-07,False,E-commerce Platforms,E-commerce Platforms,E-commerce Platforms
,2023-08-05,8400/000 : FNB,26.44 GSUITE_regima 4XXXXX*5225 03 AUG XXXXXXXXXXXXXXXXXXX4944,Account Payment,26.44 GSUITE_regima 4XXXXX*5225 03 AUG XXXXXXXXXXXXXXXXXXX4944,501.65,,270066.68,AccountTransactionsReport(2).csv,2092,2023-08,False,Other Computer Services,Other Computer Services,Other Computer Services
,2023-08-10,8400/000 : FNB,GoDaddy 113.85 DNH*GODADDY. 4XXXXX*5225 07 AUG XXXXXXXXXXXXXXXXXXX0664 GoDaddy,Account Payment,GoDaddy 113.85 DNH*GODADDY. 4XXXXX*5225 07 AUG XXXXXXXXXXXXXXXXXXX0664 GoDaddy,113.85,,270180.53,AccountTransactionsReport(2).csv,2093,2023-08,False,Domain & Hosting,Domain & Hosting,Domain & Hosting
,2023-08-10,8400/000 : FNB,3.60 GETADDRESS.IO 4XXXXX*5225 07 AUG XXXXXXXXXXXXXXXXXXX5193,Account Payment,3.60 GETADDRESS.IO 4XXXXX*5225 07 AUG XXXXXXXXXXXXXXXXXXX5193,87.83,,270268.36,AccountTransactionsReport(2).csv,2094,2023-08,False,Other Computer Services,Other Computer Services,Other Computer Services
,2023-08-15,8400/000 : FNB,"GitHub 63.00 GITHUB, INC. 4XXXXX*5225 13 AUG XXXXXXXXXXXXXXXXXXX8999 GitHub",Account Payment,"GitHub 63.00 GITHUB, INC. 4XXXXX*5225 13 AUG XXXXXXXXXXXXXXXXXXX8999 GitHub",1220.72,,271489.08,AccountTransactionsReport(2).csv,2095,2023-08,False,Development Tools,Development Tools,Development Tools
,2023-08-15,8400/000 : FNB,"GitHub 46.95 GITHUB, INC. 4XXXXX*5225 13 AUG XXXXXXXXXXXXXXXXXXX5267 GitHub",Account Payment,"GitHub 46.95 GITHUB, INC. 4XXXXX*5225 13 AUG XXXXXXXXXXXXXXXXXXX5267 GitHub",909.73,,272398.81,AccountTransactionsReport(2).csv,2096,2023-08,False,Development Tools,Development Tools,Development Tools
,2023-08-15,8400/000 : FNB,"GitHub 42.00 GITHUB, INC. 4XXXXX*5225 13 AUG XXXXXXXXXXXXXXXXXXX0916 GitHub",Account Payment,"GitHub 42.00 GITHUB, INC. 4XXXXX*5225 13 AUG XXXXXXXXXXXXXXXXXXX0916 GitHub",813.81,,273212.62,AccountTransactionsReport(2).csv,2097,2023-08,False,Development Tools,Development Tools,Development Tools
,2023-08-15,8400/000 : FNB,"GitHub 42.00 GITHUB, INC. 4XXXXX*5225 13 AUG XXXXXXXXXXXXXXXXXXX5521 GitHub",Account Payment,"GitHub 42.00 GITHUB, INC. 4XXXXX*5225 13 AUG XXXXXXXXXXXXXXXXXXX5521 GitHub",813.81,,274026.43,AccountTransactionsReport(2).csv,2098,2023-08,False,Development Tools,Development Tools,Development Tools
,2023-08-16,8400/000 : FNB,"GitHub 4.00 GITHUB, INC. 4XXXXX*5225 14 AUG XXXXXXXXXXXXXXXXXXX1767 GitHub",Account Payment,"GitHub 4.00 GITHUB, INC. 4XXXXX*5225 14 AUG XXXXXXXXXXXXXXXXXXX1767 GitHub",77.51,,274103.94,AccountTransactionsReport(2).csv,2099,2023-08,False,Development Tools,Development Tools,Development Tools
,2023-08-16,8400/000 : FNB,GoDaddy 3317.82 DNH*GODADDY 4XXXXX*5225 14 AUG XXXXXXXXXXXXXXXXXXX0791 GoDaddy,Account Payment,GoDaddy 3317.82 DNH*GODADDY 4XXXXX*5225 14 AUG XXXXXXXXXXXXXXXXXXX0791 GoDaddy,3317.82,,277421.76,AccountTransactionsReport(2).csv,2100,2023-08,False,Domain & Hosting,Domain & Hosting,Domain & Hosting
,2023-08-16,8400/000 : FNB,Bob Go 4XXXXX*5225 12 AUG XXXXXXXXXXXXXXXXXXX5635,Account Payment,Bob Go 4XXXXX*5225 12 AUG XXXXXXXXXXXXXXXXXXX5635,1483.13,,278904.89,AccountTransactionsReport(2).csv,2101,2023-08,False,Other Computer Services,Other Computer Services,Other Computer Services
,2023-08-17,8400/000 : FNB,"GitHub 113.81 GITHUB, INC. 4XXXXX*5225 15 AUG XXXXXXXXXXXXXXXXXXX8985 GitHub",Account Payment,"GitHub 113.81 GITHUB, INC. 4XXXXX*5225 15 AUG XXXXXXXXXXXXXXXXXXX8985 GitHub",2225.53,,281130.42,AccountTransactionsReport(2).csv,2102,2023-08,False,Development Tools,Development Tools,Development Tools
,2023-08-17,8400/000 : FNB,53.96 SLACK T0MN3D5 4XXXXX*5225 15 AUG XXXXXXXXXXXXXXXXXXX3499,Account Payment,53.96 SLACK T0MN3D5 4XXXXX*5225 15 AUG XXXXXXXXXXXXXXXXXXX3499,1055.18,,282185.6,AccountTransactionsReport(2).csv,2103,2023-08,False,Communication,Communication,Communication
,2023-08-18,8400/000 : FNB,GoDaddy 3664.31 DNH*GODADDY 4XXXXX*5225 16 AUG XXXXXXXXXXXXXXXXXXX0445 GoDaddy,Account Payment,GoDaddy 3664.31 DNH*GODADDY 4XXXXX*5225 16 AUG XXXXXXXXXXXXXXXXXXX0445 GoDaddy,3664.31,,285849.91,AccountTransactionsReport(2).csv,2104,2023-08,False,Domain & Hosting,Domain & Hosting,Domain & Hosting
,2023-08-18,8400/000 : FNB,GoDaddy 662.40 DNH*GODADDY. 4XXXXX*5225 16 AUG XXXXXXXXXXXXXXXXXXX2107 GoDaddy,Account Payment,GoDaddy 662.40 DNH*GODADDY. 4XXXXX*5225 16 AUG XXXXXXXXXXXXXXXXXXX2107 GoDaddy,662.4,,286512.31,AccountTransactionsReport(2).csv,2105,2023-08,False,Domain & Hosting,Domain & Hosting,Domain & Hosting
,2023-08-18,8400/000 : FNB,12.63 Google GSUITE 4XXXXX*5225 17 AUG XXXXXXXXXXXXXXXXXXX5855,Account Payment,12.63 Google GSUITE 4XXXXX*5225 17 AUG XXXXXXXXXXXXXXXXXXX5855,270.03,,286782.34,AccountTransactionsReport(2).csv,2106,2023-08,False,Other Computer Services,Analytics & Monitoring,Analytics & Monitoring
,2023-08-18,8400/000 : FNB,8.62 Google GSUITE_ 4XXXXX*5225 17 AUG XXXXXXXXXXXXXXXXXXX5850,Account Payment,8.62 Google GSUITE_ 4XXXXX*5225 17 AUG XXXXXXXXXXXXXXXXXXX5850,184.29,,286966.63,AccountTransactionsReport(2).csv,2107,2023-08,False,Other Computer Services,Analytics & Monitoring,Analytics & Monitoring
,2023-08-19,8400/000 : FNB,GoDaddy 5535.59 DNH*GODADDY 4XXXXX*5225 17 AUG XXXXXXXXXXXXXXXXXXX1866 GoDaddy,Account Payment,GoDaddy 5535.59 DNH*GODADDY 4XXXXX*5225 17 AUG XXXXXXXXXXXXXXXXXXX1866 GoDaddy,5535.59,,292502.22,AccountTransactionsReport(2).csv,2108,2023-08,False,Domain & Hosting,Domain & Hosting,Domain & Hosting
,2023-08-19,8400/000 : FNB,4.31 GOOGLE*GSUITE 4XXXXX*5225 17 AUG XXXXXXXXXXXXXXXXXXX2206,Account Payment,4.31 GOOGLE*GSUITE 4XXXXX*5225 17 AUG XXXXXXXXXXXXXXXXXXX2206,92.15,,292594.37,AccountTransactionsReport(2).csv,2109,2023-08,False,Other Computer Services,Analytics & Monitoring,Analytics & Monitoring
,2023-08-21,8400/000 : FNB,GoDaddy 2317.58 DNH*GODADDY 4XXXXX*5225 18 AUG XXXXXXXXXXXXXXXXXXX1344 GoDaddy,Account Payment,GoDaddy 2317.58 DNH*GODADDY 4XXXXX*5225 18 AUG XXXXXXXXXXXXXXXXXXX1344 GoDaddy,2317.58,,294911.95,AccountTransactionsReport(2).csv,2110,2023-08,False,Domain & Hosting,Domain & Hosting,Domain & Hosting
,2023-08-22,8400/000 : FNB,Shopify 74.75 SHOPIFY* 1921 4XXXXX*5225 19 AUG XXXXXXXXXXXXXXXXXXX0740 Shopify,Account Payment,Shopify 74.75 SHOPIFY* 1921 4XXXXX*5225 19 AUG XXXXXXXXXXXXXXXXXXX0740 Shopify,1461.11,,296373.06,AccountTransactionsReport(2).csv,2111,2023-08,False,E-commerce Platforms,E-commerce Platforms,E-commerce Platforms
,2023-08-22,8400/000 : FNB,59.00 GREENBACK.COM 4XXXXX*5225 19 AUG XXXXXXXXXXXXXXXXXXX3058,Account Payment,59.00 GREENBACK.COM 4XXXXX*5225 19 AUG XXXXXXXXXXXXXXXXXXX3058,1153.25,,297526.31,AccountTransactionsReport(2).csv,2112,2023-08,False,Other Computer Services,Other Computer Services,Other Computer Services
,2023-08-22,8400/000 : FNB,"20.00 REPLIT, INC. 4XXXXX*5225 20 AUG XXXXXXXXXXXXXXXXXXX3324",Account Payment,"20.00 REPLIT, INC. 4XXXXX*5225 20 AUG XXXXXXXXXXXXXXXXXXX3324",390.94,,297917.25,AccountTransactionsReport(2).csv,2113,2023-08,False,Other Computer Services,Other Computer Services,Other Computer Services
,2023-08-22,8400/000 : FNB,Shopify 18.40 SHOPIFY* 1921 4XXXXX*5225 19 AUG XXXXXXXXXXXXXXXXXXX0946 Shopify,Account Payment,Shopify 18.40 SHOPIFY* 1921 4XXXXX*5225 19 AUG XXXXXXXXXXXXXXXXXXX0946 Shopify,359.66,,298276.91,AccountTransactionsReport(2).csv,2114,2023-08,False,E-commerce Platforms,E-commerce Platforms,E-commerce Platforms
,2023-08-22,8400/000 : FNB,Shopify 17.25 SHOPIFY* 1921 4XXXXX*5225 19 AUG XXXXXXXXXXXXXXXXXXX1292 Shopify,Account Payment,Shopify 17.25 SHOPIFY* 1921 4XXXXX*5225 19 AUG XXXXXXXXXXXXXXXXXXX1292 Shopify,337.18,,298614.09,AccountTransactionsReport(2).csv,2115,2023-08,False,E-commerce Platforms,E-commerce Platforms,E-commerce Platforms
,2023-08-22,8400/000 : FNB,Shopify 17.25 SHOPIFY* 1921 4XXXXX*5225 19 AUG XXXXXXXXXXXXXXXXXXX1092 Shopify,Account Payment,Shopify 17.25 SHOPIFY* 1921 4XXXXX*5225 19 AUG XXXXXXXXXXXXXXXXXXX1092 Shopify,337.18,,298951.27,AccountTransactionsReport(2).csv,2116,2023-08,False,E-commerce Platforms,E-commerce Platforms,E-commerce Platforms
,2023-08-22,8400/000 : FNB,Shopify 17.25 SHOPIFY* 1921 4XXXXX*5225 19 AUG XXXXXXXXXXXXXXXXXXX1076 Shopify,Account Payment,Shopify 17.25 SHOPIFY* 1921 4XXXXX*5225 19 AUG XXXXXXXXXXXXXXXXXXX1076 Shopify,337.18,,299288.45,AccountTransactionsReport(2).csv,2117,2023-08,False,E-commerce Platforms,E-commerce Platforms,E-commerce Platforms
,2023-08-22,8400/000 : FNB,"1.50 REPLIT, INC. 4XXXXX*5225 20 AUG XXXXXXXXXXXXXXXXXXX0324",Account Payment,"1.50 REPLIT, INC. 4XXXXX*5225 20 AUG XXXXXXXXXXXXXXXXXXX0324",29.33,,299317.78,AccountTransactionsReport(2).csv,2118,2023-08,False,Other Computer Services,Other Computer Services,Other Computer Services
,2023-08-23,8400/000 : FNB,X0529.26 DNH*GODADD 4XXXXX*5225 21 AUG XXXXXXXXXXXXXXXXXXX4317,Account Payment,X0529.26 DNH*GODADD 4XXXXX*5225 21 AUG XXXXXXXXXXXXXXXXXXX4317,10529.26,,309847.04,AccountTransactionsReport(2).csv,2119,2023-08,False,Other Computer Services,Other Computer Services,Other Computer Services
,2023-08-24,8400/000 : FNB,GoDaddy 2368.01 DNH*GODADDY 4XXXXX*5225 22 AUG XXXXXXXXXXXXXXXXXXX0694 GoDaddy,Account Payment,GoDaddy 2368.01 DNH*GODADDY 4XXXXX*5225 22 AUG XXXXXXXXXXXXXXXXXXX0694 GoDaddy,2368.01,,312215.05,AccountTransactionsReport(2).csv,2120,2023-08,False,Domain & Hosting,Domain & Hosting,Domain & Hosting
,2023-08-24,8400/000 : FNB,GoDaddy 1322.30 DNH*GODADDY 4XXXXX*5225 22 AUG XXXXXXXXXXXXXXXXXXX0561 GoDaddy,Account Payment,GoDaddy 1322.30 DNH*GODADDY 4XXXXX*5225 22 AUG XXXXXXXXXXXXXXXXXXX0561 GoDaddy,1322.3,,313537.35,AccountTransactionsReport(2).csv,2121,2023-08,False,Domain & Hosting,Domain & Hosting,Domain & Hosting
,2023-08-25,8400/000 : FNB,GoDaddy 392.14 DNH*GODADDY. 4XXXXX*5225 23 AUG XXXXXXXXXXXXXXXXXXX0454 GoDaddy,Account Payment,GoDaddy 392.14 DNH*GODADDY. 4XXXXX*5225 23 AUG XXXXXXXXXXXXXXXXXXX0454 GoDaddy,392.14,,313929.49,AccountTransactionsReport(2).csv,2122,2023-08,False,Domain & Hosting,Domain & Hosting,Domain & Hosting
,2023-08-25,8400/000 : FNB,"10.00 REPLIT, INC. 4XXXXX*5225 23 AUG XXXXXXXXXXXXXXXXXXX0625",Account Payment,"10.00 REPLIT, INC. 4XXXXX*5225 23 AUG XXXXXXXXXXXXXXXXXXX0625",193.87,,314123.36,AccountTransactionsReport(2).csv,2123,2023-08,False,Other Computer Services,Other Computer Services,Other Computer Services
,2023-08-26,8400/000 : FNB,376.40 HOLASPIRIT 4XXXXX*5225 25 AUG XXXXXXXXXXXXXXXXXXX8114,Account Payment,376.40 HOLASPIRIT 4XXXXX*5225 25 AUG XXXXXXXXXXXXXXXXXXX8114,7818.94,,321942.3,AccountTransactionsReport(2).csv,2124,2023-08,False,Other Computer Services,Other Computer Services,Other Computer Services
,2023-08-26,8400/000 : FNB,207.00 FIGMA 4XXXXX*5225 24 AUG XXXXXXXXXXXXXXXXXXX6482,Account Payment,207.00 FIGMA 4XXXXX*5225 24 AUG XXXXXXXXXXXXXXXXXXX6482,3979.73,,325922.03,AccountTransactionsReport(2).csv,2125,2023-08,False,Other Computer Services,Design Tools,Design Tools
,2023-08-26,8400/000 : FNB,"GitHub 155.98 GITHUB, INC. 4XXXXX*5225 24 AUG XXXXXXXXXXXXXXXXXXX3715 GitHub",Account Payment,"GitHub 155.98 GITHUB, INC. 4XXXXX*5225 24 AUG XXXXXXXXXXXXXXXXXXX3715 GitHub",2998.83,,328920.86,AccountTransactionsReport(2).csv,2126,2023-08,False,Development Tools,Development Tools,Development Tools
,2023-08-26,8400/000 : FNB,GoDaddy 254.40 DNH*GODADDY. 4XXXXX*5225 24 AUG XXXXXXXXXXXXXXXXXXX2373 GoDaddy,Account Payment,GoDaddy 254.40 DNH*GODADDY. 4XXXXX*5225 24 AUG XXXXXXXXXXXXXXXXXXX2373 GoDaddy,254.4,,329175.26,AccountTransactionsReport(2).csv,2127,2023-08,False,Domain & Hosting,Domain & Hosting,Domain & Hosting
,2023-08-28,8400/000 : FNB,Intuit 546.25 INTUIT *QBoo 4XXXXX*5225 25 AUG XXXXXXXXXXXXXXXXXXX3207 Intuit,Account Payment,Intuit 546.25 INTUIT *QBoo 4XXXXX*5225 25 AUG XXXXXXXXXXXXXXXXXXX3207 Intuit,546.25,,329721.51,AccountTransactionsReport(2).csv,2128,2023-08,False,Productivity Software,Productivity Software,Productivity Software
,2023-08-28,STOCK2SHOP (PTY) LTD,WWI31078,Supplier Invoice,STOCK2SHOP,2219.0,,331940.51,AccountTransactionsReport(2).csv,2129,2023-08,False,E-commerce Platforms,E-commerce Platforms,E-commerce Platforms
,2023-08-29,8400/000 : FNB,GoDaddy 386.30 DNH*GODADDY. 4XXXXX*5225 27 AUG XXXXXXXXXXXXXXXXXXX0230 GoDaddy,Account Payment,GoDaddy 386.30 DNH*GODADDY. 4XXXXX*5225 27 AUG XXXXXXXXXXXXXXXXXXX0230 GoDaddy,386.3,,332326.81,AccountTransactionsReport(2).csv,2130,2023-08,False,Domain & Hosting,Domain & Hosting,Domain & Hosting
,2023-08-29,8400/000 : FNB,GoDaddy 74.75 DNH*GODADDY.C 4XXXXX*5225 26 AUG XXXXXXXXXXXXXXXXXXX0977 GoDaddy,Account Payment,GoDaddy 74.75 DNH*GODADDY.C 4XXXXX*5225 26 AUG XXXXXXXXXXXXXXXXXXX0977 GoDaddy,74.75,,332401.56,AccountTransactionsReport(2).csv,2131,2023-08,False,Domain & Hosting,Domain & Hosting,Domain & Hosting
,2023-08-29,8400/000 : FNB,GoDaddy 1780.20 DNH*GODADDY 4XXXXX*5225 27 AUG XXXXXXXXXXXXXXXXXXX0125 GoDaddy,Account Payment,GoDaddy 1780.20 DNH*GODADDY 4XXXXX*5225 27 AUG XXXXXXXXXXXXXXXXXXX0125 GoDaddy,1780.2,,334181.76,AccountTransactionsReport(2).csv,2132,2023-08,False,Domain & Hosting,Domain & Hosting,Domain & Hosting
,2023-08-29,8400/000 : FNB,99.00 MIOSALON.COM( 4XXXXX*5225 27 AUG XXXXXXXXXXXXXXXXXXX8432,Account Payment,99.00 MIOSALON.COM( 4XXXXX*5225 27 AUG XXXXXXXXXXXXXXXXXXX8432,1909.15,,336090.91,AccountTransactionsReport(2).csv,2133,2023-08,False,Other Computer Services,Other Computer Services,Other Computer Services
,2023-08-29,8400/000 : FNB,99.00 MIOSALON.COM( 4XXXXX*5225 27 AUG XXXXXXXXXXXXXXXXXXX5468,Account Payment,99.00 MIOSALON.COM( 4XXXXX*5225 27 AUG XXXXXXXXXXXXXXXXXXX5468,1909.15,,338000.06,AccountTransactionsReport(2).csv,2134,2023-08,False,Other Computer Services,Other Computer Services,Other Computer Services
,2023-08-30,8400/000 : FNB,GoDaddy 428.18 DNH*GODADDY. 4XXXXX*5225 28 AUG XXXXXXXXXXXXXXXXXXX0843 GoDaddy,Account Payment,GoDaddy 428.18 DNH*GODADDY. 4XXXXX*5225 28 AUG XXXXXXXXXXXXXXXXXXX0843 GoDaddy,428.18,,338428.24,AccountTransactionsReport(2).csv,2135,2023-08,False,Domain & Hosting,Domain & Hosting,Domain & Hosting
,2023-08-31,8400/000 : FNB,5050.80 FRESHWORKS 4XXXXX*5225 29 AUG XXXXXXXXXXXXXXXXXXX9920,Account Payment,5050.80 FRESHWORKS 4XXXXX*5225 29 AUG XXXXXXXXXXXXXXXXXXX9920,5050.8,,343479.04,AccountTransactionsReport(2).csv,2136,2023-08,False,Productivity Software,Productivity Software,Productivity Software
,2023-08-31,8400/000 : FNB,Canva 109.99 CANVA* I0389 4XXXXX*5225 30 AUG XXXXXXXXXXXXXXXXXXX6924 Canva,Account Payment,Canva 109.99 CANVA* I0389 4XXXXX*5225 30 AUG XXXXXXXXXXXXXXXXXXX6924 Canva,109.99,,343589.03,AccountTransactionsReport(2).csv,2137,2023-08,False,Other Computer Services,Design Tools,Design Tools
,2023-09-04,8400/000 : FNB,246.80 GSUITE_regim 4XXXXX*5225 01 SEP XXXXXXXXXXXXXXXXXXX4947,Account Payment,246.80 GSUITE_regim 4XXXXX*5225 01 SEP XXXXXXXXXXXXXXXXXXX4947,4770.3,,348359.33,AccountTransactionsReport(2).csv,2138,2023-09,False,Other Computer Services,Other Computer Services,Other Computer Services
,2023-09-04,8400/000 : FNB,GOOGLE*GSUITE RZO. 4XXXXX*5225 01 SEP XXXXXXXXXXXXXXXXXXX6004,Account Payment,GOOGLE*GSUITE RZO. 4XXXXX*5225 01 SEP XXXXXXXXXXXXXXXXXXX6004,0.63,,348359.96,AccountTransactionsReport(2).csv,2139,2023-09,False,Other Computer Services,Analytics & Monitoring,Analytics & Monitoring
,2023-09-04,8400/000 : FNB,Canva 335.33 CANVA* I0389 4XXXXX*5225 01 SEP XXXXXXXXXXXXXXXXXXX1359 Canva,Account Payment,Canva 335.33 CANVA* I0389 4XXXXX*5225 01 SEP XXXXXXXXXXXXXXXXXXX1359 Canva,335.33,,348695.29,AccountTransactionsReport(2).csv,2140,2023-09,False,Other Computer Services,Design Tools,Design Tools
,2023-09-04,8400/000 : FNB,16.24 Google GSUITE 4XXXXX*5225 01 SEP XXXXXXXXXXXXXXXXXXX5851,Account Payment,16.24 Google GSUITE 4XXXXX*5225 01 SEP XXXXXXXXXXXXXXXXXXX5851,340.6,,349035.89,AccountTransactionsReport(2).csv,2141,2023-09,False,Other Computer Services,Analytics & Monitoring,Analytics & Monitoring
,2023-09-06,8400/000 : FNB,1499.00 APPDIRECT 4XXXXX*5225 04 SEP XXXXXXXXXXXXXXXXXXX1968,Account Payment,1499.00 APPDIRECT 4XXXXX*5225 04 SEP XXXXXXXXXXXXXXXXXXX1968,28914.37,,377950.26,AccountTransactionsReport(2).csv,2142,2023-09,False,Other Computer Services,Other Computer Services,Other Computer Services
,2023-09-06,8400/000 : FNB,Netcash Pty Ltd 4XXXXX*5225 02 SEP XXXXXXXXXXXXXXXXXXX9833,Account Payment,Netcash Pty Ltd 4XXXXX*5225 02 SEP XXXXXXXXXXXXXXXXXXX9833,2750.0,,380700.26,AccountTransactionsReport(2).csv,2143,2023-09,False,Other Computer Services,Other Computer Services,Other Computer Services
,2023-09-06,8400/000 : FNB,ManageWP 120.75 MANAGEWP 4XXXXX*5225 05 SEP XXXXXXXXXXXXXXXXXXX4976 ManageWP,Account Payment,ManageWP 120.75 MANAGEWP 4XXXXX*5225 05 SEP XXXXXXXXXXXXXXXXXXX4976 ManageWP,2359.67,,383059.93,AccountTransactionsReport(2).csv,2144,2023-09,False,Other Computer Services,Other Computer Services,Other Computer Services
,2023-09-06,8400/000 : FNB,"GitHub 19.61 GITHUB, INC. 4XXXXX*5225 04 SEP XXXXXXXXXXXXXXXXXXX9953 GitHub",Account Payment,"GitHub 19.61 GITHUB, INC. 4XXXXX*5225 04 SEP XXXXXXXXXXXXXXXXXXX9953 GitHub",378.26,,383438.19,AccountTransactionsReport(2).csv,2145,2023-09,False,Development Tools,Development Tools,Development Tools
,2023-09-06,8400/000 : FNB,"GitHub 7.54 GITHUB, INC. 4XXXXX*5225 04 SEP XXXXXXXXXXXXXXXXXXX7920 GitHub",Account Payment,"GitHub 7.54 GITHUB, INC. 4XXXXX*5225 04 SEP XXXXXXXXXXXXXXXXXXX7920 GitHub",145.44,,383583.63,AccountTransactionsReport(2).csv,2146,2023-09,False,Development Tools,Development Tools,Development Tools
,2023-09-07,8400/000 : FNB,3768.62 PAYPAL *NEX 4XXXXX*5225 05 SEP XXXXXXXXXXXXXXXXXXX3747,Account Payment,3768.62 PAYPAL *NEX 4XXXXX*5225 05 SEP XXXXXXXXXXXXXXXXXXX3747,3768.62,,387352.25,AccountTransactionsReport(2).csv,2147,2023-09,False,Payment Processing,Payment Processing,Payment Processing
,2023-09-07,8400/000 : FNB,ManageWP 181.13 MANAGEWP 4XXXXX*5225 06 SEP XXXXXXXXXXXXXXXXXXX4607 ManageWP,Account Payment,ManageWP 181.13 MANAGEWP 4XXXXX*5225 06 SEP XXXXXXXXXXXXXXXXXXX4607 ManageWP,3563.95,,390916.2,AccountTransactionsReport(2).csv,2148,2023-09,False,Other Computer Services,Other Computer Services,Other Computer Services
,2023-09-08,8400/000 : FNB,20.00 VERCEL PRO 4XXXXX*5225 07 SEP XXXXXXXXXXXXXXXXXXX4680,Account Payment,20.00 VERCEL PRO 4XXXXX*5225 07 SEP XXXXXXXXXXXXXXXXXXX4680,394.73,,391310.93,AccountTransactionsReport(2).csv,2149,2023-09,False,Cloud Services,Cloud Services,Cloud Services
,2023-09-08,8400/000 : FNB,20.00 VERCEL PRO 4XXXXX*5225 07 SEP XXXXXXXXXXXXXXXXXXX9465,Account Payment,20.00 VERCEL PRO 4XXXXX*5225 07 SEP XXXXXXXXXXXXXXXXXXX9465,394.73,,391705.66,AccountTransactionsReport(2).csv,2150,2023-09,False,Cloud Services,Cloud Services,Cloud Services
,2023-09-09,8400/000 : FNB,Intuit 546.25 INTUIT *QBoo 4XXXXX*5225 07 SEP XXXXXXXXXXXXXXXXXXX8360 Intuit,Account Payment,Intuit 546.25 INTUIT *QBoo 4XXXXX*5225 07 SEP XXXXXXXXXXXXXXXXXXX8360 Intuit,546.25,,392251.91,AccountTransactionsReport(2).csv,2151,2023-09,False,Productivity Software,Productivity Software,Productivity Software
,2023-09-09,8400/000 : FNB,Wondershare 52.91 Wondershare 4XXXXX*5225 07 SEP XXXXXXXXXXXXXXXXXXX1823 Wondershare,Account Payment,Wondershare 52.91 Wondershare 4XXXXX*5225 07 SEP XXXXXXXXXXXXXXXXXXX1823 Wondershare,1044.27,,393296.18,AccountTransactionsReport(2).csv,2152,2023-09,False,Other Computer Services,Other Computer Services,Other Computer Services
,2023-09-09,8400/000 : FNB,3.60 GETADDRESS.IO 4XXXXX*5225 07 SEP XXXXXXXXXXXXXXXXXXX3641,Account Payment,3.60 GETADDRESS.IO 4XXXXX*5225 07 SEP XXXXXXXXXXXXXXXXXXX3641,89.18,,393385.36,AccountTransactionsReport(2).csv,2153,2023-09,False,Other Computer Services,Other Computer Services,Other Computer Services
,2023-09-12,8400/000 : FNB,Shopify 2552.99 SHOPIFY* 19 4XXXXX*5225 10 SEP XXXXXXXXXXXXXXXXXXX5019 Shopify,Account Payment,Shopify 2552.99 SHOPIFY* 19 4XXXXX*5225 10 SEP XXXXXXXXXXXXXXXXXXX5019 Shopify,50023.72,,443409.08,AccountTransactionsReport(2).csv,2154,2023-09,False,E-commerce Platforms,E-commerce Platforms,E-commerce Platforms
,2023-09-12,8400/000 : FNB,GoDaddy 1322.93 DNH*GODADDY 4XXXXX*5225 10 SEP XXXXXXXXXXXXXXXXXXX5416 GoDaddy,Account Payment,GoDaddy 1322.93 DNH*GODADDY 4XXXXX*5225 10 SEP XXXXXXXXXXXXXXXXXXX5416 GoDaddy,1322.93,,444732.01,AccountTransactionsReport(2).csv,2155,2023-09,False,Domain & Hosting,Domain & Hosting,Domain & Hosting
,2023-09-13,8400/000 : FNB,"GitHub 42.00 GITHUB, INC. 4XXXXX*5225 11 SEP XXXXXXXXXXXXXXXXXXX5558 GitHub",Account Payment,"GitHub 42.00 GITHUB, INC. 4XXXXX*5225 11 SEP XXXXXXXXXXXXXXXXXXX5558 GitHub",822.96,,445554.97,AccountTransactionsReport(2).csv,2156,2023-09,False,Development Tools,Development Tools,Development Tools
,2023-09-13,8400/000 : FNB,"GitHub 189.00 GITHUB, INC. 4XXXXX*5225 11 SEP XXXXXXXXXXXXXXXXXXX8177 GitHub",Account Payment,"GitHub 189.00 GITHUB, INC. 4XXXXX*5225 11 SEP XXXXXXXXXXXXXXXXXXX8177 GitHub",3703.29,,449258.26,AccountTransactionsReport(2).csv,2157,2023-09,False,Development Tools,Development Tools,Development Tools
,2023-09-13,8400/000 : FNB,Intuit 408.25 INTUIT *QBoo 4XXXXX*5225 11 SEP XXXXXXXXXXXXXXXXXXX6287 Intuit,Account Payment,Intuit 408.25 INTUIT *QBoo 4XXXXX*5225 11 SEP XXXXXXXXXXXXXXXXXXX6287 Intuit,408.25,,449666.51,AccountTransactionsReport(2).csv,2158,2023-09,False,Productivity Software,Productivity Software,Productivity Software
,2023-09-13,8400/000 : FNB,Intuit 546.25 INTUIT *QBoo 4XXXXX*5225 11 SEP XXXXXXXXXXXXXXXXXXX6253 Intuit,Account Payment,Intuit 546.25 INTUIT *QBoo 4XXXXX*5225 11 SEP XXXXXXXXXXXXXXXXXXX6253 Intuit,546.25,,450212.76,AccountTransactionsReport(2).csv,2159,2023-09,False,Productivity Software,Productivity Software,Productivity Software
,2023-09-13,8400/000 : FNB,"GitHub 42.00 GITHUB, INC. 4XXXXX*5225 11 SEP XXXXXXXXXXXXXXXXXXX7870 GitHub",Account Payment,"GitHub 42.00 GITHUB, INC. 4XXXXX*5225 11 SEP XXXXXXXXXXXXXXXXXXX7870 GitHub",822.96,,451035.72,AccountTransactionsReport(2).csv,2160,2023-09,False,Development Tools,Development Tools,Development Tools
,2023-09-15,8400/000 : FNB,180.00 AGENCYANALYT 4XXXXX*5225 13 SEP XXXXXXXXXXXXXXXXXXX8804,Account Payment,180.00 AGENCYANALYT 4XXXXX*5225 13 SEP XXXXXXXXXXXXXXXXXXX8804,3497.04,,454532.76,AccountTransactionsReport(2).csv,2161,2023-09,False,Other Computer Services,Other Computer Services,Other Computer Services
,2023-09-18,8400/000 : FNB,226.48 SLACK T0MN3D 4XXXXX*5225 15 SEP XXXXXXXXXXXXXXXXXXX6844,Account Payment,226.48 SLACK T0MN3D 4XXXXX*5225 15 SEP XXXXXXXXXXXXXXXXXXX6844,4404.8,,458937.56,AccountTransactionsReport(2).csv,2162,2023-09,False,Communication,Communication,Communication
,2023-09-19,8400/000 : FNB,"10.00 REPLIT, INC. 4XXXXX*5225 17 SEP XXXXXXXXXXXXXXXXXXX2742",Account Payment,"10.00 REPLIT, INC. 4XXXXX*5225 17 SEP XXXXXXXXXXXXXXXXXXX2742",195.03,,459132.59,AccountTransactionsReport(2).csv,2163,2023-09,False,Other Computer Services,Other Computer Services,Other Computer Services
,2023-09-19,8400/000 : FNB,3762.85 PAYPAL *NEX 4XXXXX*5225 16 SEP XXXXXXXXXXXXXXXXXXX4079,Account Payment,3762.85 PAYPAL *NEX 4XXXXX*5225 16 SEP XXXXXXXXXXXXXXXXXXX4079,3762.85,,462895.44,AccountTransactionsReport(2).csv,2164,2023-09,False,Payment Processing,Payment Processing,Payment Processing
,2023-09-20,8400/000 : FNB,Shopify 74.75 SHOPIFY* 1961 4XXXXX*5225 18 SEP XXXXXXXXXXXXXXXXXXX4037 Shopify,Account Payment,Shopify 74.75 SHOPIFY* 1961 4XXXXX*5225 18 SEP XXXXXXXXXXXXXXXXXXX4037 Shopify,1457.88,,464353.32,AccountTransactionsReport(2).csv,2165,2023-09,False,E-commerce Platforms,E-commerce Platforms,E-commerce Platforms
,2023-09-21,8400/000 : FNB,59.00 GREENBACK.COM 4XXXXX*5225 19 SEP XXXXXXXXXXXXXXXXXXX8427,Account Payment,59.00 GREENBACK.COM 4XXXXX*5225 19 SEP XXXXXXXXXXXXXXXXXXX8427,1149.27,,465502.59,AccountTransactionsReport(2).csv,2166,2023-09,False,Other Computer Services,Other Computer Services,Other Computer Services
,2023-09-21,8400/000 : FNB,Intuit 546.25 INTUIT *QBoo 4XXXXX*5225 19 SEP XXXXXXXXXXXXXXXXXXX3398 Intuit,Account Payment,Intuit 546.25 INTUIT *QBoo 4XXXXX*5225 19 SEP XXXXXXXXXXXXXXXXXXX3398 Intuit,546.25,,466048.84,AccountTransactionsReport(2).csv,2167,2023-09,False,Productivity Software,Productivity Software,Productivity Software
,2023-09-21,8400/000 : FNB,Intuit 546.25 INTUIT *QBoo 4XXXXX*5225 19 SEP XXXXXXXXXXXXXXXXXXX3406 Intuit,Account Payment,Intuit 546.25 INTUIT *QBoo 4XXXXX*5225 19 SEP XXXXXXXXXXXXXXXXXXX3406 Intuit,546.25,,466595.09,AccountTransactionsReport(2).csv,2168,2023-09,False,Productivity Software,Productivity Software,Productivity Software
,2023-09-21,8400/000 : FNB,Intuit 546.25 INTUIT *QBoo 4XXXXX*5225 19 SEP XXXXXXXXXXXXXXXXXXX8378 Intuit,Account Payment,Intuit 546.25 INTUIT *QBoo 4XXXXX*5225 19 SEP XXXXXXXXXXXXXXXXXXX8378 Intuit,546.25,,467141.34,AccountTransactionsReport(2).csv,2169,2023-09,False,Productivity Software,Productivity Software,Productivity Software
,2023-09-21,8400/000 : FNB,Intuit 546.25 INTUIT *QBoo 4XXXXX*5225 19 SEP XXXXXXXXXXXXXXXXXXX3380 Intuit,Account Payment,Intuit 546.25 INTUIT *QBoo 4XXXXX*5225 19 SEP XXXXXXXXXXXXXXXXXXX3380 Intuit,546.25,,467687.59,AccountTransactionsReport(2).csv,2170,2023-09,False,Productivity Software,Productivity Software,Productivity Software
,2023-09-21,8400/000 : FNB,Intuit 546.25 INTUIT *QBoo 4XXXXX*5225 19 SEP XXXXXXXXXXXXXXXXXXX8386 Intuit,Account Payment,Intuit 546.25 INTUIT *QBoo 4XXXXX*5225 19 SEP XXXXXXXXXXXXXXXXXXX8386 Intuit,546.25,,468233.84,AccountTransactionsReport(2).csv,2171,2023-09,False,Productivity Software,Productivity Software,Productivity Software
,2023-09-21,8400/000 : FNB,Intuit 273.13 INTUIT *QBoo 4XXXXX*5225 19 SEP XXXXXXXXXXXXXXXXXXX0343 Intuit,Account Payment,Intuit 273.13 INTUIT *QBoo 4XXXXX*5225 19 SEP XXXXXXXXXXXXXXXXXXX0343 Intuit,273.13,,468506.97,AccountTransactionsReport(2).csv,2172,2023-09,False,Productivity Software,Productivity Software,Productivity Software
,2023-09-21,8400/000 : FNB,Intuit 132.25 INTUIT *QBoo 4XXXXX*5225 19 SEP XXXXXXXXXXXXXXXXXXX8394 Intuit,Account Payment,Intuit 132.25 INTUIT *QBoo 4XXXXX*5225 19 SEP XXXXXXXXXXXXXXXXXXX8394 Intuit,132.25,,468639.22,AccountTransactionsReport(2).csv,2173,2023-09,False,Productivity Software,Productivity Software,Productivity Software
,2023-09-22,8400/000 : FNB,"20.00 REPLIT, INC. 4XXXXX*5225 20 SEP XXXXXXXXXXXXXXXXXXX1922",Account Payment,"20.00 REPLIT, INC. 4XXXXX*5225 20 SEP XXXXXXXXXXXXXXXXXXX1922",388.91,,469028.13,AccountTransactionsReport(2).csv,2174,2023-09,False,Other Computer Services,Other Computer Services,Other Computer Services
,2023-09-26,8400/000 : FNB,376.40 HOLASPIRIT 4XXXXX*5225 25 SEP XXXXXXXXXXXXXXXXXXX3362,Account Payment,376.40 HOLASPIRIT 4XXXXX*5225 25 SEP XXXXXXXXXXXXXXXXXXX3362,6769.73,,475797.86,AccountTransactionsReport(2).csv,2175,2023-09,False,Other Computer Services,Other Computer Services,Other Computer Services
,2023-09-26,8400/000 : FNB,"GitHub 4.00 GITHUB, INC. 4XXXXX*5225 22 SEP XXXXXXXXXXXXXXXXXXX5533 GitHub",Account Payment,"GitHub 4.00 GITHUB, INC. 4XXXXX*5225 22 SEP XXXXXXXXXXXXXXXXXXX5533 GitHub",77.72,,475875.58,AccountTransactionsReport(2).csv,2176,2023-09,False,Development Tools,Development Tools,Development Tools
,2023-09-28,8400/000 : FNB,X0706.01 PAYPAL *NE 4XXXXX*5225 26 SEP XXXXXXXXXXXXXXXXXXX1789,Account Payment,X0706.01 PAYPAL *NE 4XXXXX*5225 26 SEP XXXXXXXXXXXXXXXXXXX1789,10706.01,,486581.59,AccountTransactionsReport(2).csv,2177,2023-09,False,Payment Processing,Payment Processing,Payment Processing
,2023-09-28,STOCK2SHOP (PTY) LTD,WWI31114,Supplier Invoice,3300/020 : Computer - Platforms,2219.0,,488800.59,AccountTransactionsReport(2).csv,2178,2023-09,False,E-commerce Platforms,E-commerce Platforms,E-commerce Platforms
,2023-09-30,8400/000 : FNB,Intuit 546.25 INTUIT *QBoo 4XXXXX*5225 28 SEP XXXXXXXXXXXXXXXXXXX4274 Intuit,Account Payment,Intuit 546.25 INTUIT *QBoo 4XXXXX*5225 28 SEP XXXXXXXXXXXXXXXXXXX4274 Intuit,546.25,,489346.84,AccountTransactionsReport(2).csv,2179,2023-09,False,Productivity Software,Productivity Software,Productivity Software
,2023-09-30,8400/000 : FNB,Intuit 546.25 INTUIT *QBoo 4XXXXX*5225 28 SEP XXXXXXXXXXXXXXXXXXX4266 Intuit,Account Payment,Intuit 546.25 INTUIT *QBoo 4XXXXX*5225 28 SEP XXXXXXXXXXXXXXXXXXX4266 Intuit,546.25,,489893.09,AccountTransactionsReport(2).csv,2180,2023-09,False,Productivity Software,Productivity Software,Productivity Software
,2023-10-02,8400/000 : FNB,5050.80 FRESHWORKS 4XXXXX*5225 29 SEP XXXXXXXXXXXXXXXXXXX2828,Account Payment,5050.80 FRESHWORKS 4XXXXX*5225 29 SEP XXXXXXXXXXXXXXXXXXX2828,5050.8,,494943.89,AccountTransactionsReport(2).csv,2181,2023-10,False,Productivity Software,Productivity Software,Productivity Software
,2023-10-02,8400/000 : FNB,Bob Go 4XXXXX*5225 28 SEP XXXXXXXXXXXXXXXXXXX7119,Account Payment,Bob Go 4XXXXX*5225 28 SEP XXXXXXXXXXXXXXXXXXX7119,2298.85,,497242.74,AccountTransactionsReport(2).csv,2182,2023-10,False,Other Computer Services,Other Computer Services,Other Computer Services
,2023-10-02,8400/000 : FNB,2989.34 PAYPAL *NEX 4XXXXX*5225 28 SEP XXXXXXXXXXXXXXXXXXX1883,Account Payment,2989.34 PAYPAL *NEX 4XXXXX*5225 28 SEP XXXXXXXXXXXXXXXXXXX1883,2989.34,,500232.08,AccountTransactionsReport(2).csv,2183,2023-10,False,Payment Processing,Payment Processing,Payment Processing
,2023-10-03,8400/000 : FNB,Intuit 546.25 INTUIT *QBoo 4XXXXX*5225 01 OCT XXXXXXXXXXXXXXXXXXX4325 Intuit,Account Payment,Intuit 546.25 INTUIT *QBoo 4XXXXX*5225 01 OCT XXXXXXXXXXXXXXXXXXX4325 Intuit,546.25,,500778.33,AccountTransactionsReport(2).csv,2184,2023-10,False,Productivity Software,Productivity Software,Productivity Software
,2023-10-03,8400/000 : FNB,119.94 CLINICSOFTWA 4XXXXX*5225 30 SEP XXXXXXXXXXXXXXXXXXX5025,Account Payment,119.94 CLINICSOFTWA 4XXXXX*5225 30 SEP XXXXXXXXXXXXXXXXXXX5025,2861.24,,503639.57,AccountTransactionsReport(2).csv,2185,2023-10,False,Other Computer Services,Other Computer Services,Other Computer Services
,2023-10-05,8400/000 : FNB,224.48 AIRTABLE.COM 4XXXXX*5225 03 OCT XXXXXXXXXXXXXXXXXXX5057,Account Payment,224.48 AIRTABLE.COM 4XXXXX*5225 03 OCT XXXXXXXXXXXXXXXXXXX5057,4404.78,,508044.35,AccountTransactionsReport(2).csv,2186,2023-10,False,Other Computer Services,Collaboration Tools,Collaboration Tools
,2023-10-06,8400/000 : FNB,1499.00 APPDIRECT 4XXXXX*5225 04 OCT XXXXXXXXXXXXXXXXXXX0089,Account Payment,1499.00 APPDIRECT 4XXXXX*5225 04 OCT XXXXXXXXXXXXXXXXXXX0089,29649.03,,537693.38,AccountTransactionsReport(2).csv,2187,2023-10,False,Other Computer Services,Other Computer Services,Other Computer Services
,2023-10-06,8400/000 : FNB,ManageWP 120.75 MANAGEWP 4XXXXX*5225 05 OCT XXXXXXXXXXXXXXXXXXX4557 ManageWP,Account Payment,ManageWP 120.75 MANAGEWP 4XXXXX*5225 05 OCT XXXXXXXXXXXXXXXXXXX4557 ManageWP,2395.48,,540088.86,AccountTransactionsReport(2).csv,2188,2023-10,False,Other Computer Services,Other Computer Services,Other Computer Services
,2023-10-06,8400/000 : FNB,ManageWP 120.75 MANAGEWP 4XXXXX*5225 05 OCT XXXXXXXXXXXXXXXXXXX7460 ManageWP,Account Payment,ManageWP 120.75 MANAGEWP 4XXXXX*5225 05 OCT XXXXXXXXXXXXXXXXXXX7460 ManageWP,2395.48,,542484.34,AccountTransactionsReport(2).csv,2189,2023-10,False,Other Computer Services,Other Computer Services,Other Computer Services
,2023-10-06,8400/000 : FNB,"GitHub 19.00 GITHUB, INC. 4XXXXX*5225 04 OCT XXXXXXXXXXXXXXXXXXX5225 GitHub",Account Payment,"GitHub 19.00 GITHUB, INC. 4XXXXX*5225 04 OCT XXXXXXXXXXXXXXXXXXX5225 GitHub",375.81,,542860.15,AccountTransactionsReport(2).csv,2190,2023-10,False,Development Tools,Development Tools,Development Tools
,2023-10-06,8400/000 : FNB,"GitHub 7.05 GITHUB, INC. 4XXXXX*5225 04 OCT XXXXXXXXXXXXXXXXXXX4437 GitHub",Account Payment,"GitHub 7.05 GITHUB, INC. 4XXXXX*5225 04 OCT XXXXXXXXXXXXXXXXXXX4437 GitHub",139.44,,542999.59,AccountTransactionsReport(2).csv,2191,2023-10,False,Development Tools,Development Tools,Development Tools
,2023-10-09,8400/000 : FNB,19.99 WOOCOMMERCE S 4XXXXX*5225 06 OCT XXXXXXXXXXXXXXXXXXX6920,Account Payment,19.99 WOOCOMMERCE S 4XXXXX*5225 06 OCT XXXXXXXXXXXXXXXXXXX6920,400.66,,543400.25,AccountTransactionsReport(2).csv,2192,2023-10,False,Other Computer Services,Other Computer Services,Other Computer Services
,2023-10-09,8400/000 : FNB,20.00 VERCEL PRO 4XXXXX*5225 07 OCT XXXXXXXXXXXXXXXXXXX3010,Account Payment,20.00 VERCEL PRO 4XXXXX*5225 07 OCT XXXXXXXXXXXXXXXXXXX3010,400.87,,543801.12,AccountTransactionsReport(2).csv,2193,2023-10,False,Cloud Services,Cloud Services,Cloud Services
,2023-10-09,8400/000 : FNB,20.00 VERCEL PRO 4XXXXX*5225 07 OCT XXXXXXXXXXXXXXXXXXX7609,Account Payment,20.00 VERCEL PRO 4XXXXX*5225 07 OCT XXXXXXXXXXXXXXXXXXX7609,400.87,,544201.99,AccountTransactionsReport(2).csv,2194,2023-10,False,Cloud Services,Cloud Services,Cloud Services
,2023-10-10,8400/000 : FNB,3.60 GETADDRESS.IO 4XXXXX*5225 07 OCT XXXXXXXXXXXXXXXXXXX1721,Account Payment,3.60 GETADDRESS.IO 4XXXXX*5225 07 OCT XXXXXXXXXXXXXXXXXXX1721,87.71,,544289.7,AccountTransactionsReport(2).csv,2195,2023-10,False,Other Computer Services,Other Computer Services,Other Computer Services
,2023-10-10,8400/000 : FNB,Intuit 546.25 INTUIT *QBoo 4XXXXX*5225 07 OCT XXXXXXXXXXXXXXXXXXX6981 Intuit,Account Payment,Intuit 546.25 INTUIT *QBoo 4XXXXX*5225 07 OCT XXXXXXXXXXXXXXXXXXX6981 Intuit,546.25,,544835.95,AccountTransactionsReport(2).csv,2196,2023-10,False,Productivity Software,Productivity Software,Productivity Software
,2023-10-10,8400/000 : FNB,99.00 MIOSALON.COM( 4XXXXX*5225 07 OCT XXXXXXXXXXXXXXXXXXX2289,Account Payment,99.00 MIOSALON.COM( 4XXXXX*5225 07 OCT XXXXXXXXXXXXXXXXXXX2289,1984.32,,546820.27,AccountTransactionsReport(2).csv,2197,2023-10,False,Other Computer Services,Other Computer Services,Other Computer Services
,2023-10-10,8400/000 : FNB,99.00 MIOSALON.COM( 4XXXXX*5225 07 OCT XXXXXXXXXXXXXXXXXXX8177,Account Payment,99.00 MIOSALON.COM( 4XXXXX*5225 07 OCT XXXXXXXXXXXXXXXXXXX8177,1984.32,,548804.59,AccountTransactionsReport(2).csv,2198,2023-10,False,Other Computer Services,Other Computer Services,Other Computer Services
,2023-10-13,8400/000 : FNB,"GitHub 189.00 GITHUB, INC. 4XXXXX*5225 11 OCT XXXXXXXXXXXXXXXXXXX2413 GitHub",Account Payment,"GitHub 189.00 GITHUB, INC. 4XXXXX*5225 11 OCT XXXXXXXXXXXXXXXXXXX2413 GitHub",3734.72,,552539.31,AccountTransactionsReport(2).csv,2199,2023-10,False,Development Tools,Development Tools,Development Tools
,2023-10-13,8400/000 : FNB,"GitHub 42.00 GITHUB, INC. 4XXXXX*5225 11 OCT XXXXXXXXXXXXXXXXXXX9207 GitHub",Account Payment,"GitHub 42.00 GITHUB, INC. 4XXXXX*5225 11 OCT XXXXXXXXXXXXXXXXXXX9207 GitHub",829.93,,553369.24,AccountTransactionsReport(2).csv,2200,2023-10,False,Development Tools,Development Tools,Development Tools
,2023-10-13,8400/000 : FNB,"GitHub 42.00 GITHUB, INC. 4XXXXX*5225 11 OCT XXXXXXXXXXXXXXXXXXX1847 GitHub",Account Payment,"GitHub 42.00 GITHUB, INC. 4XXXXX*5225 11 OCT XXXXXXXXXXXXXXXXXXX1847 GitHub",829.93,,554199.17,AccountTransactionsReport(2).csv,2201,2023-10,False,Development Tools,Development Tools,Development Tools
,2023-10-13,8400/000 : FNB,Intuit 546.25 INTUIT *QBoo 4XXXXX*5225 11 OCT XXXXXXXXXXXXXXXXXXX1408 Intuit,Account Payment,Intuit 546.25 INTUIT *QBoo 4XXXXX*5225 11 OCT XXXXXXXXXXXXXXXXXXX1408 Intuit,546.25,,554745.42,AccountTransactionsReport(2).csv,2202,2023-10,False,Productivity Software,Productivity Software,Productivity Software
,2023-10-13,8400/000 : FNB,Intuit 408.25 INTUIT *QBoo 4XXXXX*5225 11 OCT XXXXXXXXXXXXXXXXXXX1366 Intuit,Account Payment,Intuit 408.25 INTUIT *QBoo 4XXXXX*5225 11 OCT XXXXXXXXXXXXXXXXXXX1366 Intuit,408.25,,555153.67,AccountTransactionsReport(2).csv,2203,2023-10,False,Productivity Software,Productivity Software,Productivity Software
,2023-10-14,8400/000 : FNB,"10.00 REPLIT, INC. 4XXXXX*5225 12 OCT XXXXXXXXXXXXXXXXXXX8578",Account Payment,"10.00 REPLIT, INC. 4XXXXX*5225 12 OCT XXXXXXXXXXXXXXXXXXX8578",194.59,,555348.26,AccountTransactionsReport(2).csv,2204,2023-10,False,Other Computer Services,Other Computer Services,Other Computer Services
,2023-10-16,8400/000 : FNB,180.00 AGENCYANALYT 4XXXXX*5225 13 OCT XXXXXXXXXXXXXXXXXXX9278,Account Payment,180.00 AGENCYANALYT 4XXXXX*5225 13 OCT XXXXXXXXXXXXXXXXXXX9278,3499.71,,558847.97,AccountTransactionsReport(2).csv,2205,2023-10,False,Other Computer Services,Other Computer Services,Other Computer Services
,2023-10-17,8400/000 : FNB,216.20 SLACK T0MN3D 4XXXXX*5225 15 OCT XXXXXXXXXXXXXXXXXXX8977,Account Payment,216.20 SLACK T0MN3D 4XXXXX*5225 15 OCT XXXXXXXXXXXXXXXXXXX8977,4201.39,,563049.36,AccountTransactionsReport(2).csv,2206,2023-10,False,Communication,Communication,Communication
,2023-10-17,8400/000 : FNB,"GitHub 4.00 GITHUB, INC. 4XXXXX*5225 14 OCT XXXXXXXXXXXXXXXXXXX5247 GitHub",Account Payment,"GitHub 4.00 GITHUB, INC. 4XXXXX*5225 14 OCT XXXXXXXXXXXXXXXXXXX5247 GitHub",77.73,,563127.09,AccountTransactionsReport(2).csv,2207,2023-10,False,Development Tools,Development Tools,Development Tools
,2023-10-20,8400/000 : FNB,74143613292000157664335,Account Payment,74.75 SHOPIFY 2002 4910505225 18 OCT 74143613292000157664335,1442.92,,564570.01,AccountTransactionsReport(2).csv,2208,2023-10,False,E-commerce Platforms,E-commerce Platforms,E-commerce Platforms
,2023-10-21,8400/000 : FNB,Payment made,Account Payment,Payment made,132.25,,564702.26,AccountTransactionsReport(2).csv,2209,2023-10,False,Other Computer Services,Other Computer Services,Other Computer Services
,2023-10-21,8400/000 : FNB,Payment made,Account Payment,Payment made,273.13,,564975.39,AccountTransactionsReport(2).csv,2210,2023-10,False,Other Computer Services,Other Computer Services,Other Computer Services
,2023-10-21,8400/000 : FNB,Payment made,Account Payment,Payment made,546.25,,565521.64,AccountTransactionsReport(2).csv,2211,2023-10,False,Other Computer Services,Other Computer Services,Other Computer Services
,2023-10-21,8400/000 : FNB,Payment made,Account Payment,Payment made,546.25,,566067.89,AccountTransactionsReport(2).csv,2212,2023-10,True,Other Computer Services,Other Computer Services,Other Computer Services
,2023-10-21,8400/000 : FNB,Payment made,Account Payment,Payment made,1148.83,,567216.72,AccountTransactionsReport(2).csv,2213,2023-10,False,Other Computer Services,Other Computer Services,Other Computer Services
,2023-10-23,8400/000 : FNB,Payment made,Account Payment,Payment made,391.02,,567607.74,AccountTransactionsReport(2).csv,2214,2023-10,False,Other Computer Services,Other Computer Services,Other Computer Services
,2023-10-26,8400/000 : FNB,Payment made,Account Payment,Payment made,1467.54,,569075.28,AccountTransactionsReport(2).csv,2215,2023-10,False,Other Computer Services,Other Computer Services,Other Computer Services
,2023-10-26,8400/000 : FNB,Payment made,Account Payment,Payment made,7801.99,,576877.27,AccountTransactionsReport(2).csv,2216,2023-10,False,Other Computer Services,Other Computer Services,Other Computer Services
,2023-10-28,STOCK2SHOP (PTY) LTD,WWI31145,Supplier Invoice,3300/020 : Computer - Platforms Stock to Shop,2219.0,,579096.27,AccountTransactionsReport(2).csv,2217,2023-10,False,E-commerce Platforms,E-commerce Platforms,E-commerce Platforms
,2023-10-31,8400/000 : FNB,CANVA,Account Payment,CANVA,109.99,,579206.26,AccountTransactionsReport(2).csv,2218,2023-10,False,Other Computer Services,Design Tools,Design Tools
,2023-10-31,8400/000 : FNB,FRESHWORKS,Account Payment,FRESHWORKS,5050.8,,584257.06,AccountTransactionsReport(2).csv,2219,2023-10,False,Productivity Software,Productivity Software,Productivity Software
,2023-11-01,8400/000 : FNB,CLINICSOFTWARE,Account Payment,CLINICSOFTWARE,2824.21,,587081.27,AccountTransactionsReport(2).csv,2220,2023-11,False,Other Computer Services,Other Computer Services,Other Computer Services
,2023-11-02,8400/000 : FNB,INTUIIT,Account Payment,INTUIT,546.25,,587627.52,AccountTransactionsReport(2).csv,2221,2023-11,False,Productivity Software,Productivity Software,Productivity Software
,2023-11-03,8400/000 : FNB,273.24 GSUITE _regim,Account Payment,273.24 GSUITE _regim,5284.68,,592912.2,AccountTransactionsReport(2).csv,2222,2023-11,False,Other Computer Services,Other Computer Services,Other Computer Services
,2023-11-03,8400/000 : FNB,GOOGLE GSUIT,Account Payment,GOOGLE GSUIT,906.49,,593818.69,AccountTransactionsReport(2).csv,2223,2023-11,False,Other Computer Services,Analytics & Monitoring,Analytics & Monitoring
,2023-11-07,8400/000 : FNB,GITHUB,Account Payment,GITHUB,358.38,,594177.07,AccountTransactionsReport(2).csv,2224,2023-11,False,Development Tools,Development Tools,Development Tools
,2023-11-07,8400/000 : FNB,GITHUB,Account Payment,GITHUB,128.83,,594305.9,AccountTransactionsReport(2).csv,2225,2023-11,False,Development Tools,Development Tools,Development Tools
,2023-11-07,8400/000 : FNB,APPDIRECT,Account Payment,APPDIRECT,28273.71,,622579.61,AccountTransactionsReport(2).csv,2226,2023-11,False,Other Computer Services,Other Computer Services,Other Computer Services
,2023-11-08,8400/000 : FNB,REPLIT INC,Account Payment,REPLIT INC,188.62,,622768.23,AccountTransactionsReport(2).csv,2227,2023-11,False,Other Computer Services,Other Computer Services,Other Computer Services
,2023-11-08,8400/000 : FNB,VERCEL PRO,Account Payment,VERCEL PRO,374.9,,623143.13,AccountTransactionsReport(2).csv,2228,2023-11,False,Cloud Services,Cloud Services,Cloud Services
,2023-11-08,8400/000 : FNB,VERCEL PRO,Account Payment,VERCEL PRO,374.9,,623518.03,AccountTransactionsReport(2).csv,2229,2023-11,True,Cloud Services,Cloud Services,Cloud Services
,2023-11-08,8400/000 : FNB,WOOCOMMERCE,Account Payment,WOOCOMMERCE,377.04,,623895.07,AccountTransactionsReport(2).csv,2230,2023-11,False,Other Computer Services,Other Computer Services,Other Computer Services
,2023-11-09,8400/000 : FNB,3.60 GETADDRESS,Account Payment,3.60 GETADDRESS,83.5,,623978.57,AccountTransactionsReport(2).csv,2231,2023-11,False,Other Computer Services,Other Computer Services,Other Computer Services
,2023-11-09,8400/000 : FNB,INTUIT,Account Payment,INTUIT,546.25,,624524.82,AccountTransactionsReport(2).csv,2232,2023-11,False,Productivity Software,Productivity Software,Productivity Software
,2023-11-09,8400/000 : FNB,99.00 MIOSALON,Account Payment,99.00 MIOSALON,1855.76,,626380.58,AccountTransactionsReport(2).csv,2233,2023-11,False,Other Computer Services,Other Computer Services,Other Computer Services
,2023-11-09,8400/000 : FNB,SAGE SA NETCASH,Account Payment,SAGE SA NETCASH,4020.81,,630401.39,AccountTransactionsReport(2).csv,2234,2023-11,False,Other Computer Services,Other Computer Services,Other Computer Services
,2023-11-10,8400/000 : FNB,MANAGE WP,Account Payment,MANAGE WP,2272.07,,632673.46,AccountTransactionsReport(2).csv,2235,2023-11,False,Other Computer Services,Other Computer Services,Other Computer Services
,2023-11-10,8400/000 : FNB,MANAGE WP,Account Payment,MANAGE WP,2272.07,,634945.53,AccountTransactionsReport(2).csv,2236,2023-11,True,Other Computer Services,Other Computer Services,Other Computer Services
,2023-11-13,8400/000 : FNB,SHOPIFY,Account Payment,SHOPIFY,57249.26,,692194.79,AccountTransactionsReport(2).csv,2237,2023-11,False,E-commerce Platforms,E-commerce Platforms,E-commerce Platforms
,2023-11-14,8400/000 : FNB,INTUIT,Account Payment,INTUIT,546.25,,692741.04,AccountTransactionsReport(2).csv,2238,2023-11,False,Productivity Software,Productivity Software,Productivity Software
,2023-11-14,8400/000 : FNB,GITHUB,Account Payment,GITHUB,806.47,,693547.51,AccountTransactionsReport(2).csv,2239,2023-11,False,Development Tools,Development Tools,Development Tools
,2023-11-14,8400/000 : FNB,GITHUB,Account Payment,GITHUB,806.47,,694353.98,AccountTransactionsReport(2).csv,2240,2023-11,True,Development Tools,Development Tools,Development Tools
,2023-11-14,8400/000 : FNB,GITHUB,Account Payment,GITHUB,3629.12,,697983.1,AccountTransactionsReport(2).csv,2241,2023-11,False,Development Tools,Development Tools,Development Tools
,2023-11-14,8400/000 : FNB,INTUIT,Account Payment,INTUIT,408.25,,698391.35,AccountTransactionsReport(2).csv,2242,2023-11,False,Productivity Software,Productivity Software,Productivity Software
,2023-11-16,8400/000 : FNB,GITBUB,Account Payment,GITHUB,76.8,,698468.15,AccountTransactionsReport(2).csv,2243,2023-11,False,Development Tools,Development Tools,Development Tools
,2023-11-16,8400/000 : FNB,STOCK 2 SHOP,Account Payment,STOCK 2 SHOP,747.5,,699215.65,AccountTransactionsReport(2).csv,2244,2023-11,False,Other Computer Services,Other Computer Services,Other Computer Services
,2023-11-17,8400/000 : FNB,SLACK T0MN3D,Account Payment,222.01 SLACK T0MN3D,4239.53,,703455.18,AccountTransactionsReport(2).csv,2245,2023-11,False,Communication,Communication,Communication
,2023-11-18,8400/000 : FNB,BOB PAY,Account Payment,BOB PAY,4597.7,,708052.88,AccountTransactionsReport(2).csv,2246,2023-11,False,Other Computer Services,Other Computer Services,Other Computer Services
,2023-11-18,8400/000 : FNB,MSFT,Account Payment,5790.43 MSFT+*3cE0,5790.43,,713843.31,AccountTransactionsReport(2).csv,2247,2023-11,False,Other Computer Services,Other Computer Services,Other Computer Services
,2023-11-20,8400/000 : FNB,SHOPIFY,Account Payment,SHOPIFY,1405.76,,715249.07,AccountTransactionsReport(2).csv,2248,2023-11,False,E-commerce Platforms,E-commerce Platforms,E-commerce Platforms
,2023-11-21,8400/000 : FNB,74838423323108735050849,Account Payment,273.13 INTUIT QBoo 4910505225 19 NOV 74838423323108735050849,273.13,,715522.2,AccountTransactionsReport(2).csv,2249,2023-11,False,Productivity Software,Productivity Software,Productivity Software
,2023-11-21,8400/000 : FNB,24492163324000007039811,Account Payment,420.00 WEBFLOW.COM 4910505191 20 NOV 24492163324000007039811,7900.81,,723423.01,AccountTransactionsReport(2).csv,2250,2023-11,False,Other Computer Services,Content Management,Content Management
,2023-11-21,8400/000 : FNB,74838423323108728523711,Account Payment,546.25 INTUIT QBoo 4910505225 19 NOV 74838423323108728523711,546.25,,723969.26,AccountTransactionsReport(2).csv,2251,2023-11,False,Productivity Software,Productivity Software,Productivity Software
,2023-11-21,8400/000 : FNB,74838423323108728238674,Account Payment,546.25 INTUIT QBoo 4910505225 19 NOV 74838423323108728238674,546.25,,724515.51,AccountTransactionsReport(2).csv,2252,2023-11,False,Productivity Software,Productivity Software,Productivity Software
,2023-11-21,8400/000 : FNB,74838423323108735050807,Account Payment,132.25 INTUIT QBoo 4910505225 19 NOV 74838423323108735050807,132.25,,724647.76,AccountTransactionsReport(2).csv,2253,2023-11,False,Productivity Software,Productivity Software,Productivity Software
,2023-11-22,8400/000 : FNB,74922133324036260013190,Account Payment,BOB PAY 4910505191 16 NOV 74922133324036260013190,2298.85,,726946.61,AccountTransactionsReport(2).csv,2254,2023-11,False,Other Computer Services,Other Computer Services,Other Computer Services
,2023-11-22,8400/000 : FNB,74922133324036270019930,Account Payment,BOB PAY 4910505191 17 NOV 74922133324036270019930,2298.85,,729245.46,AccountTransactionsReport(2).csv,2255,2023-11,False,Other Computer Services,Other Computer Services,Other Computer Services
,2023-11-22,8400/000 : FNB,24492163324000049371024,Account Payment,20.00 REPLIT INC. 4910505225 20 NOV 24492163324000049371024,376.23,,729621.69,AccountTransactionsReport(2).csv,2256,2023-11,False,Other Computer Services,Other Computer Services,Other Computer Services
,2023-11-25,8400/000 : FNB,24906413327187776120249,Account Payment,392.14 DNHGODADDY. 4910505225 23 NOV 24906413327187776120249,392.14,,730013.83,AccountTransactionsReport(2).csv,2257,2023-11,False,Domain & Hosting,Domain & Hosting,Domain & Hosting
,2023-11-27,8400/000 : FNB,24011343328000039857574,Account Payment,1397.25 FIGMA 4910505225 24 NOV 24011343328000039857574,26947.01,,756960.84,AccountTransactionsReport(2).csv,2258,2023-11,False,Other Computer Services,Design Tools,Design Tools
,2023-11-27,8400/000 : FNB,74609053329000005771335,Account Payment,376.40 HOLASPIRIT 4910505225 25 NOV 74609053329000005771335,7948.47,,764909.31,AccountTransactionsReport(2).csv,2259,2023-11,False,Other Computer Services,Other Computer Services,Other Computer Services
,2023-11-27,8400/000 : FNB,74609053329000005872398,Account Payment,70.80 HOLASPIRIT 4910505225 25 NOV 74609053329000005872398,1495.09,,766404.4,AccountTransactionsReport(2).csv,2260,2023-11,False,Other Computer Services,Other Computer Services,Other Computer Services
,2023-11-29,8400/000 : FNB,74143613332000119333013,Account Payment,2909.35 SHOPIFY 20 4910505225 27 NOV 74143613332000119333013,56297.39,,822701.79,AccountTransactionsReport(2).csv,2261,2023-11,False,E-commerce Platforms,E-commerce Platforms,E-commerce Platforms
,2023-11-30,8400/000 : FNB,74838423332106250478386,Account Payment,546.25 INTUIT QBoo 4910505225 28 NOV 74838423332106250478386,546.25,,823248.04,AccountTransactionsReport(2).csv,2262,2023-11,False,Productivity Software,Productivity Software,Productivity Software
,2023-12-01,8400/000 : FNB,24011343334000012129258,Account Payment,141.99 CANVA I0398 4910505225 30 NOV 24011343334000012129258,141.99,,823390.03,AccountTransactionsReport(2).csv,2263,2023-12,False,Other Computer Services,Design Tools,Design Tools
,2023-12-01,STOCK2SHOP (PTY) LTD,WWI31217,Supplier Invoice,3300/020 : Computer - Platforms,2219.0,,825609.03,AccountTransactionsReport(2).csv,2264,2023-12,False,E-commerce Platforms,E-commerce Platforms,E-commerce Platforms
,2023-12-04,8400/000 : FNB,24492163335000076649414,Account Payment,10.00 REPLIT INC. 4910505225 01 DEC 24492163335000076649414,193.63,,825802.66,AccountTransactionsReport(2).csv,2265,2023-12,False,Other Computer Services,Other Computer Services,Other Computer Services
,2023-12-04,8400/000 : FNB,74838423335109240242315,Account Payment,546.25 INTUIT QBoo 4910505225 01 DEC 74838423335109240242315,546.25,,826348.91,AccountTransactionsReport(2).csv,2266,2023-12,False,Productivity Software,Productivity Software,Productivity Software
,2023-12-04,8400/000 : FNB,74697693336920045315719,Account Payment,44.14 GOOGLEGSUITE 4910505225 01 DEC 74697693336920045315719,931.63,,827280.54,AccountTransactionsReport(2).csv,2267,2023-12,False,Other Computer Services,Analytics & Monitoring,Analytics & Monitoring
,2023-12-04,8400/000 : FNB,74987503336000233316058,Account Payment,101.54 Google GSUIT 4910505191 02 DEC 74987503336000233316058,2131.98,,829412.52,AccountTransactionsReport(2).csv,2268,2023-12,False,Other Computer Services,Analytics & Monitoring,Analytics & Monitoring
,2023-12-04,8400/000 : FNB,24011343335000042966199,Account Payment,4109.90 CANVA I039 4910505225 01 DEC 24011343335000042966199,4109.9,,833522.42,AccountTransactionsReport(2).csv,2269,2023-12,False,Other Computer Services,Design Tools,Design Tools
,2023-12-04,8400/000 : FNB,74796313335000088390048,Account Payment,273.24 GSUITE_regim 4910505225 01 DEC 74796313335000088390048,5290.57,,838812.99,AccountTransactionsReport(2).csv,2270,2023-12,False,Other Computer Services,Other Computer Services,Other Computer Services
,2023-12-04,8400/000 : FNB,24492163336000013453549,Account Payment,540.00 AIRTABLE.COM 4910505191 02 DEC 24492163336000013453549,10414.03,,849227.02,AccountTransactionsReport(2).csv,2271,2023-12,False,Other Computer Services,Collaboration Tools,Collaboration Tools
,2023-12-05,8400/000 : FNB,24492163338000019228042,Account Payment,1499.00 APPDIRECT 4910505225 04 DEC 24492163338000019228042,28908.56,,878135.58,AccountTransactionsReport(2).csv,2272,2023-12,False,Other Computer Services,Other Computer Services,Other Computer Services
,2023-12-05,8400/000 : FNB,24492163336000048649764,Account Payment,4.00 GITHUB INC. 4910505225 02 DEC 24492163336000048649764,77.14,,878212.72,AccountTransactionsReport(2).csv,2273,2023-12,False,Development Tools,Development Tools,Development Tools
,2023-12-05,8400/000 : FNB,74201333336000005935483,Account Payment,576.00 LEONARDO.AI 4910505225 02 DEC 74201333336000005935483,11108.3,,889321.02,AccountTransactionsReport(2).csv,2274,2023-12,False,Other Computer Services,Other Computer Services,Other Computer Services
,2023-12-06,8400/000 : FNB,24492163338000043001522,Account Payment,19.00 GITHUB INC. 4910505225 04 DEC 24492163338000043001522,366.41,,889687.43,AccountTransactionsReport(2).csv,2275,2023-12,False,Development Tools,Development Tools,Development Tools
,2023-12-06,8400/000 : FNB,24492163338000043318835,Account Payment,6.61 GITHUB INC. 4910505225 04 DEC 24492163338000043318835,127.48,,889814.91,AccountTransactionsReport(2).csv,2276,2023-12,False,Development Tools,Development Tools,Development Tools
,2023-12-07,8400/000 : FNB,24492163339000033133631,Account Payment,120.75 MANAGEWP 4910505225 05 DEC 24492163339000033133631,2325.31,,892140.22,AccountTransactionsReport(2).csv,2277,2023-12,False,Other Computer Services,Other Computer Services,Other Computer Services
,2023-12-07,8400/000 : FNB,24492163339000033038863,Account Payment,120.75 MANAGEWP 4910505225 05 DEC 24492163339000033038863,2325.31,,894465.53,AccountTransactionsReport(2).csv,2278,2023-12,False,Other Computer Services,Other Computer Services,Other Computer Services
,2023-12-08,8400/000 : FNB,74208473341000006935375,Account Payment,3.60 GETADDRESS.IO 4910505225 07 DEC 74208473341000006935375,87.93,,894553.46,AccountTransactionsReport(2).csv,2279,2023-12,False,Other Computer Services,Other Computer Services,Other Computer Services
,2023-12-08,8400/000 : FNB,24011343341000019559243,Account Payment,20.00 VERCEL PRO 4910505225 07 DEC 24011343341000019559243,388.13,,894941.59,AccountTransactionsReport(2).csv,2280,2023-12,False,Cloud Services,Cloud Services,Cloud Services
,2023-12-08,8400/000 : FNB,24011343341000014174196,Account Payment,20.00 VERCEL PRO 4910505225 07 DEC 24011343341000014174196,388.13,,895329.72,AccountTransactionsReport(2).csv,2281,2023-12,False,Cloud Services,Cloud Services,Cloud Services
,2023-12-08,8400/000 : FNB,74609053340000008431825,Account Payment,19.99 WOOCOMMERCE S 4910505225 06 DEC 74609053340000008431825,388.04,,895717.76,AccountTransactionsReport(2).csv,2282,2023-12,False,Other Computer Services,Other Computer Services,Other Computer Services
,2023-12-09,8400/000 : FNB,74838423341104430792486,Account Payment,546.25 INTUIT QBoo 4910505225 07 DEC 74838423341104430792486,546.25,,896264.01,AccountTransactionsReport(2).csv,2283,2023-12,False,Productivity Software,Productivity Software,Productivity Software
,2023-12-09,8400/000 : FNB,24492163342000000451490,Account Payment,99.00 MIOSALON.COM 4910505225 07 DEC 24492163342000000451490,1921.22,,898185.23,AccountTransactionsReport(2).csv,2284,2023-12,False,Other Computer Services,Other Computer Services,Other Computer Services
,2023-12-09,8400/000 : FNB,24492163342000000262806,Account Payment,99.00 MIOSALON.COM 4910505225 07 DEC 24492163342000000262806,1921.22,,900106.45,AccountTransactionsReport(2).csv,2285,2023-12,False,Other Computer Services,Other Computer Services,Other Computer Services
,2023-12-11,STOCK2SHOP (PTY) LTD,WWI31205,Supplier Invoice,Additional console,10000.0,,910106.45,AccountTransactionsReport(2).csv,2286,2023-12,False,E-commerce Platforms,E-commerce Platforms,E-commerce Platforms
,2023-12-12,8400/000 : FNB,74143613345001282409668,Account Payment,3001.45 SHOPIFY 20 4910505225 10 DEC 74143613345001282409668,58219.52,,968325.97,AccountTransactionsReport(2).csv,2287,2023-12,False,E-commerce Platforms,E-commerce Platforms,E-commerce Platforms
,2023-12-13,8400/000 : FNB,74838423345108111924934,Account Payment,408.25 INTUIT QBoo 4910505225 11 DEC 74838423345108111924934,408.25,,968734.22,AccountTransactionsReport(2).csv,2288,2023-12,False,Productivity Software,Productivity Software,Productivity Software
,2023-12-13,8400/000 : FNB,74201333345000005897856,Account Payment,40.00 KRISPCALL 4910505191 11 DEC 74201333345000005897856,775.88,,969510.1,AccountTransactionsReport(2).csv,2289,2023-12,False,Other Computer Services,Other Computer Services,Other Computer Services
,2023-12-13,8400/000 : FNB,74201333345000005923009,Account Payment,40.00 KRISPCALL 4910505191 11 DEC 74201333345000005923009,775.88,,970285.98,AccountTransactionsReport(2).csv,2290,2023-12,False,Other Computer Services,Other Computer Services,Other Computer Services
,2023-12-13,8400/000 : FNB,24492163345000044273709,Account Payment,189.00 GITHUB INC. 4910505225 11 DEC 24492163345000044273709,3666.05,,973952.03,AccountTransactionsReport(2).csv,2291,2023-12,False,Development Tools,Development Tools,Development Tools
,2023-12-13,8400/000 : FNB,74201333345000005926572,Account Payment,40.00 KRISPCALL 4910505191 11 DEC 74201333345000005926572,775.88,,974727.91,AccountTransactionsReport(2).csv,2292,2023-12,False,Other Computer Services,Other Computer Services,Other Computer Services
,2023-12-13,8400/000 : FNB,74201333345000005936910,Account Payment,40.00 KRISPCALL 4910505191 11 DEC 74201333345000005936910,775.88,,975503.79,AccountTransactionsReport(2).csv,2293,2023-12,False,Other Computer Services,Other Computer Services,Other Computer Services
,2023-12-13,8400/000 : FNB,74838423345108111924876,Account Payment,546.25 INTUIT QBoo 4910505225 11 DEC 74838423345108111924876,546.25,,976050.04,AccountTransactionsReport(2).csv,2294,2023-12,False,Productivity Software,Productivity Software,Productivity Software
,2023-12-13,8400/000 : FNB,74201333345000006010251,Account Payment,100.00 KRISPCALL 4910505191 11 DEC 74201333345000006010251,1939.71,,977989.75,AccountTransactionsReport(2).csv,2295,2023-12,False,Other Computer Services,Other Computer Services,Other Computer Services
,2023-12-13,8400/000 : FNB,24492163345000043804819,Account Payment,42.00 GITHUB INC. 4910505225 11 DEC 24492163345000043804819,814.68,,978804.43,AccountTransactionsReport(2).csv,2296,2023-12,False,Development Tools,Development Tools,Development Tools
,2023-12-13,8400/000 : FNB,24492163345000044413446,Account Payment,42.00 GITHUB INC. 4910505225 11 DEC 24492163345000044413446,814.68,,979619.11,AccountTransactionsReport(2).csv,2297,2023-12,False,Development Tools,Development Tools,Development Tools
,2023-12-18,8400/000 : FNB,74208473349000007934825,Account Payment,500.00 ATARIMAGENCY 4910505191 15 DEC 74208473349000007934825,9550.15,,989169.26,AccountTransactionsReport(2).csv,2298,2023-12,False,Other Computer Services,Other Computer Services,Other Computer Services
,2023-12-18,8400/000 : FNB,24492163348000046760387,Account Payment,14.00 GITHUB INC. 4910505225 14 DEC 24492163348000046760387,272.73,,989441.99,AccountTransactionsReport(2).csv,2299,2023-12,False,Development Tools,Development Tools,Development Tools
,2023-12-18,8400/000 : FNB,74609053349000009084772,Account Payment,990.00 DMNS.APP BUS 4910505225 15 DEC 74609053349000009084772,18909.3,,1008351.29,AccountTransactionsReport(2).csv,2300,2023-12,False,Other Computer Services,Other Computer Services,Other Computer Services
,2023-12-18,8400/000 : FNB,74609053349000011704276,Account Payment,190.32 SLACK T0MN3D 4910505225 15 DEC 74609053349000011704276,3635.17,,1011986.46,AccountTransactionsReport(2).csv,2301,2023-12,False,Communication,Communication,Communication
,2023-12-18,8400/000 : FNB,24011343349000067214172,Account Payment,780.00 RETOOL 4910505225 15 DEC 24011343349000067214172,14898.23,,1026884.69,AccountTransactionsReport(2).csv,2302,2023-12,False,Other Computer Services,Other Computer Services,Other Computer Services
,2023-12-18,8400/000 : FNB,74247283347820126504342,Account Payment,180.00 AGENCYANALYT 4910505225 13 DEC 74247283347820126504342,3514.71,,1030399.4,AccountTransactionsReport(2).csv,2303,2023-12,False,Other Computer Services,Other Computer Services,Other Computer Services
,2023-12-18,8400/000 : FNB,24011343349000025966392,Account Payment,348.00 WWW.MAKE.COM 4910505191 15 DEC 24011343349000025966392,6646.9,,1037046.3,AccountTransactionsReport(2).csv,2304,2023-12,False,Other Computer Services,API Services,API Services
,2023-12-18,8400/000 : FNB,74208473349000008621264,Account Payment,149.99 ATARIMAGENCY 4910505191 15 DEC 74208473349000008621264,2864.85,,1039911.15,AccountTransactionsReport(2).csv,2305,2023-12,False,Other Computer Services,Other Computer Services,Other Computer Services
,2023-12-19,8400/000 : FNB,74143613352001295803071,Account Payment,74.75 SHOPIFY 2087 4910505225 17 DEC 74143613352001295803071,1406.02,,1041317.17,AccountTransactionsReport(2).csv,2306,2023-12,False,E-commerce Platforms,E-commerce Platforms,E-commerce Platforms
,2023-12-19,8400/000 : FNB,74796313351000000009055,Account Payment,26415.96 MSFT E07 4910505225 17 DEC 74796313351000000009055,26415.96,,1067733.13,AccountTransactionsReport(2).csv,2307,2023-12,False,Other Computer Services,Other Computer Services,Other Computer Services
,2023-12-19,8400/000 : FNB,24011343350000049887877,Account Payment,279.00 TRIPLE WHALE 4910505191 16 DEC 24011343350000049887877,5247.88,,1072981.01,AccountTransactionsReport(2).csv,2308,2023-12,False,Other Computer Services,Other Computer Services,Other Computer Services
,2023-12-19,8400/000 : FNB,24492163351000041020922,Account Payment,449.00 SITECORE USA 4910505191 17 DEC 24492163351000041020922,8445.52,,1081426.53,AccountTransactionsReport(2).csv,2309,2023-12,False,Other Computer Services,Other Computer Services,Other Computer Services
,2023-12-19,8400/000 : FNB,74601003351350632302002,Account Payment,5439.50 MSFT E070 4910505225 17 DEC 74601003351350632302002,5439.5,,1086866.03,AccountTransactionsReport(2).csv,2310,2023-12,False,Other Computer Services,Other Computer Services,Other Computer Services
,2023-12-20,8400/000 : FNB,74548583353006507000072,Account Payment,httpwww.windeed. 4910505191 15 DEC 74548583353006507000072,900.0,,1087766.03,AccountTransactionsReport(2).csv,2311,2023-12,False,Other Computer Services,Other Computer Services,Other Computer Services
,2023-12-21,8400/000 : FNB,24492163353000025130927,Account Payment,59.00 GREENBACK.COM 4910505225 19 DEC 24492163353000025130927,1123.55,,1088889.58,AccountTransactionsReport(2).csv,2312,2023-12,False,Other Computer Services,Other Computer Services,Other Computer Services
,2023-12-21,8400/000 : FNB,74838423353102631123647,Account Payment,546.25 INTUIT QBoo 4910505225 19 DEC 74838423353102631123647,546.25,,1089435.83,AccountTransactionsReport(2).csv,2313,2023-12,False,Productivity Software,Productivity Software,Productivity Software
,2023-12-21,8400/000 : FNB,74838423353102631186180,Account Payment,546.25 INTUIT QBoo 4910505225 19 DEC 74838423353102631186180,546.25,,1089982.08,AccountTransactionsReport(2).csv,2314,2023-12,False,Productivity Software,Productivity Software,Productivity Software
,2023-12-21,8400/000 : FNB,74838423353102635308061,Account Payment,264.50 INTUIT QBoo 4910505225 19 DEC 74838423353102635308061,264.5,,1090246.58,AccountTransactionsReport(2).csv,2315,2023-12,False,Productivity Software,Productivity Software,Productivity Software
,2023-12-21,8400/000 : FNB,74838423353102635308053,Account Payment,546.25 INTUIT QBoo 4910505225 19 DEC 74838423353102635308053,546.25,,1090792.83,AccountTransactionsReport(2).csv,2316,2023-12,False,Productivity Software,Productivity Software,Productivity Software
,2023-12-22,8400/000 : FNB,24492163354000048987385,Account Payment,20.00 REPLIT INC. 4910505225 20 DEC 24492163354000048987385,380.42,,1091173.25,AccountTransactionsReport(2).csv,2317,2023-12,False,Other Computer Services,Other Computer Services,Other Computer Services
,2023-12-27,8400/000 : FNB,74609053359000002032288,Account Payment,70.80 HOLASPIRIT 4910505225 25 DEC 74609053359000002032288,1475.15,,1092648.4,AccountTransactionsReport(2).csv,2318,2023-12,False,Other Computer Services,Other Computer Services,Other Computer Services
,2023-12-27,8400/000 : FNB,74609053359000001987805,Account Payment,376.40 HOLASPIRIT 4910505225 25 DEC 74609053359000001987805,7842.46,,1100490.86,AccountTransactionsReport(2).csv,2319,2023-12,False,Other Computer Services,Other Computer Services,Other Computer Services
,2023-12-28,8400/000 : FNB,24492163360000034251210,Account Payment,10.00 REPLIT INC. 4910505225 26 DEC 24492163360000034251210,189.32,,1100680.18,AccountTransactionsReport(2).csv,2320,2023-12,False,Other Computer Services,Other Computer Services,Other Computer Services
,2023-12-28,STOCK2SHOP (PTY) LTD,WWI31211,Supplier Invoice,3300/020 : Computer - Platforms,2219.0,,1102899.18,AccountTransactionsReport(2).csv,2321,2023-12,False,E-commerce Platforms,E-commerce Platforms,E-commerce Platforms
,2023-12-29,8400/000 : FNB,74201333361000007523749,Account Receipt,40.00 KRISPCALL 4910505191 27 DEC 74201333361000007523749,,721.84,1102177.34,AccountTransactionsReport(2).csv,2322,2023-12,False,Other Computer Services,Other Computer Services,Other Computer Services
,2023-12-29,8400/000 : FNB,24692163361109501046636,Account Payment,5.00 GOOGLE Chrome 4910505191 27 DEC 24692163361109501046636,95.68,,1102273.02,AccountTransactionsReport(2).csv,2323,2023-12,False,Other Computer Services,Analytics & Monitoring,Analytics & Monitoring
,2023-12-29,8400/000 : FNB,24492163362000008906425,Account Payment,628.61 APPDIRECT 4910505191 28 DEC 24492163362000008906425,11989.47,,1114262.49,AccountTransactionsReport(2).csv,2324,2023-12,False,Other Computer Services,Other Computer Services,Other Computer Services
,2023-12-29,8400/000 : FNB,74201333361000007525652,Account Receipt,40.00 KRISPCALL 4910505191 27 DEC 74201333361000007525652,,721.84,1113540.65,AccountTransactionsReport(2).csv,2325,2023-12,False,Other Computer Services,Other Computer Services,Other Computer Services
,2023-12-29,8400/000 : FNB,74143613362000102501371,Account Payment,2771.42 SHOPIFY 21 4910505225 27 DEC 74143613362000102501371,53034.17,,1166574.82,AccountTransactionsReport(2).csv,2326,2023-12,False,E-commerce Platforms,E-commerce Platforms,E-commerce Platforms
,2023-12-29,8400/000 : FNB,74083423361000005684636,Account Payment,96.00 OBSIDIAN.MD 4910505191 27 DEC 74083423361000005684636,1837.06,,1168411.88,AccountTransactionsReport(2).csv,2327,2023-12,False,Other Computer Services,Other Computer Services,Other Computer Services
,2023-12-29,8400/000 : FNB,74201333361000007527146,Account Receipt,40.00 KRISPCALL 4910505191 27 DEC 74201333361000007527146,,721.84,1167690.04,AccountTransactionsReport(2).csv,2328,2023-12,False,Other Computer Services,Other Computer Services,Other Computer Services
,2023-12-29,8400/000 : FNB,74083423361000005614351,Account Payment,96.00 OBSIDIAN.MD 4910505191 27 DEC 74083423361000005614351,1837.06,,1169527.1,AccountTransactionsReport(2).csv,2329,2023-12,False,Other Computer Services,Other Computer Services,Other Computer Services
,2023-12-29,8400/000 : FNB,74875303362000307894060,Account Payment,8.99 Google Storage 4910505191 27 DEC 74875303362000307894060,8.99,,1169536.09,AccountTransactionsReport(2).csv,2330,2023-12,False,Other Computer Services,Analytics & Monitoring,Analytics & Monitoring
,2023-12-29,8400/000 : FNB,74201333361000007528086,Account Receipt,100.00 KRISPCALL 4910505191 27 DEC 74201333361000007528086,,1795.34,1167740.75,AccountTransactionsReport(2).csv,2331,2023-12,False,Other Computer Services,Other Computer Services,Other Computer Services
,2023-12-29,8400/000 : FNB,74201333361000007524366,Account Receipt,40.00 KRISPCALL 4910505191 27 DEC 74201333361000007524366,,721.84,1167018.91,AccountTransactionsReport(2).csv,2332,2023-12,False,Other Computer Services,Other Computer Services,Other Computer Services
,2023-12-30,8400/000 : FNB,74838423362109922265507,Account Payment,546.25 INTUIT QBoo 4910505225 28 DEC 74838423362109922265507,546.25,,1167565.16,AccountTransactionsReport(2).csv,2333,2023-12,False,Productivity Software,Productivity Software,Productivity Software
,2023-12-30,8400/000 : FNB,74838423362109922265515,Account Payment,546.25 INTUIT QBoo 4910505225 28 DEC 74838423362109922265515,546.25,,1168111.41,AccountTransactionsReport(2).csv,2334,2023-12,False,Productivity Software,Productivity Software,Productivity Software
,2023-12-30,8400/000 : FNB,74083423363000004601035,Account Payment,381.90 OBSIDIAN.MD 4910505191 29 DEC 74083423363000004601035,7254.05,,1175365.46,AccountTransactionsReport(2).csv,2335,2023-12,False,Other Computer Services,Other Computer Services,Other Computer Services
,2024-01-01,STOCK2SHOP (PTY) LTD,WWI31232,Supplier Invoice,Sage One integration,10000.0,,1185365.46,AccountTransactionsReport(2).csv,2336,2024-01,False,E-commerce Platforms,E-commerce Platforms,E-commerce Platforms
,2024-01-02,8400/000 : FNB,74208473364000009026091,Account Payment,119.94 CLINICSOFTWA 4910505225 30 DEC 74208473364000009026091,2911.42,,1188276.88,AccountTransactionsReport(2).csv,2337,2024-01,False,Other Computer Services,Other Computer Services,Other Computer Services
,2024-01-02,8400/000 : FNB,74838423365102425118403,Account Payment,546.25 INTUIT QBoo 4910505225 31 DEC 74838423365102425118403,546.25,,1188823.13,AccountTransactionsReport(2).csv,2338,2024-01,False,Productivity Software,Productivity Software,Productivity Software
,2024-01-02,8400/000 : FNB,24011343364000012869831,Account Payment,141.99 CANVA I0401 4910505225 30 DEC 24011343364000012869831,141.99,,1188965.12,AccountTransactionsReport(2).csv,2339,2024-01,False,Other Computer Services,Design Tools,Design Tools
,2024-01-03,8400/000 : FNB,Gsuiteq,Account Payment,273.24 GSUITE_regim 4910505225 01 JAN 74796314001000052591044,5193.22,,1194158.34,AccountTransactionsReport(2).csv,2340,2024-01,False,Other Computer Services,Other Computer Services,Other Computer Services
,2024-01-03,8400/000 : FNB,74697694002920024161697,Account Payment,44.14 GOOGLEGSUITE 4910505225 01 JAN 74697694002920024161697,928.71,,1195087.05,AccountTransactionsReport(2).csv,2341,2024-01,False,Other Computer Services,Analytics & Monitoring,Analytics & Monitoring
,2024-01-03,8400/000 : FNB,74697694002920020285995,Account Payment,21.84 GOOGLEGSUITE 4910505191 01 JAN 74697694002920020285995,459.52,,1195546.57,AccountTransactionsReport(2).csv,2342,2024-01,False,Other Computer Services,Analytics & Monitoring,Analytics & Monitoring
,2024-01-03,8400/000 : FNB,74697694002920020385399,Account Payment,4.81 GOOGLEGSUITE 4910505191 01 JAN 74697694002920020385399,91.42,,1195637.99,AccountTransactionsReport(2).csv,2343,2024-01,False,Other Computer Services,Analytics & Monitoring,Analytics & Monitoring
,2024-01-05,8400/000 : FNB,24011344004000024870557,Account Payment,89.00 STABLE 4910505191 04 JAN 24011344004000024870557,1711.75,,1197349.74,AccountTransactionsReport(2).csv,2344,2024-01,False,Other Computer Services,Other Computer Services,Other Computer Services
,2024-01-05,8400/000 : FNB,24492164004000020407289,Account Payment,1499.00 APPDIRECT 4910505225 04 JAN 24492164004000020407289,28830.57,,1226180.31,AccountTransactionsReport(2).csv,2345,2024-01,False,Other Computer Services,Other Computer Services,Other Computer Services
,2024-01-06,8400/000 : FNB,24492164004000040661998,Account Payment,19.00 GITHUB INC. 4910505225 04 JAN 24492164004000040661998,365.44,,1226545.75,AccountTransactionsReport(2).csv,2346,2024-01,False,Development Tools,Development Tools,Development Tools
,2024-01-06,8400/000 : FNB,24492164005000012082438,Account Payment,120.75 MANAGEWP 4910505225 05 JAN 24492164005000012082438,2311.25,,1228857.0,AccountTransactionsReport(2).csv,2347,2024-01,False,Other Computer Services,Other Computer Services,Other Computer Services
,2024-01-06,8400/000 : FNB,24492164005000012166868,Account Payment,120.75 MANAGEWP 4910505225 05 JAN 24492164005000012166868,2311.25,,1231168.25,AccountTransactionsReport(2).csv,2348,2024-01,False,Other Computer Services,Other Computer Services,Other Computer Services
,2024-01-06,8400/000 : FNB,74548584005002608016570,Account Payment,SAGE ACC 4910505225 04 JAN 74548584005002608016570,3160.0,,1234328.25,AccountTransactionsReport(2).csv,2349,2024-01,False,Other Computer Services,Other Computer Services,Other Computer Services
,2024-01-06,8400/000 : FNB,24000774004000002308530,Account Payment,749.00 FLYWP.COM 4910505191 04 JAN 24000774004000002308530,14405.66,,1248733.91,AccountTransactionsReport(2).csv,2350,2024-01,False,Other Computer Services,Other Computer Services,Other Computer Services
,2024-01-08,8400/000 : FNB,74922134005036756006249,Account Payment,BOB GROUP 4910505191 04 JAN 74922134005036756006249,2298.85,,1251032.76,AccountTransactionsReport(2).csv,2351,2024-01,False,Other Computer Services,Other Computer Services,Other Computer Services
,2024-01-08,8400/000 : FNB,74922134005036720013552,Account Payment,BOB GROUP 4910505191 01 JAN 74922134005036720013552,2298.85,,1253331.61,AccountTransactionsReport(2).csv,2352,2024-01,False,Other Computer Services,Other Computer Services,Other Computer Services
,2024-01-08,8400/000 : FNB,24492164005000040351029,Account Payment,99.00 WWW.ODRIVE.CO 4910505191 05 JAN 24492164005000040351029,1894.94,,1255226.55,AccountTransactionsReport(2).csv,2353,2024-01,False,Other Computer Services,Other Computer Services,Other Computer Services
,2024-01-09,8400/000 : FNB,24492164008000001686873,Account Payment,269.63 UNSTOPPABLED 4910505191 07 JAN 24492164008000001686873,5217.52,,1260444.07,AccountTransactionsReport(2).csv,2354,2024-01,False,Other Computer Services,Other Computer Services,Other Computer Services
,2024-01-09,8400/000 : FNB,24492164008000000058132,Account Payment,99.00 MIOSALON.COM 4910505225 07 JAN 24492164008000000058132,1915.72,,1262359.79,AccountTransactionsReport(2).csv,2355,2024-01,False,Other Computer Services,Other Computer Services,Other Computer Services
,2024-01-09,8400/000 : FNB,24492164008000000044207,Account Payment,99.00 MIOSALON.COM 4910505225 07 JAN 24492164008000000044207,1915.72,,1264275.51,AccountTransactionsReport(2).csv,2356,2024-01,False,Other Computer Services,Other Computer Services,Other Computer Services
,2024-01-09,8400/000 : FNB,74987504008000801258042,Account Payment,99.00 Dan.com 4910505191 08 JAN 74987504008000801258042,1915.72,,1266191.23,AccountTransactionsReport(2).csv,2357,2024-01,False,Other Computer Services,Other Computer Services,Other Computer Services
,2024-01-09,8400/000 : FNB,74838424007107975696007,Account Payment,546.25 INTUIT QBoo 4910505225 07 JAN 74838424007107975696007,546.25,,1266737.48,AccountTransactionsReport(2).csv,2358,2024-01,False,Productivity Software,Productivity Software,Productivity Software
,2024-01-09,8400/000 : FNB,24011344007000025705502,Account Payment,23.68 ECM A LEGALZ 4910505191 07 JAN 24011344007000025705502,458.22,,1267195.7,AccountTransactionsReport(2).csv,2359,2024-01,False,Other Computer Services,Other Computer Services,Other Computer Services
,2024-01-09,8400/000 : FNB,24011344007000017400278,Account Payment,20.00 VERCEL INC. 4910505225 07 JAN 24011344007000017400278,387.02,,1267582.72,AccountTransactionsReport(2).csv,2360,2024-01,False,Cloud Services,Cloud Services,Cloud Services
,2024-01-09,8400/000 : FNB,74609054006000005977799,Account Payment,19.99 WOOCOMMERCE S 4910505225 06 JAN 74609054006000005977799,386.82,,1267969.54,AccountTransactionsReport(2).csv,2361,2024-01,False,Other Computer Services,Other Computer Services,Other Computer Services
,2024-01-09,8400/000 : FNB,24492164007000015449509,Account Payment,4.95 SHELLS.COM 4910505191 07 JAN 24492164007000015449509,95.79,,1268065.33,AccountTransactionsReport(2).csv,2362,2024-01,False,Other Computer Services,Other Computer Services,Other Computer Services
,2024-01-09,8400/000 : FNB,74208474007000005536292,Account Payment,3.60 GETADDRESS.IO 4910505225 07 JAN 74208474007000005536292,88.0,,1268153.33,AccountTransactionsReport(2).csv,2363,2024-01,False,Other Computer Services,Other Computer Services,Other Computer Services
,2024-01-09,8400/000 : FNB,74601004007400022985431,Account Payment,85.00 MICROSOFTSTO 4910505191 07 JAN 74601004007400022985431,85.0,,1268238.33,AccountTransactionsReport(2).csv,2364,2024-01,False,Productivity Software,Productivity Software,Productivity Software
,2024-01-10,8400/000 : FNB,24492164009000011605482,Account Payment,500.00 STRIPE ATLAS 4910505191 09 JAN 24492164009000011605482,9599.06,,1277837.39,AccountTransactionsReport(2).csv,2365,2024-01,False,Payment Processing,Payment Processing,Payment Processing
,2024-01-10,8400/000 : FNB,24492164008000038107356,Account Payment,150.00 AUTH0.COM 4910505191 08 JAN 24492164008000038107356,2902.6,,1280739.99,AccountTransactionsReport(2).csv,2366,2024-01,False,Security Services,Security Services,Security Services
,2024-01-10,8400/000 : FNB,24011344008000043763094,Account Payment,76.49 SINCH MAILGUN 4910505191 08 JAN 24011344008000043763094,1480.13,,1282220.12,AccountTransactionsReport(2).csv,2367,2024-01,False,Communication,Communication,Communication
,2024-01-12,8400/000 : FNB,24015094011000000134802,Account Payment,32.00 BUBBLE STARTE 4910505191 11 JAN 24015094011000000134802,612.48,,1282832.6,AccountTransactionsReport(2).csv,2368,2024-01,False,Other Computer Services,Other Computer Services,Other Computer Services
,2024-01-12,8400/000 : FNB,74143614011000104304801,Account Payment,3001.45 SHOPIFY 21 4910505225 10 JAN 74143614011000104304801,57355.23,,1340187.83,AccountTransactionsReport(2).csv,2369,2024-01,False,E-commerce Platforms,E-commerce Platforms,E-commerce Platforms
,2024-01-12,8400/000 : FNB,74987504010001669085044,Account Receipt,99.00 Dan.com 4910505191 08 JAN 74987504010001669085044,,1799.59,1338388.24,AccountTransactionsReport(2).csv,2370,2024-01,False,Other Computer Services,Other Computer Services,Other Computer Services
,2024-01-13,8400/000 : FNB,24492164011000040970754,Account Payment,42.00 GITHUB INC. 4910505225 11 JAN 24492164011000040970754,803.87,,1339192.11,AccountTransactionsReport(2).csv,2371,2024-01,False,Development Tools,Development Tools,Development Tools
,2024-01-13,8400/000 : FNB,74838424011100962651915,Account Payment,546.25 INTUIT QBoo 4910505225 11 JAN 74838424011100962651915,546.25,,1339738.36,AccountTransactionsReport(2).csv,2372,2024-01,False,Productivity Software,Productivity Software,Productivity Software
,2024-01-13,8400/000 : FNB,74838424011100962651832,Account Payment,408.25 INTUIT QBoo 4910505225 11 JAN 74838424011100962651832,408.25,,1340146.61,AccountTransactionsReport(2).csv,2373,2024-01,False,Productivity Software,Productivity Software,Productivity Software
,2024-01-13,8400/000 : FNB,24492164011000041501145,Account Payment,189.00 GITHUB INC. 4910505225 11 JAN 24492164011000041501145,3617.44,,1343764.05,AccountTransactionsReport(2).csv,2374,2024-01,False,Development Tools,Development Tools,Development Tools
,2024-01-13,8400/000 : FNB,24492164011000041888914,Account Payment,42.00 GITHUB INC. 4910505225 11 JAN 24492164011000041888914,803.87,,1344567.92,AccountTransactionsReport(2).csv,2375,2024-01,False,Development Tools,Development Tools,Development Tools
,2024-01-15,8400/000 : FNB,24492164012000045584443,Account Payment,15.00 TABNINE 4910505191 12 JAN 24492164012000045584443,287.07,,1344854.99,AccountTransactionsReport(2).csv,2376,2024-01,False,Other Computer Services,Other Computer Services,Other Computer Services
,2024-01-16,8400/000 : FNB,74838424013102743278487,Account Payment,129.08 INTUIT QBoo 4910505225 13 JAN 74838424013102743278487,129.08,,1344984.07,AccountTransactionsReport(2).csv,2377,2024-01,False,Productivity Software,Productivity Software,Productivity Software
,2024-01-16,8400/000 : FNB,74083424013000010576785,Account Payment,100.00 OBSIDIAN.MD 4910505191 13 JAN 74083424013000010576785,1908.5,,1346892.57,AccountTransactionsReport(2).csv,2378,2024-01,False,Other Computer Services,Other Computer Services,Other Computer Services
,2024-01-16,8400/000 : FNB,74083424014000009557845,Account Payment,129.00 LOOKA LOGO M 4910505191 14 JAN 74083424014000009557845,2461.96,,1349354.53,AccountTransactionsReport(2).csv,2379,2024-01,False,Other Computer Services,Other Computer Services,Other Computer Services
,2024-01-16,8400/000 : FNB,74083424014000009938532,Account Payment,129.00 LOOKA LOGO M 4910505191 14 JAN 74083424014000009938532,2461.96,,1351816.49,AccountTransactionsReport(2).csv,2380,2024-01,False,Other Computer Services,Other Computer Services,Other Computer Services
,2024-01-16,8400/000 : FNB,74083424014000009972150,Account Payment,129.00 LOOKA LOGO M 4910505191 14 JAN 74083424014000009972150,2461.96,,1354278.45,AccountTransactionsReport(2).csv,2381,2024-01,False,Other Computer Services,Other Computer Services,Other Computer Services
,2024-01-16,8400/000 : FNB,74247284013820124748850,Account Payment,180.00 AGENCYANALYT 4910505225 13 JAN 74247284013820124748850,3435.3,,1357713.75,AccountTransactionsReport(2).csv,2382,2024-01,False,Other Computer Services,Other Computer Services,Other Computer Services
,2024-01-16,8400/000 : FNB,24492164014000035005696,Account Payment,14.00 GITHUB INC. 4910505225 14 JAN 24492164014000035005696,267.19,,1357980.94,AccountTransactionsReport(2).csv,2383,2024-01,False,Development Tools,Development Tools,Development Tools
,2024-01-17,8400/000 : FNB,24492164015000042455719,Account Payment,18.96 GITHUB INC. 4910505225 15 JAN 24492164015000042455719,361.86,,1358342.8,AccountTransactionsReport(2).csv,2384,2024-01,False,Development Tools,Development Tools,Development Tools
,2024-01-17,8400/000 : FNB,74592724015259563969814,Account Payment,1231.75 Paypro 4480 4910505191 15 JAN 74592724015259563969814,1231.75,,1359574.55,AccountTransactionsReport(2).csv,2385,2024-01,False,Other Computer Services,Other Computer Services,Other Computer Services
,2024-01-17,8400/000 : FNB,74609054015000008178915,Account Payment,217.59 SLACK T0MN3D 4910505225 15 JAN 74609054015000008178915,4152.71,,1363727.26,AccountTransactionsReport(2).csv,2386,2024-01,False,Communication,Communication,Communication
,2024-01-18,8400/000 : FNB,74143614017000106601133,Account Payment,74.75 SHOPIFY 2129 4910505225 16 JAN 74143614017000106601133,1427.63,,1365154.89,AccountTransactionsReport(2).csv,2387,2024-01,False,E-commerce Platforms,E-commerce Platforms,E-commerce Platforms
,2024-01-18,8400/000 : FNB,24011344016000040346026,Account Payment,279.00 TRIPLE WHALE 4910505191 16 JAN 24011344016000040346026,5328.55,,1370483.44,AccountTransactionsReport(2).csv,2388,2024-01,False,Other Computer Services,Other Computer Services,Other Computer Services
,2024-01-18,8400/000 : FNB,74796314017000300035085,Account Payment,5439.50 MSFT 3cE0 4910505225 17 JAN 74796314017000300035085,5439.5,,1375922.94,AccountTransactionsReport(2).csv,2389,2024-01,False,Other Computer Services,Other Computer Services,Other Computer Services
,2024-01-18,8400/000 : FNB,74796314017000600005036,Account Payment,26415.96 MSFT E07 4910505225 17 JAN 74796314017000600005036,26415.96,,1402338.9,AccountTransactionsReport(2).csv,2390,2024-01,False,Other Computer Services,Other Computer Services,Other Computer Services
,2024-01-22,8400/000 : FNB,74838424019107064577791,Account Payment,546.25 INTUIT QBoo 4910505225 19 JAN 74838424019107064577791,546.25,,1402885.15,AccountTransactionsReport(2).csv,2391,2024-01,False,Productivity Software,Productivity Software,Productivity Software
,2024-01-22,8400/000 : FNB,74838424019107060993901,Account Payment,546.25 INTUIT QBoo 4910505225 19 JAN 74838424019107060993901,546.25,,1403431.4,AccountTransactionsReport(2).csv,2392,2024-01,False,Productivity Software,Productivity Software,Productivity Software
,2024-01-22,8400/000 : FNB,74838424019107064577783,Account Payment,264.50 INTUIT QBoo 4910505225 19 JAN 74838424019107064577783,264.5,,1403695.9,AccountTransactionsReport(2).csv,2393,2024-01,False,Productivity Software,Productivity Software,Productivity Software
,2024-01-22,8400/000 : FNB,24492164019000025130129,Account Payment,59.00 GREENBACK.COM 4910505225 19 JAN 24492164019000025130129,1151.41,,1404847.31,AccountTransactionsReport(2).csv,2394,2024-01,False,Other Computer Services,Other Computer Services,Other Computer Services
,2024-01-22,8400/000 : FNB,74838424019107058650455,Account Payment,546.25 INTUIT QBoo 4910505225 19 JAN 74838424019107058650455,546.25,,1405393.56,AccountTransactionsReport(2).csv,2395,2024-01,False,Productivity Software,Productivity Software,Productivity Software
,2024-01-23,8400/000 : FNB,24015094021000000131392,Account Payment,54.00 AIRTABLE.COM 4910505191 21 JAN 24015094021000000131392,1051.86,,1406445.42,AccountTransactionsReport(2).csv,2396,2024-01,False,Other Computer Services,Collaboration Tools,Collaboration Tools
,2024-01-23,8400/000 : FNB,24492164020000046934753,Account Payment,20.00 REPLIT INC. 4910505225 20 JAN 24492164020000046934753,389.58,,1406835.0,AccountTransactionsReport(2).csv,2397,2024-01,False,Other Computer Services,Other Computer Services,Other Computer Services
,2024-01-25,8400/000 : FNB,74987504024000007024081,Account Payment,1124.99 LinkedIn SN 4910505191 24 JAN 74987504024000007024081,1124.99,,1407959.99,AccountTransactionsReport(2).csv,2398,2024-01,False,Other Computer Services,Other Computer Services,Other Computer Services
,2024-01-25,8400/000 : FNB,24692164023100518376940,Account Payment,68.86 DNHDOMAINHO 4910505225 23 JAN 24692164023100518376940,1351.63,,1409311.62,AccountTransactionsReport(2).csv,2399,2024-01,False,Domain & Hosting,Domain & Hosting,Domain & Hosting
,2024-01-25,8400/000 : FNB,24906414023192076779905,Account Payment,2355.25 DNHDOMAIN 4910505225 23 JAN 24906414023192076779905,46187.41,,1455499.03,AccountTransactionsReport(2).csv,2400,2024-01,False,Domain & Hosting,Domain & Hosting,Domain & Hosting
,2024-01-25,8400/000 : FNB,74609054023000015007453,Account Payment,13.41 HOLASPIRIT 4910505225 23 JAN 74609054023000015007453,286.31,,1455785.34,AccountTransactionsReport(2).csv,2401,2024-01,False,Other Computer Services,Other Computer Services,Other Computer Services
,2024-01-25,8400/000 : FNB,74609054024000002515756,Account Payment,54.35 SLACK T1AS3LC 4910505191 24 JAN 74609054024000002515756,1066.82,,1456852.16,AccountTransactionsReport(2).csv,2402,2024-01,False,Communication,Communication,Communication
,2024-01-26,8400/000 : FNB,74987504024001399315038,Account Payment,13.79 Dropbox 19JK5 4910505191 24 JAN 74987504024001399315038,270.68,,1457122.84,AccountTransactionsReport(2).csv,2403,2024-01,False,Other Computer Services,Other Computer Services,Other Computer Services
,2024-01-26,8400/000 : FNB,74987504024001399993032,Account Payment,4.59 Dropbox VVT842 4910505191 24 JAN 74987504024001399993032,90.1,,1457212.94,AccountTransactionsReport(2).csv,2404,2024-01,False,Other Computer Services,Other Computer Services,Other Computer Services
,2024-01-26,8400/000 : FNB,74609054025000003478672,Account Payment,376.40 HOLASPIRIT 4910505225 25 JAN 74609054025000003478672,7959.25,,1465172.19,AccountTransactionsReport(2).csv,2405,2024-01,False,Other Computer Services,Other Computer Services,Other Computer Services
,2024-01-26,8400/000 : FNB,74609054025000003561378,Account Payment,231.95 HOLASPIRIT 4910505225 25 JAN 74609054025000003561378,4904.75,,1470076.94,AccountTransactionsReport(2).csv,2406,2024-01,False,Other Computer Services,Other Computer Services,Other Computer Services
,2024-01-28,STOCK2SHOP (PTY) LTD,WWI31231,Supplier Invoice,3300/020 : Computer - Platforms,2219.0,,1472295.94,AccountTransactionsReport(2).csv,2407,2024-01,False,E-commerce Platforms,E-commerce Platforms,E-commerce Platforms
,2024-01-29,8400/000 : FNB,74208474026000009938111,Account Payment,358.80 ENDOLE.CO.UK 4910505191 26 JAN 74208474026000009938111,8825.44,,1481121.38,AccountTransactionsReport(2).csv,2408,2024-01,False,Other Computer Services,Other Computer Services,Other Computer Services
,2024-01-30,8400/000 : FNB,74143614029001065900371,Account Payment,2828.92 SHOPIFY 21 4910505225 27 JAN 74143614029001065900371,54730.97,,1535852.35,AccountTransactionsReport(2).csv,2409,2024-01,False,E-commerce Platforms,E-commerce Platforms,E-commerce Platforms
,2024-01-30,8400/000 : FNB,74838424028104069507476,Account Payment,546.25 INTUIT QBoo 4910505225 28 JAN 74838424028104069507476,546.25,,1536398.6,AccountTransactionsReport(2).csv,2410,2024-01,False,Productivity Software,Productivity Software,Productivity Software
,2024-01-30,8400/000 : FNB,74548584028006600000469,Account Payment,httpwww.windeed. 4910505191 26 JAN 74548584028006600000469,1000.0,,1537398.6,AccountTransactionsReport(2).csv,2411,2024-01,False,Other Computer Services,Other Computer Services,Other Computer Services
,2024-01-30,8400/000 : FNB,74838424028104069507468,Account Payment,546.25 INTUIT QBoo 4910505225 28 JAN 74838424028104069507468,546.25,,1537944.85,AccountTransactionsReport(2).csv,2412,2024-01,False,Productivity Software,Productivity Software,Productivity Software
,2024-01-30,8400/000 : FNB,74007484029241542095816,Account Payment,3.00 CBACCleaner P 4910505191 28 JAN 74007484029241542095816,3.0,,1537947.85,AccountTransactionsReport(2).csv,2413,2024-01,False,Other Computer Services,Other Computer Services,Other Computer Services
,2024-01-30,8400/000 : FNB,74838424027103578066215,Account Payment,8.99 GOOGLE Google 4910505191 27 JAN 74838424027103578066215,8.99,,1537956.84,AccountTransactionsReport(2).csv,2414,2024-01,False,Other Computer Services,Analytics & Monitoring,Analytics & Monitoring
,2024-01-31,8400/000 : FNB,24011344030000011144477,Account Payment,141.99 CANVA I0404 4910505225 30 JAN 24011344030000011144477,141.99,,1538098.83,AccountTransactionsReport(2).csv,2415,2024-01,False,Other Computer Services,Design Tools,Design Tools
,2024-01-31,8400/000 : FNB,STOCK 2 SHOP,Account Payment,FNB OB 000000047 STOCK 2 SHOP STOCK 2 SHOP,2551.65,,1540650.48,AccountTransactionsReport(2).csv,2416,2024-01,False,Other Computer Services,Other Computer Services,Other Computer Services
,2024-01-31,8400/000 : FNB,24011344029000028639900,Account Payment,5050.80 FRESHWORKS 4910505225 29 JAN 24011344029000028639900,5050.8,,1545701.28,AccountTransactionsReport(2).csv,2417,2024-01,False,Productivity Software,Productivity Software,Productivity Software
,2024-02-01,,SADJ0000037,Supplier Adjustment,,,54730.97,1490970.31,AccountTransactionsReport(2).csv,2418,2024-02,False,Other Computer Services,Other Computer Services,Other Computer Services
,2024-02-01,,SADJ0000036,Supplier Adjustment,,205651.94,,1696622.25,AccountTransactionsReport(2).csv,2419,2024-02,False,Other Computer Services,Other Computer Services,Other Computer Services
,2024-02-01,8400/000 : FNB,74208474030000013496282,Account Payment,119.94 CLINICSOFTWA 4910505225 30 JAN 74208474030000013496282,2934.35,,1699556.6,AccountTransactionsReport(2).csv,2420,2024-02,False,Other Computer Services,Other Computer Services,Other Computer Services
,2024-02-01,8400/000 : FNB,74922134030037009987648,Account Payment,BOB PAY 4910505191 29 JAN 74922134030037009987648,4597.7,,1704154.3,AccountTransactionsReport(2).csv,2421,2024-02,False,Other Computer Services,Other Computer Services,Other Computer Services
,2024-02-03,8400/000 : FNB,74083424032000001578060,Account Payment,47.52 OBSIDIAN.MD 4910505191 01 FEB 74083424032000001578060,913.97,,1705068.27,AccountTransactionsReport(2).csv,2422,2024-02,False,Other Computer Services,Other Computer Services,Other Computer Services
,2024-02-03,8400/000 : FNB,24168884031106717957982,Account Payment,40090.81 DNHGODADD 4910505191 31 JAN 24168884031106717957982,40090.81,,1745159.08,AccountTransactionsReport(2).csv,2423,2024-02,False,Other Computer Services,Other Computer Services,Other Computer Services
,2024-02-03,8400/000 : FNB,24492154031745520260731,Account Payment,182.85 WIX.COM 4910505191 31 JAN 24492154031745520260731,3530.52,,1748689.6,AccountTransactionsReport(2).csv,2424,2024-02,False,E-commerce Platforms,E-commerce Platforms,E-commerce Platforms
,2024-02-03,8400/000 : FNB,74083424032000001824910,Account Payment,100.00 OBSIDIAN.MD 4910505191 01 FEB 74083424032000001824910,1923.33,,1750612.93,AccountTransactionsReport(2).csv,2425,2024-02,False,Other Computer Services,Other Computer Services,Other Computer Services
,2024-02-03,8400/000 : FNB,74609054031000004906939,Account Payment,34.50 SLACK T06A3T4 4910505191 31 JAN 74609054031000004906939,666.13,,1751279.06,AccountTransactionsReport(2).csv,2426,2024-02,False,Communication,Communication,Communication
,2024-02-03,8400/000 : FNB,74838424031106270996419,Account Payment,546.25 INTUIT QBoo 4910505225 31 JAN 74838424031106270996419,546.25,,1751825.31,AccountTransactionsReport(2).csv,2427,2024-02,False,Productivity Software,Productivity Software,Productivity Software
,2024-02-03,8400/000 : FNB,74143614032000061709351,Account Payment,408.92 FACEBK 27YJ 4910505191 31 JAN 74143614032000061709351,408.92,,1752234.23,AccountTransactionsReport(2).csv,2428,2024-02,False,Other Computer Services,Other Computer Services,Other Computer Services
,2024-02-05,8400/000 : FNB,74697694033920047198539,Account Payment,153.09 GOOGLEGSUIT 4910505225 01 FEB 74697694033920047198539,3192.44,,1755426.67,AccountTransactionsReport(2).csv,2429,2024-02,False,Other Computer Services,Analytics & Monitoring,Analytics & Monitoring
,2024-02-05,8400/000 : FNB,74796314032001132217041,Account Payment,158.65 GSUITE_regim 4910505225 01 FEB 74796314032001132217041,3051.36,,1758478.03,AccountTransactionsReport(2).csv,2430,2024-02,False,Other Computer Services,Other Computer Services,Other Computer Services
,2024-02-05,8400/000 : FNB,24011344032000065788508,Account Payment,99.00 SINCH MAILGUN 4910505191 01 FEB 24011344032000065788508,1904.1,,1760382.13,AccountTransactionsReport(2).csv,2431,2024-02,False,Communication,Communication,Communication
,2024-02-05,8400/000 : FNB,74697694033920047412138,Account Payment,44.14 GOOGLEGSUITE 4910505225 01 FEB 74697694033920047412138,920.47,,1761302.6,AccountTransactionsReport(2).csv,2432,2024-02,False,Other Computer Services,Analytics & Monitoring,Analytics & Monitoring
,2024-02-05,8400/000 : FNB,74697694033920043340416,Account Payment,39.82 GOOGLEGSUITE 4910505191 01 FEB 74697694033920043340416,830.38,,1762132.98,AccountTransactionsReport(2).csv,2433,2024-02,False,Other Computer Services,Analytics & Monitoring,Analytics & Monitoring
,2024-02-05,8400/000 : FNB,74796314032001164076042,Account Payment,29.81 GSUITE_zone.m 4910505191 01 FEB 74796314032001164076042,573.34,,1762706.32,AccountTransactionsReport(2).csv,2434,2024-02,False,Other Computer Services,Other Computer Services,Other Computer Services
,2024-02-05,8400/000 : FNB,74796314032001200131058,Account Payment,4.60 FACEBK FACEBK 4910505191 01 FEB 74796314032001200131058,88.47,,1762794.79,AccountTransactionsReport(2).csv,2435,2024-02,False,Other Computer Services,Other Computer Services,Other Computer Services
,2024-02-05,8400/000 : FNB,24492164032000040887201,Account Payment,GLASSFROG 4910505191 01 FEB 24492164032000040887201,11.16,,1762805.95,AccountTransactionsReport(2).csv,2436,2024-02,False,Other Computer Services,Other Computer Services,Other Computer Services
,2024-02-06,8400/000 : FNB,74201334033000007008994,Account Payment,450.00 WAPPALYZER 4910505191 02 FEB 74201334033000007008994,8621.28,,1771427.23,AccountTransactionsReport(2).csv,2437,2024-02,False,Other Computer Services,Other Computer Services,Other Computer Services
,2024-02-07,8400/000 : FNB,24492164035000017878511,Account Payment,1499.00 APPDIRECT 4910505225 04 FEB 24492164035000017878511,28958.07,,1800385.3,AccountTransactionsReport(2).csv,2438,2024-02,False,Other Computer Services,Other Computer Services,Other Computer Services
,2024-02-07,8400/000 : FNB,24011344035000018153443,Account Payment,255.22 STABLE 4910505191 04 FEB 24011344035000018153443,4930.4,,1805315.7,AccountTransactionsReport(2).csv,2439,2024-02,False,Other Computer Services,Other Computer Services,Other Computer Services
,2024-02-07,8400/000 : FNB,74609054035000001412283,Account Payment,99.00 DMNS.APP BUSI 4910505191 03 FEB 74609054035000001412283,1912.51,,1807228.21,AccountTransactionsReport(2).csv,2440,2024-02,False,Other Computer Services,Other Computer Services,Other Computer Services
,2024-02-07,8400/000 : FNB,74083424035000000730917,Account Payment,60.00 INSOMNIA TEAM 4910505191 03 FEB 74083424035000000730917,1159.1,,1808387.31,AccountTransactionsReport(2).csv,2441,2024-02,False,Other Computer Services,Other Computer Services,Other Computer Services
,2024-02-07,8400/000 : FNB,24492164035000015173055,Account Payment,4.95 SHELLS.COM 4910505191 04 FEB 24492164035000015173055,95.63,,1808482.94,AccountTransactionsReport(2).csv,2442,2024-02,False,Other Computer Services,Other Computer Services,Other Computer Services
,2024-02-09,8400/000 : FNB,24492164035000035140423,Account Payment,7.07 GITHUB INC. 4910505225 04 FEB 24492164035000035140423,136.58,,1808619.52,AccountTransactionsReport(2).csv,2443,2024-02,False,Development Tools,Development Tools,Development Tools
,2024-02-09,8400/000 : FNB,24492164035000034964633,Account Payment,19.00 GITHUB INC. 4910505225 04 FEB 24492164035000034964633,367.05,,1808986.57,AccountTransactionsReport(2).csv,2444,2024-02,False,Development Tools,Development Tools,Development Tools
,2024-02-09,8400/000 : FNB,74875304036000104427043,Account Payment,999.99 Google Malwa 4910505191 04 FEB 74875304036000104427043,999.99,,1809986.56,AccountTransactionsReport(2).csv,2445,2024-02,False,Other Computer Services,Analytics & Monitoring,Analytics & Monitoring
,2024-02-10,8400/000 : FNB,74548584037002605009620,Account Payment,SAGE ACC 4910505225 05 FEB 74548584037002605009620,3160.0,,1813146.56,AccountTransactionsReport(2).csv,2446,2024-02,False,Other Computer Services,Other Computer Services,Other Computer Services
,2024-02-10,8400/000 : FNB,24492164037000013595083,Account Payment,120.75 MANAGEWP 4910505225 06 FEB 24492164037000013595083,2354.16,,1815500.72,AccountTransactionsReport(2).csv,2447,2024-02,False,Other Computer Services,Other Computer Services,Other Computer Services
,2024-02-10,8400/000 : FNB,24492164037000013583881,Account Payment,120.75 MANAGEWP 4910505225 06 FEB 24492164037000013583881,2354.16,,1817854.88,AccountTransactionsReport(2).csv,2448,2024-02,False,Other Computer Services,Other Computer Services,Other Computer Services
,2024-02-10,8400/000 : FNB,24011344037000054336397,Account Payment,20.00 VERCEL INC. 4910505225 06 FEB 24011344037000054336397,389.93,,1818244.81,AccountTransactionsReport(2).csv,2449,2024-02,False,Cloud Services,Cloud Services,Cloud Services
,2024-02-10,8400/000 : FNB,24011344037000054128513,Account Payment,20.00 VERCEL INC. 4910505225 06 FEB 24011344037000054128513,389.93,,1818634.74,AccountTransactionsReport(2).csv,2450,2024-02,False,Cloud Services,Cloud Services,Cloud Services
,2024-02-10,8400/000 : FNB,74609054037000007535382,Account Payment,19.99 WOOCOMMERCE S 4910505225 06 FEB 74609054037000007535382,389.73,,1819024.47,AccountTransactionsReport(2).csv,2451,2024-02,False,Other Computer Services,Other Computer Services,Other Computer Services
,2024-02-10,8400/000 : FNB,24011344037000015928092,Account Payment,15.00 HIGHTAIL 4910505191 06 FEB 24011344037000015928092,292.44,,1819316.91,AccountTransactionsReport(2).csv,2452,2024-02,False,Other Computer Services,Other Computer Services,Other Computer Services
,2024-02-10,8400/000 : FNB,24000774038000001970231,Account Payment,780.00 ACQUIRE.COM 4910505191 07 FEB 24000774038000001970231,15215.9,,1834532.81,AccountTransactionsReport(2).csv,2453,2024-02,False,Other Computer Services,Other Computer Services,Other Computer Services
,2024-02-10,8400/000 : FNB,74208474038000010035648,Account Payment,3.60 GETADDRESS.IO 4910505225 07 FEB 74208474038000010035648,88.21,,1834621.02,AccountTransactionsReport(2).csv,2454,2024-02,False,Other Computer Services,Other Computer Services,Other Computer Services
,2024-02-12,8400/000 : FNB,24492164039000000120240,Account Payment,99.00 MIOSALON.COM 4910505225 07 FEB 24492164039000000120240,1931.25,,1836552.27,AccountTransactionsReport(2).csv,2455,2024-02,False,Other Computer Services,Other Computer Services,Other Computer Services
,2024-02-12,8400/000 : FNB,24492164039000000089809,Account Payment,99.00 MIOSALON.COM 4910505225 07 FEB 24492164039000000089809,1931.25,,1838483.52,AccountTransactionsReport(2).csv,2456,2024-02,False,Other Computer Services,Other Computer Services,Other Computer Services
,2024-02-12,8400/000 : FNB,74838424038101897303720,Account Payment,546.25 INTUIT QBoo 4910505225 07 FEB 74838424038101897303720,546.25,,1839029.77,AccountTransactionsReport(2).csv,2457,2024-02,False,Productivity Software,Productivity Software,Productivity Software
,2024-02-12,8400/000 : FNB,74579164038590707965642,Account Payment,34288.64 BLSCHOCOL 4910505191 06 FEB 74579164038590707965642,34288.64,,1873318.41,AccountTransactionsReport(2).csv,2458,2024-02,False,Other Computer Services,Other Computer Services,Other Computer Services
,2024-02-13,8400/000 : FNB,24492164039000040969036,Account Payment,150.00 AUTH0.COM 4910505191 08 FEB 24492164039000040969036,2899.15,,1876217.56,AccountTransactionsReport(2).csv,2459,2024-02,False,Security Services,Security Services,Security Services
,2024-02-13,8400/000 : FNB,74143254040000001860434,Account Payment,49.00 SKRAPP.IO STA 4910505191 09 FEB 74143254040000001860434,950.11,,1877167.67,AccountTransactionsReport(2).csv,2460,2024-02,False,Other Computer Services,Other Computer Services,Other Computer Services
,2024-02-13,8400/000 : FNB,74201334039000004336434,Account Payment,384.00 KRISPCALL 4910505191 08 FEB 74201334039000004336434,7421.83,,1884589.5,AccountTransactionsReport(2).csv,2461,2024-02,False,Other Computer Services,Other Computer Services,Other Computer Services
,2024-02-13,8400/000 : FNB,24011344039000048744597,Account Payment,26.31 SINCH MAILGUN 4910505191 08 FEB 24011344039000048744597,508.51,,1885098.01,AccountTransactionsReport(2).csv,2462,2024-02,False,Communication,Communication,Communication
,2024-02-13,8400/000 : FNB,74201334039000004502217,Account Payment,6.00 KRISPCALL 4910505191 08 FEB 74201334039000004502217,115.96,,1885213.97,AccountTransactionsReport(2).csv,2463,2024-02,False,Other Computer Services,Other Computer Services,Other Computer Services
,2024-02-13,8400/000 : FNB,24021214039010041919404,Account Payment,171.35 PADDLE.NETD 4910505191 08 FEB 24021214039010041919404,3311.8,,1888525.77,AccountTransactionsReport(2).csv,2464,2024-02,False,Other Computer Services,Subscription Management,Subscription Management
,2024-02-13,8400/000 : FNB,24011344040000048361522,Account Payment,468.00 APOLLO.IO 4910505191 09 FEB 24011344040000048361522,9074.51,,1897600.28,AccountTransactionsReport(2).csv,2465,2024-02,False,Other Computer Services,Other Computer Services,Other Computer Services
,2024-02-14,8400/000 : FNB,24492164042000035572451,Account Payment,63.00 GITHUB INC. 4910505225 11 FEB 24492164042000035572451,1225.99,,1898826.27,AccountTransactionsReport(2).csv,2466,2024-02,False,Development Tools,Development Tools,Development Tools
,2024-02-14,8400/000 : FNB,24492164042000035286326,Account Payment,42.00 GITHUB INC. 4910505225 11 FEB 24492164042000035286326,817.33,,1899643.6,AccountTransactionsReport(2).csv,2467,2024-02,False,Development Tools,Development Tools,Development Tools
,2024-02-14,8400/000 : FNB,24492164042000017185207,Account Payment,32.00 BUBBLE STARTE 4910505191 11 FEB 24492164042000017185207,622.72,,1900266.32,AccountTransactionsReport(2).csv,2468,2024-02,False,Other Computer Services,Other Computer Services,Other Computer Services
,2024-02-14,8400/000 : FNB,74838424042102160226972,Account Payment,546.25 INTUIT QBoo 4910505225 11 FEB 74838424042102160226972,546.25,,1900812.57,AccountTransactionsReport(2).csv,2469,2024-02,False,Productivity Software,Productivity Software,Productivity Software
,2024-02-14,8400/000 : FNB,74838424042102160226931,Account Payment,546.25 INTUIT QBoo 4910505225 11 FEB 74838424042102160226931,546.25,,1901358.82,AccountTransactionsReport(2).csv,2470,2024-02,False,Productivity Software,Productivity Software,Productivity Software
,2024-02-14,8400/000 : FNB,74143614043001012270615,Account Payment,3001.45 SHOPIFY 21 4910505225 10 FEB 74143614043001012270615,58408.68,,1959767.5,AccountTransactionsReport(2).csv,2471,2024-02,False,E-commerce Platforms,E-commerce Platforms,E-commerce Platforms
,2024-02-14,8400/000 : FNB,24492164042000035462356,Account Payment,189.00 GITHUB INC. 4910505225 11 FEB 24492164042000035462356,3677.97,,1963445.47,AccountTransactionsReport(2).csv,2472,2024-02,False,Development Tools,Development Tools,Development Tools
,2024-02-14,8400/000 : FNB,24011344042000019006187,Account Payment,99.00 DYNAMIC.XYZ 4910505191 11 FEB 24011344042000019006187,1926.56,,1965372.03,AccountTransactionsReport(2).csv,2473,2024-02,False,Other Computer Services,Other Computer Services,Other Computer Services
,2024-02-14,8400/000 : FNB,74020024039151248839208,Account Payment,79.00 IKOCHAP AGENC 4910505191 08 FEB 74020024039151248839208,1526.89,,1966898.92,AccountTransactionsReport(2).csv,2474,2024-02,False,Other Computer Services,Other Computer Services,Other Computer Services
,2024-02-15,8400/000 : FNB,74247284044820122677377,Account Payment,180.00 AGENCYANALYT 4910505225 13 FEB 74247284044820122677377,3504.26,,1970403.18,AccountTransactionsReport(2).csv,2475,2024-02,False,Other Computer Services,Other Computer Services,Other Computer Services
,2024-02-15,8400/000 : FNB,24492164043000038323117,Account Payment,15.00 TABNINE 4910505191 12 FEB 24492164043000038323117,291.9,,1970695.08,AccountTransactionsReport(2).csv,2476,2024-02,False,Other Computer Services,Other Computer Services,Other Computer Services
,2024-02-16,8400/000 : FNB,74143614046000099291038,Account Payment,2058.98 SHOPIFY 21 4910505191 14 FEB 74143614046000099291038,40303.52,,2010998.6,AccountTransactionsReport(2).csv,2477,2024-02,False,E-commerce Platforms,E-commerce Platforms,E-commerce Platforms
,2024-02-16,8400/000 : FNB,74987504046000557294088,Account Payment,11999.88 LinkedIn S 4910505191 15 FEB 74987504046000557294088,11999.88,,2022998.48,AccountTransactionsReport(2).csv,2478,2024-02,False,Other Computer Services,Other Computer Services,Other Computer Services
,2024-02-16,8400/000 : FNB,24011344045000053094906,Account Payment,461.44 APOLLO.IO 4910505191 14 FEB 24011344045000053094906,9032.46,,2032030.94,AccountTransactionsReport(2).csv,2479,2024-02,False,Other Computer Services,Other Computer Services,Other Computer Services
,2024-02-16,8400/000 : FNB,24492164045000046962425,Account Payment,280.00 WIZA.CO 4910505191 14 FEB 24492164045000046962425,5480.86,,2037511.8,AccountTransactionsReport(2).csv,2480,2024-02,False,Other Computer Services,Other Computer Services,Other Computer Services
,2024-02-16,8400/000 : FNB,24492164045000039371873,Account Payment,14.00 GITHUB INC. 4910505225 14 FEB 24492164045000039371873,274.04,,2037785.84,AccountTransactionsReport(2).csv,2481,2024-02,False,Development Tools,Development Tools,Development Tools
,2024-02-16,8400/000 : FNB,74201334045000005495405,Account Receipt,384.00 KRISPCALL 4910505191 14 FEB 74201334045000005495405,,7069.94,2030715.9,AccountTransactionsReport(2).csv,2482,2024-02,False,Other Computer Services,Other Computer Services,Other Computer Services
,2024-02-16,8400/000 : FNB,74201334045000005488152,Account Receipt,6.00 KRISPCALL 4910505191 14 FEB 74201334045000005488152,,110.47,2030605.43,AccountTransactionsReport(2).csv,2483,2024-02,False,Other Computer Services,Other Computer Services,Other Computer Services
,2024-02-17,8400/000 : FNB,74609054046000008692587,Account Payment,259.33 SLACK T0MN3D 4910505225 15 FEB 74609054046000008692587,5080.52,,2035685.95,AccountTransactionsReport(2).csv,2484,2024-02,False,Communication,Communication,Communication
,2024-02-17,8400/000 : FNB,74143614047000105742130,Account Payment,74.75 SHOPIFY 2173 4910505225 15 FEB 74143614047000105742130,1464.42,,2037150.37,AccountTransactionsReport(2).csv,2485,2024-02,False,E-commerce Platforms,E-commerce Platforms,E-commerce Platforms
,2024-02-17,8400/000 : FNB,24011344046000026542543,Account Payment,230.40 SQUARESPACE 4910505191 15 FEB 24011344046000026542543,230.4,,2037380.77,AccountTransactionsReport(2).csv,2486,2024-02,False,Payment Processing,Payment Processing,Payment Processing
,2024-02-17,8400/000 : FNB,24011344046000026541180,Account Payment,230.40 SQUARESPACE 4910505191 15 FEB 24011344046000026541180,230.4,,2037611.17,AccountTransactionsReport(2).csv,2487,2024-02,False,Payment Processing,Payment Processing,Payment Processing
,2024-02-19,8400/000 : FNB,74796314048000500007085,Account Payment,26415.96 MSFT E07 4910505225 17 FEB 74796314048000500007085,26415.96,,2064027.13,AccountTransactionsReport(2).csv,2488,2024-02,False,Other Computer Services,Other Computer Services,Other Computer Services
,2024-02-19,8400/000 : FNB,74796314048000500025087,Account Payment,5439.50 MSFT 3cE0 4910505225 17 FEB 74796314048000500025087,5439.5,,2069466.63,AccountTransactionsReport(2).csv,2489,2024-02,False,Other Computer Services,Other Computer Services,Other Computer Services
,2024-02-19,8400/000 : FNB,24011344047000046688176,Account Payment,279.00 TRIPLE WHALE 4910505191 16 FEB 24011344047000046688176,5434.93,,2074901.56,AccountTransactionsReport(2).csv,2490,2024-02,False,Other Computer Services,Other Computer Services,Other Computer Services
,2024-02-19,8400/000 : FNB,74424654047112431747992,Account Payment,154.80 www.anydesk. 4910505191 16 FEB 74424654047112431747992,3015.51,,2077917.07,AccountTransactionsReport(2).csv,2491,2024-02,False,Other Computer Services,Other Computer Services,Other Computer Services
,2024-02-19,8400/000 : FNB,74208474048000000208872,Account Payment,153.75 CLOUDM003916 4910505191 16 FEB 74208474048000000208872,2995.06,,2080912.13,AccountTransactionsReport(2).csv,2492,2024-02,False,Other Computer Services,Other Computer Services,Other Computer Services
,2024-02-19,8400/000 : FNB,24011344048000012291624,Account Payment,1150.00 SQUARESPACE 4910505191 17 FEB 24011344048000012291624,1150.0,,2082062.13,AccountTransactionsReport(2).csv,2493,2024-02,False,Payment Processing,Payment Processing,Payment Processing
,2024-02-19,8400/000 : FNB,74045464048910020000919,Account Payment,10.00 GOOGLEGSUITE 4910505191 16 FEB 74045464048910020000919,245.42,,2082307.55,AccountTransactionsReport(2).csv,2494,2024-02,False,Other Computer Services,Analytics & Monitoring,Analytics & Monitoring
,2024-02-19,8400/000 : FNB,24011344048000012668078,Account Payment,230.40 SQUARESPACE 4910505191 17 FEB 24011344048000012668078,230.4,,2082537.95,AccountTransactionsReport(2).csv,2495,2024-02,False,Payment Processing,Payment Processing,Payment Processing
,2024-02-19,8400/000 : FNB,74143614048000060403099,Account Payment,43.70 FACEBK Y76LJ 4910505191 16 FEB 74143614048000060403099,43.7,,2082581.65,AccountTransactionsReport(2).csv,2496,2024-02,False,Other Computer Services,Other Computer Services,Other Computer Services
,2024-02-20,8400/000 : FNB,24000774050000000984376,Account Payment,276.00 CLOUDFLARE 4910505191 19 FEB 24000774050000000984376,5350.02,,2087931.67,AccountTransactionsReport(2).csv,2497,2024-02,False,Cloud Services,Cloud Services,Cloud Services
,2024-02-20,8400/000 : FNB,74875304048000907662057,Account Payment,178.68 PipedriveUK 4910505191 17 FEB 74875304048000907662057,4363.89,,2092295.56,AccountTransactionsReport(2).csv,2498,2024-02,False,Other Computer Services,Other Computer Services,Other Computer Services
,2024-02-20,8400/000 : FNB,24492164050000012206213,Account Payment,100.00 NAMEBIO 4910505191 19 FEB 24492164050000012206213,1938.42,,2094233.98,AccountTransactionsReport(2).csv,2499,2024-02,False,Other Computer Services,Other Computer Services,Other Computer Services
,2024-02-20,8400/000 : FNB,74208474050000005674404,Account Payment,46.80 ENDOLE.CO.UK 4910505191 19 FEB 74208474050000005674404,1142.99,,2095376.97,AccountTransactionsReport(2).csv,2500,2024-02,False,Other Computer Services,Other Computer Services,Other Computer Services
,2024-02-20,8400/000 : FNB,24692164049107702566269,Account Payment,55.00 INTUIT QBook 4910505191 18 FEB 24692164049107702566269,1066.12,,2096443.09,AccountTransactionsReport(2).csv,2501,2024-02,False,Productivity Software,Productivity Software,Productivity Software
,2024-02-20,8400/000 : FNB,24692164049107702566319,Account Payment,45.00 INTUIT QBook 4910505191 18 FEB 24692164049107702566319,872.28,,2097315.37,AccountTransactionsReport(2).csv,2502,2024-02,False,Productivity Software,Productivity Software,Productivity Software
,2024-02-20,8400/000 : FNB,74143614050000380701615,Account Payment,43.70 FACEBK XMXYD 4910505191 17 FEB 74143614050000380701615,43.7,,2097359.07,AccountTransactionsReport(2).csv,2503,2024-02,False,Other Computer Services,Other Computer Services,Other Computer Services
,2024-02-20,8400/000 : FNB,74143614050000365561935,Account Payment,43.70 FACEBK R8MR9 4910505191 18 FEB 74143614050000365561935,43.7,,2097402.77,AccountTransactionsReport(2).csv,2504,2024-02,False,Other Computer Services,Other Computer Services,Other Computer Services
,2024-02-21,8400/000 : FNB,24492164050000021625577,Account Payment,59.00 GREENBACK.COM 4910505225 19 FEB 24492164050000021625577,1143.66,,2098546.43,AccountTransactionsReport(2).csv,2505,2024-02,False,Other Computer Services,Other Computer Services,Other Computer Services
,2024-02-21,8400/000 : FNB,74838424050108403626067,Account Payment,546.25 INTUIT QBoo 4910505225 19 FEB 74838424050108403626067,546.25,,2099092.68,AccountTransactionsReport(2).csv,2506,2024-02,False,Productivity Software,Productivity Software,Productivity Software
,2024-02-21,8400/000 : FNB,74838424050108402049535,Account Payment,546.25 INTUIT QBoo 4910505225 19 FEB 74838424050108402049535,546.25,,2099638.93,AccountTransactionsReport(2).csv,2507,2024-02,False,Productivity Software,Productivity Software,Productivity Software
,2024-02-21,8400/000 : FNB,74838424050108397927257,Account Payment,546.25 INTUIT QBoo 4910505225 19 FEB 74838424050108397927257,546.25,,2100185.18,AccountTransactionsReport(2).csv,2508,2024-02,False,Productivity Software,Productivity Software,Productivity Software
,2024-02-21,8400/000 : FNB,74838424050108403626083,Account Payment,264.50 INTUIT QBoo 4910505225 19 FEB 74838424050108403626083,264.5,,2100449.68,AccountTransactionsReport(2).csv,2509,2024-02,False,Productivity Software,Productivity Software,Productivity Software
,2024-02-21,8400/000 : FNB,74143614051000835931048,Account Payment,69.00 FACEBK MRG3N 4910505191 19 FEB 74143614051000835931048,69.0,,2100518.68,AccountTransactionsReport(2).csv,2510,2024-02,False,Other Computer Services,Other Computer Services,Other Computer Services
,2024-02-21,8400/000 : FNB,74143614051000061063565,Account Payment,46.00 FACEBK 5E5AM 4910505191 19 FEB 74143614051000061063565,46.0,,2100564.68,AccountTransactionsReport(2).csv,2511,2024-02,False,Other Computer Services,Other Computer Services,Other Computer Services
,2024-02-22,8400/000 : FNB,24492164052000019237052,Account Payment,500.00 STRIPE ATLAS 4910505191 21 FEB 24492164052000019237052,9734.26,,2110298.94,AccountTransactionsReport(2).csv,2512,2024-02,False,Payment Processing,Payment Processing,Payment Processing
,2024-02-22,8400/000 : FNB,24000774052000002426820,Account Payment,54.00 AIRTABLE.COM 4910505191 21 FEB 24000774052000002426820,1051.3,,2111350.24,AccountTransactionsReport(2).csv,2513,2024-02,False,Other Computer Services,Collaboration Tools,Collaboration Tools
,2024-02-22,8400/000 : FNB,24492164051000044220983,Account Payment,20.00 REPLIT INC. 4910505225 20 FEB 24492164051000044220983,387.89,,2111738.13,AccountTransactionsReport(2).csv,2514,2024-02,False,Other Computer Services,Other Computer Services,Other Computer Services
,2024-02-23,8400/000 : FNB,74922134052037200006712,Account Payment,BOB PAY 4910505191 18 FEB 74922134052037200006712,5548.95,,2117287.08,AccountTransactionsReport(2).csv,2515,2024-02,False,Other Computer Services,Other Computer Services,Other Computer Services
,2024-02-23,8400/000 : FNB,74143614053000072471623,Account Payment,115.00 FACEBK E38S 4910505191 21 FEB 74143614053000072471623,115.0,,2117402.08,AccountTransactionsReport(2).csv,2516,2024-02,False,Other Computer Services,Other Computer Services,Other Computer Services
,2024-02-23,8400/000 : FNB,24011344052000042375606,Account Payment,134.00 SQUARESPACE 4910505191 21 FEB 24011344052000042375606,134.0,,2117536.08,AccountTransactionsReport(2).csv,2517,2024-02,False,Payment Processing,Payment Processing,Payment Processing
,2024-02-23,8400/000 : FNB,74922134052037200007777,Account Payment,BOB GROUP 4910505191 18 FEB 74922134052037200007777,2298.85,,2119834.93,AccountTransactionsReport(2).csv,2518,2024-02,False,Other Computer Services,Other Computer Services,Other Computer Services
,2024-02-23,8400/000 : FNB,74922134052037200007868,Account Payment,BOB GROUP 4910505191 18 FEB 74922134052037200007868,2298.85,,2122133.78,AccountTransactionsReport(2).csv,2519,2024-02,False,Other Computer Services,Other Computer Services,Other Computer Services
,2024-02-24,8400/000 : FNB,74609054054000003878339,Account Payment,49.00 BUYMICROSTART 4910505191 23 FEB 74609054054000003878339,959.49,,2123093.27,AccountTransactionsReport(2).csv,2520,2024-02,False,Other Computer Services,Other Computer Services,Other Computer Services
,2024-02-24,8400/000 : FNB,24011344054000023816519,Account Payment,199.00 TINYACQUISIT 4910505191 23 FEB 24011344054000023816519,3896.71,,2126989.98,AccountTransactionsReport(2).csv,2521,2024-02,False,Other Computer Services,Other Computer Services,Other Computer Services
,2024-02-24,8400/000 : FNB,74609054053000014574985,Account Payment,299.00 TIME IS LTD 4910505191 22 FEB 74609054053000014574985,5787.5,,2132777.48,AccountTransactionsReport(2).csv,2522,2024-02,False,Other Computer Services,Other Computer Services,Other Computer Services
,2024-02-26,8400/000 : FNB,74609054054000005662491,Account Payment,17.25 SLACK T1AS3LC 4910505191 23 FEB 74609054054000005662491,337.78,,2133115.26,AccountTransactionsReport(2).csv,2523,2024-02,False,Communication,Communication,Communication
,2024-02-26,8400/000 : FNB,74143614055000063122498,Account Payment,690.00 FACEBK WFZU 4910505191 23 FEB 74143614055000063122498,690.0,,2133805.26,AccountTransactionsReport(2).csv,2524,2024-02,False,Other Computer Services,Other Computer Services,Other Computer Services
,2024-02-26,8400/000 : FNB,74987504055000109097086,Account Payment,1124.99 LinkedIn SN 4910505191 24 FEB 74987504055000109097086,1124.99,,2134930.25,AccountTransactionsReport(2).csv,2525,2024-02,False,Other Computer Services,Other Computer Services,Other Computer Services
,2024-02-27,8400/000 : FNB,74143614057000946822056,Account Payment,172.50 FACEBK EX69 4910505191 24 FEB 74143614057000946822056,172.5,,2135102.75,AccountTransactionsReport(2).csv,2526,2024-02,False,Other Computer Services,Other Computer Services,Other Computer Services
,2024-02-27,8400/000 : FNB,74987504055001724880039,Account Payment,18.38 Dropbox TFXKT 4910505191 24 FEB 74987504055001724880039,363.69,,2135466.44,AccountTransactionsReport(2).csv,2527,2024-02,False,Other Computer Services,Other Computer Services,Other Computer Services
,2024-02-27,8400/000 : FNB,24011344055000049913570,Account Payment,34.12 WWW.MAKE.COM 4910505191 24 FEB 24011344055000049913570,675.15,,2136141.59,AccountTransactionsReport(2).csv,2528,2024-02,False,Other Computer Services,API Services,API Services
,2024-02-27,8400/000 : FNB,24492164057000017465023,Account Payment,89.00 WHOISXMLAPI 4910505191 26 FEB 24492164057000017465023,1761.08,,2137902.67,AccountTransactionsReport(2).csv,2529,2024-02,False,Other Computer Services,Other Computer Services,Other Computer Services
,2024-02-27,8400/000 : FNB,74609054056000003747532,Account Payment,231.95 HOLASPIRIT 4910505225 25 FEB 74609054056000003747532,4964.51,,2142867.18,AccountTransactionsReport(2).csv,2530,2024-02,False,Other Computer Services,Other Computer Services,Other Computer Services
,2024-02-27,8400/000 : FNB,74609054056000003662814,Account Payment,376.40 HOLASPIRIT 4910505225 25 FEB 74609054056000003662814,8056.24,,2150923.42,AccountTransactionsReport(2).csv,2531,2024-02,False,Other Computer Services,Other Computer Services,Other Computer Services
,2024-02-27,8400/000 : FNB,24492164056000042194011,Account Payment,1119.00 SAPIEN TECH 4910505191 25 FEB 24492164056000042194011,22142.17,,2173065.59,AccountTransactionsReport(2).csv,2532,2024-02,False,Other Computer Services,Other Computer Services,Other Computer Services
,2024-02-28,8400/000 : FNB,74143614058000062527827,Account Payment,128.56 FACEBK 7R5D 4910505191 26 FEB 74143614058000062527827,128.56,,2173194.15,AccountTransactionsReport(2).csv,2533,2024-02,False,Other Computer Services,Other Computer Services,Other Computer Services
,2024-02-28,STOCK2SHOP (PTY) LTD,WWI31271,Supplier Invoice,3300/020 : Computer - Platforms,2413.4,,2175607.55,AccountTransactionsReport(2).csv,2534,2024-02,False,E-commerce Platforms,E-commerce Platforms,E-commerce Platforms
,2024-02-29,8400/000 : FNB,74143614059000100218792,Account Payment,2650.74 SHOPIFY 21 4910505225 27 FEB 74143614059000100218792,52361.11,,2227968.66,AccountTransactionsReport(2).csv,2535,2024-02,False,E-commerce Platforms,E-commerce Platforms,E-commerce Platforms
,2024-02-29,8400/000 : FNB,STOCK 2 SHOP,Account Payment,FNB OB 000000063 STOCK 2 SHOP STOCK 2 SHOP,5327.26,,2233295.92,AccountTransactionsReport(2).csv,2536,2024-02,False,Other Computer Services,Other Computer Services,Other Computer Services
,2024-02-29,8400/000 : FNB,74143254058000002197033,Account Payment,48.00 MATHCHA 4910505191 27 FEB 74143254058000002197033,948.16,,2234244.08,AccountTransactionsReport(2).csv,2537,2024-02,False,Other Computer Services,Other Computer Services,Other Computer Services
,2024-02-29,8400/000 : FNB,74875304058001293064046,Account Payment,8.99 Google Storage 4910505191 26 FEB 74875304058001293064046,8.99,,2234253.07,AccountTransactionsReport(2).csv,2538,2024-02,False,Other Computer Services,Analytics & Monitoring,Analytics & Monitoring
,2024-02-29,8400/000 : FNB,Agency Analytics,Account Payment,Agency ANalytics,3487.76,,2237740.83,AccountTransactionsReport(2).csv,2539,2024-02,False,Other Computer Services,Analytics & Monitoring,Analytics & Monitoring
3300/020 : Computer - Platforms,Closing Balance as at: 29/02/2024,,,,,2237740.83,,,AccountTransactionsReport(2).csv,2540,Unknown,False,Other Computer Services,Other Computer Services,Other Computer Services
,Movement for the period,,,,,2237740.83,,,AccountTransactionsReport(2).csv,2541,Unknown,False,Other Computer Services,Other Computer Services,Other Computer Services
,2022-03-28,STOCK2SHOP (PTY) LTD,WWI30629,Supplier Invoice,Stock2Shop,216.67,,216.67,AccountTransactionsReport(3).csv,2542,2022-03,False,E-commerce Platforms,E-commerce Platforms,E-commerce Platforms
,2022-03-28,STOCK2SHOP (PTY) LTD,WWI30630,Supplier Invoice,Stock2Shop,1875.0,,2091.67,AccountTransactionsReport(3).csv,2543,2022-03,False,E-commerce Platforms,E-commerce Platforms,E-commerce Platforms
,2022-03-31,REZONANCE (PTY) LTD,WWI30614,Supplier Invoice,3300/020: Computer - Platforms - Shopify,34013.54,,36105.21,AccountTransactionsReport(3).csv,2544,2022-03,False,E-commerce Platforms,E-commerce Platforms,E-commerce Platforms
,2022-03-31,REZONANCE (PTY) LTD,WWI30622,Supplier Invoice,3300/020: Computer - Platforms - Shopify,34013.54,,70118.75,AccountTransactionsReport(3).csv,2545,2022-03,True,E-commerce Platforms,E-commerce Platforms,E-commerce Platforms
,2022-04-01,STOCK2SHOP (PTY) LTD,WWI30624,Supplier Invoice,3300/020: Computer - Platforms Stock2shop,216.67,,70335.42,AccountTransactionsReport(3).csv,2546,2022-04,False,E-commerce Platforms,E-commerce Platforms,E-commerce Platforms
,2022-04-25,REZONANCE (PTY) LTD,WWI30643,Supplier Invoice,Shopify,32406.27,,102741.69,AccountTransactionsReport(3).csv,2547,2022-04,False,E-commerce Platforms,E-commerce Platforms,E-commerce Platforms
,2022-04-28,STOCK2SHOP (PTY) LTD,WWI30635,Supplier Invoice,3300/020: Computer - Platforms,855.0,,103596.69,AccountTransactionsReport(3).csv,2548,2022-04,False,E-commerce Platforms,E-commerce Platforms,E-commerce Platforms
,2022-05-28,STOCK2SHOP (PTY) LTD,WWI30648,Supplier Invoice,3300/020: Computer - Platforms,855.0,,104451.69,AccountTransactionsReport(3).csv,2549,2022-05,False,E-commerce Platforms,E-commerce Platforms,E-commerce Platforms
,2022-06-28,STOCK2SHOP (PTY) LTD,WWI30655,Supplier Invoice,3300/020: Computer - Platforms Stock2shop,855.0,,105306.69,AccountTransactionsReport(3).csv,2550,2022-06,False,E-commerce Platforms,E-commerce Platforms,E-commerce Platforms
,2022-06-28,STOCK2SHOP (PTY) LTD,WRD30066,Supplier Return,3300/020: Computer - Platforms - Duplication,,216.67,105090.02,AccountTransactionsReport(3).csv,2551,2022-06,False,E-commerce Platforms,E-commerce Platforms,E-commerce Platforms
,2022-06-30,STOCK2SHOP (PTY) LTD,WWI30656,Supplier Invoice,3300/020: Computer - Platforms - connectors,273.75,,105363.77,AccountTransactionsReport(3).csv,2552,2022-06,False,E-commerce Platforms,E-commerce Platforms,E-commerce Platforms
,2022-07-28,STOCK2SHOP (PTY) LTD,WWI30664,Supplier Invoice,3300/020: Computer - Platforms,1195.0,,106558.77,AccountTransactionsReport(3).csv,2553,2022-07,False,E-commerce Platforms,E-commerce Platforms,E-commerce Platforms
,2022-08-30,STOCK2SHOP (PTY) LTD,WWI30688,Supplier Invoice,3300/020: Stock2shop,1195.0,,107753.77,AccountTransactionsReport(3).csv,2554,2022-08,False,E-commerce Platforms,E-commerce Platforms,E-commerce Platforms
,2022-09-26,REZONANCE (PTY) LTD,WWI30736,Supplier Invoice,3300/020 : Computer - Platforms - Shopify,42341.84,,150095.61,AccountTransactionsReport(3).csv,2555,2022-09,False,E-commerce Platforms,E-commerce Platforms,E-commerce Platforms
,2022-09-28,REZONANCE (PTY) LTD,WWI30722,Supplier Invoice,3300/020 : Computer - Platforms - SHOPIFY,37700.54,,187796.15,AccountTransactionsReport(3).csv,2556,2022-09,False,E-commerce Platforms,E-commerce Platforms,E-commerce Platforms
,2022-09-28,REZONANCE (PTY) LTD,WWI30723,Supplier Invoice,3300/020 : Computer - Platforms - SHOPIFY,37925.24,,225721.39,AccountTransactionsReport(3).csv,2557,2022-09,False,E-commerce Platforms,E-commerce Platforms,E-commerce Platforms
,2022-09-28,REZONANCE (PTY) LTD,WWI30724,Supplier Invoice,3300/020 : Computer - Platforms - SHOPIFY,39838.94,,265560.33,AccountTransactionsReport(3).csv,2558,2022-09,False,E-commerce Platforms,E-commerce Platforms,E-commerce Platforms
,2022-09-28,REZONANCE (PTY) LTD,WWI30725,Supplier Invoice,3300/020 : Computer - Platforms - SHOPIFY,40568.17,,306128.5,AccountTransactionsReport(3).csv,2559,2022-09,False,E-commerce Platforms,E-commerce Platforms,E-commerce Platforms
,2022-09-28,REZONANCE (PTY) LTD,WWI30726,Supplier Invoice,3300/020 : Computer - Platforms - SHOPIFY,42341.84,,348470.34,AccountTransactionsReport(3).csv,2560,2022-09,False,E-commerce Platforms,E-commerce Platforms,E-commerce Platforms
,2022-09-28,STOCK2SHOP (PTY) LTD,WWI30731,Supplier Invoice,3300/020 : Computer - Platforms - STOCK2SHOP,1195.0,,349665.34,AccountTransactionsReport(3).csv,2561,2022-09,False,E-commerce Platforms,E-commerce Platforms,E-commerce Platforms
,2022-09-30,REZONANCE (PTY) LTD,WRD30069,Supplier Return,3300/020 : Computer - Platforms - Shopify,,42341.84,307323.5,AccountTransactionsReport(3).csv,2562,2022-09,False,E-commerce Platforms,E-commerce Platforms,E-commerce Platforms
,2022-10-28,STOCK2SHOP (PTY) LTD,WWI30753,Supplier Invoice,3300/020 : Computer - Platforms,1195.0,,308518.5,AccountTransactionsReport(3).csv,2563,2022-10,False,E-commerce Platforms,E-commerce Platforms,E-commerce Platforms
,2022-11-28,STOCK2SHOP (PTY) LTD,WWI30783,Supplier Invoice,3300/020 : Computer - Platforms - Stock2shop,1195.0,,309713.5,AccountTransactionsReport(3).csv,2564,2022-11,False,E-commerce Platforms,E-commerce Platforms,E-commerce Platforms
,2022-11-30,REZONANCE (PTY) LTD,WWI30791,Supplier Invoice,3300/020 : Computer - Platforms - Shopify,43406.33,,353119.83,AccountTransactionsReport(3).csv,2565,2022-11,False,E-commerce Platforms,E-commerce Platforms,E-commerce Platforms
,2022-11-30,REZONANCE (PTY) LTD,WWI30792,Supplier Invoice,3300/020 : Computer - Platforms - Shopify,43952.06,,397071.89,AccountTransactionsReport(3).csv,2566,2022-11,False,E-commerce Platforms,E-commerce Platforms,E-commerce Platforms
,2022-11-30,REZONANCE (PTY) LTD,WWI30793,Supplier Invoice,3300/020 : Computer - Platforms - Shopify,46384.7,,443456.59,AccountTransactionsReport(3).csv,2567,2022-11,False,E-commerce Platforms,E-commerce Platforms,E-commerce Platforms
,2022-12-28,STOCK2SHOP (PTY) LTD,WWI30810,Supplier Invoice,- Stock2shop,1195.0,,444651.59,AccountTransactionsReport(3).csv,2568,2022-12,False,E-commerce Platforms,E-commerce Platforms,E-commerce Platforms
,2023-01-26,STOCK2SHOP (PTY) LTD,WWI30824,Supplier Invoice,3300/020 : Computer - Platforms,175.2,,444826.79,AccountTransactionsReport(3).csv,2569,2023-01,False,E-commerce Platforms,E-commerce Platforms,E-commerce Platforms
,2023-01-28,STOCK2SHOP (PTY) LTD,WWI30825,Supplier Invoice,3300/020 : Computer - Platforms,1875.0,,446701.79,AccountTransactionsReport(3).csv,2570,2023-01,False,E-commerce Platforms,E-commerce Platforms,E-commerce Platforms
,2023-01-30,REZONANCE (PTY) LTD,WWI30849,Supplier Invoice,3300/020 : Computer - Platforms - Shopify,48427.89,,495129.68,AccountTransactionsReport(3).csv,2571,2023-01,False,E-commerce Platforms,E-commerce Platforms,E-commerce Platforms
,2023-02-06,REZONANCE (PTY) LTD,WWI30895,Supplier Invoice,3300/020 : Computer - Platforms - Shopify,48725.19,,543854.87,AccountTransactionsReport(3).csv,2572,2023-02,False,E-commerce Platforms,E-commerce Platforms,E-commerce Platforms
,2023-02-16,REZONANCE (PTY) LTD,WWI30850,Supplier Invoice,3300/020 : Computer - Platforms - Shopify,48725.19,,592580.06,AccountTransactionsReport(3).csv,2573,2023-02,False,E-commerce Platforms,E-commerce Platforms,E-commerce Platforms
,2023-02-16,REZONANCE (PTY) LTD,WWI30851,Supplier Invoice,3300/020 : Computer - Platforms - Shopify,48725.19,,641305.25,AccountTransactionsReport(3).csv,2574,2023-02,True,E-commerce Platforms,E-commerce Platforms,E-commerce Platforms
,2023-02-16,REZONANCE (PTY) LTD,WRD30068,Supplier Return,3300/020 : Computer - Platforms - Shopify,,48725.19,592580.06,AccountTransactionsReport(3).csv,2575,2023-02,False,E-commerce Platforms,E-commerce Platforms,E-commerce Platforms
,2023-02-28,STOCK2SHOP (PTY) LTD,WWI30874,Supplier Invoice,3300/020 : Computer - Platforms,2219.0,,594799.06,AccountTransactionsReport(3).csv,2576,2023-02,False,E-commerce Platforms,E-commerce Platforms,E-commerce Platforms
3300/020 : Computer - Platforms,Closing Balance as at: 28/02/2023,,,,,594799.06,,,AccountTransactionsReport(3).csv,2577,Unknown,False,Other Computer Services,Other Computer Services,Other Computer Services
,Movement for the period,,,,,594799.06,,,AccountTransactionsReport(3).csv,2578,Unknown,False,Other Computer Services,Other Computer Services,Other Computer Services
